STATE_NAME,DISTRICT_NAME,BLOCK_NAME,hab_num,hab_outside,osm_num,greater,osm_near,osm_far,hab_near,hab_far,hab_osm_diff,STATE_ID,BLOCK_ID,DISTRICT_ID,lat,lon,no_shape
Andhra Pradesh,Anantapur,Agali,54,0,32,hab,32,0,46,8,22,2,27,20,13.803486901511391,77.04137431011468,0
Andhra Pradesh,Anantapur,Amadagur,87,0,59,hab,58,1,69,18,28,2,104,20,13.932386608302266,78.05433244619304,0
Andhra Pradesh,Anantapur,Amarapuram,49,0,39,hab,38,1,41,8,10,2,111,20,14.085475344324758,76.99230530536558,0
Andhra Pradesh,Anantapur,Anantapur,39,0,32,hab,26,6,27,12,7,2,176,20,14.651034960276188,77.60053042697555,0
Andhra Pradesh,Anantapur,Atmakur,25,0,26,osm,25,1,24,1,-1,2,293,20,14.623532356078998,77.4107255722781,0
Andhra Pradesh,Anantapur,Bathalapalle,40,0,47,osm,46,1,40,0,-7,2,662,20,14.491948712117889,77.80952528613764,0
Andhra Pradesh,Anantapur,Beluguppa,30,0,30,hab,30,0,29,1,0,2,714,20,14.683284752615922,77.17598152176065,0
Andhra Pradesh,Anantapur,Bommanahal,35,0,36,osm,32,4,33,2,-1,2,1021,20,14.951613879933477,77.00658138674812,0
Andhra Pradesh,Anantapur,Brahmasamudram,34,0,42,osm,39,3,33,1,-8,2,1047,20,14.554285247894324,76.96474234372305,0
Andhra Pradesh,Anantapur,Bukkapatnam,43,0,36,hab,36,0,40,3,7,2,1063,20,14.252652791941642,77.91413018565912,0
Andhra Pradesh,Anantapur,Bukkarayasamudram,36,1,28,hab,28,0,27,9,8,2,1064,20,14.713053865270018,77.6881531108025,0
Andhra Pradesh,Anantapur,Chenne Kothapalle,44,0,40,hab,40,0,38,6,4,2,1234,20,14.281983821253437,77.66195918570956,0
Andhra Pradesh,Anantapur,Chilamathur,92,1,76,hab,76,0,84,8,16,2,1285,20,13.853540152795897,77.72645658221388,0
Andhra Pradesh,Anantapur,D Hirehal,29,0,29,hab,28,1,27,2,0,2,1380,20,14.93695637554966,76.87043938523071,0
Andhra Pradesh,Anantapur,Dharmavaram,62,0,53,hab,44,9,51,11,9,2,1594,20,14.408181440142755,77.75436157635144,0
Andhra Pradesh,Anantapur,Gandlapenta,108,1,88,hab,79,9,106,2,20,2,1838,20,14.076211636027207,78.26446321828259,0
Andhra Pradesh,Anantapur,Garladinne,33,0,32,hab,31,1,31,2,1,2,1884,20,14.851764276240546,77.54810290154947,0
Andhra Pradesh,Anantapur,Gooty,40,1,34,hab,34,0,33,7,6,2,2000,20,15.127802614061844,77.63301662243985,0
Andhra Pradesh,Anantapur,Gorantla,119,0,75,hab,74,1,89,30,44,2,2013,20,13.983077001954598,77.77594164151432,0
Andhra Pradesh,Anantapur,Gudibanda,67,0,58,hab,57,1,64,3,9,2,2037,20,13.966819025448407,77.11702754284974,0
Andhra Pradesh,Anantapur,Gummagatta,35,0,44,osm,43,1,32,3,-9,2,2063,20,14.618898105361009,76.86083275510504,0
Andhra Pradesh,Anantapur,Guntakal,38,1,38,osm,37,1,36,2,0,2,2074,20,15.138184729442349,77.4658497280946,0
Andhra Pradesh,Anantapur,Hindupur,49,0,45,hab,37,8,40,9,4,2,2219,20,13.815681512524671,77.52990485935008,0
Andhra Pradesh,Anantapur,Kadiri,91,0,71,hab,60,11,85,6,20,2,2571,20,14.143497795751214,78.13080281442465,0
Andhra Pradesh,Anantapur,Kalyandurg,54,0,48,hab,45,3,45,9,6,2,2662,20,14.548336246334133,77.19151803052529,0
Andhra Pradesh,Anantapur,Kambadur,42,0,35,hab,35,0,36,6,7,2,2679,20,14.406346231330879,77.25233018017505,0
Andhra Pradesh,Anantapur,Kanaganapalle,38,0,42,osm,41,1,35,3,-4,2,2689,20,14.444661239607207,77.47607712719508,0
Andhra Pradesh,Anantapur,Kanekal,29,0,33,osm,31,2,28,1,-4,2,2708,20,14.81700804220169,77.07067973058435,0
Andhra Pradesh,Anantapur,Kothacheruvu,52,1,47,hab,46,1,47,5,5,2,3161,20,14.197663392118116,77.73989032616113,0
Andhra Pradesh,Anantapur,Kudair,28,0,26,hab,26,0,25,3,2,2,3220,20,14.769489913530112,77.3982846171787,0
Andhra Pradesh,Anantapur,Kundurpi,36,0,33,hab,33,0,34,2,3,2,3263,20,14.311848389996028,77.05550136666227,0
Andhra Pradesh,Anantapur,Lepakshi,40,1,32,hab,32,0,33,7,8,2,3407,20,13.802946301466399,77.586282454531,0
Andhra Pradesh,Anantapur,Madakasira,111,0,82,hab,81,1,98,13,29,2,3464,20,13.925064162631156,77.29368605832136,0
Andhra Pradesh,Anantapur,Mudigubba,89,0,77,hab,74,3,76,13,12,2,3951,20,14.383732411096533,78.01626732055931,0
Andhra Pradesh,Anantapur,Nallacheruvu,89,1,64,hab,64,0,85,4,25,2,4114,20,14.008113360048386,78.1813396708315,0
Andhra Pradesh,Anantapur,Nallamada,78,1,61,hab,61,0,73,5,17,2,4116,20,14.156916062606786,78.01188304995789,0
Andhra Pradesh,Anantapur,Nambulipulikunta,157,0,98,hab,94,4,153,4,59,2,4122,20,14.063279604563316,78.37810279154863,0
Andhra Pradesh,Anantapur,Narpala,39,0,37,hab,37,0,38,1,2,2,4200,20,14.695989869978172,77.81659959122817,0
Andhra Pradesh,Anantapur,Obuladevaracheruvu,115,0,96,hab,96,0,109,6,19,2,4369,20,14.01631393147848,77.97204679584439,0
Andhra Pradesh,Anantapur,Pamidi,32,0,29,hab,29,0,27,5,3,2,4487,20,14.967025951983901,77.53098318159013,0
Andhra Pradesh,Anantapur,Parigi,46,0,43,hab,43,0,43,3,3,2,4565,20,13.89764585203003,77.46850945885257,0
Andhra Pradesh,Anantapur,Peddapappur,39,0,43,osm,43,0,39,0,-4,2,4675,20,14.91983859018189,77.86186970789353,0
Andhra Pradesh,Anantapur,Peddavadugur,39,0,41,osm,40,1,39,0,-2,2,4678,20,15.015440202133993,77.71550440320173,0
Andhra Pradesh,Anantapur,Penu Konda,35,0,29,hab,27,2,29,6,6,2,4697,20,14.11663324293514,77.60821619470086,0
Andhra Pradesh,Anantapur,Putlur,42,0,41,hab,38,3,41,1,1,2,4887,20,14.774355522803793,77.95451765830498,0
Andhra Pradesh,Anantapur,Puttaparthi,48,0,32,hab,31,1,33,15,16,2,4888,20,14.106573660529031,77.81227857354256,0
Andhra Pradesh,Anantapur,Ramagiri,42,0,29,hab,27,2,26,16,13,2,5022,20,14.32681774828256,77.46900386816267,0
Andhra Pradesh,Anantapur,Raptadu,26,1,26,osm,25,1,23,3,0,2,5106,20,14.540034613177928,77.57521329862207,0
Andhra Pradesh,Anantapur,Rayadurg,28,0,29,osm,27,2,26,2,-1,2,5134,20,14.717501535836629,76.91624912489388,0
Andhra Pradesh,Anantapur,Roddam,61,1,48,hab,48,0,51,10,13,2,5177,20,14.084465859524503,77.45269671261397,0
Andhra Pradesh,Anantapur,Rolla,86,0,53,hab,53,0,80,6,33,2,5187,20,13.845989866023535,77.10585683961455,0
Andhra Pradesh,Anantapur,Settur,36,0,34,hab,34,0,30,6,2,2,5496,20,14.41524187277302,76.99949701480281,0
Andhra Pradesh,Anantapur,Singanamala,40,0,40,hab,39,1,39,1,0,2,5652,20,14.84224786734554,77.7215446233857,0
Andhra Pradesh,Anantapur,Somandepalle,46,0,42,hab,42,0,40,6,4,2,5717,20,13.976816044049242,77.58319884681532,0
Andhra Pradesh,Anantapur,Tadimarri,30,0,45,osm,42,3,28,2,-15,2,5849,20,14.571622844398982,77.88021538762713,0
Andhra Pradesh,Anantapur,Tadpatri,51,1,45,hab,43,2,43,8,6,2,5851,20,14.93337424167783,78.01495586128345,0
Andhra Pradesh,Anantapur,Talupula,140,7,88,hab,88,0,123,17,52,2,5879,20,14.238004877315932,78.25735634661699,0
Andhra Pradesh,Anantapur,Tanakal,192,4,111,hab,111,0,173,19,81,2,5892,20,13.871788730760905,78.20721766281875,0
Andhra Pradesh,Anantapur,Uravakonda,29,0,25,hab,25,0,26,3,4,2,6229,20,14.865699909352129,77.24519778161434,0
Andhra Pradesh,Anantapur,Vajrakarur,30,0,30,hab,30,0,30,0,0,2,6264,20,15.007360498913703,77.35828456282859,0
Andhra Pradesh,Anantapur,Vidapanakal,19,0,17,hab,17,0,17,2,2,2,6350,20,15.049644096940368,77.1955647617198,0
Andhra Pradesh,Anantapur,Yadiki,39,0,43,osm,39,4,38,1,-4,2,6447,20,15.066964439184616,77.8809321703125,0
Andhra Pradesh,Anantapur,Yellanur,40,0,39,hab,39,0,39,1,1,2,6461,20,14.656067396835116,78.03396072652772,0
Andhra Pradesh,Chittoor,B Kothakota,197,1,125,hab,123,2,183,14,72,2,331,116,13.6494960292483,78.33628425669181,0
Andhra Pradesh,Chittoor,Baireddi Palle,113,0,69,hab,68,1,102,11,44,2,418,116,13.093455676669647,78.62222993776525,0
Andhra Pradesh,Chittoor,Bangarupalem,208,0,88,hab,85,3,185,23,120,2,508,116,13.191240435604142,78.90266550676604,0
Andhra Pradesh,Chittoor,Buchinaidu Khandriga,134,1,45,hab,44,1,117,17,89,2,1052,116,13.712219477779792,79.83708998154363,0
Andhra Pradesh,Chittoor,Chandragiri,242,3,68,hab,67,1,220,22,174,2,1161,116,13.553663794302,79.23532219082878,0
Andhra Pradesh,Chittoor,Chinnagottigallu,211,5,92,hab,92,0,205,6,119,2,1300,116,13.659097508566491,79.12556699664103,0
Andhra Pradesh,Chittoor,Chittoor,180,3,93,hab,84,9,152,28,87,2,1333,116,13.175577030821266,79.1169524188963,0
Andhra Pradesh,Chittoor,Chowdepalle,163,0,91,hab,91,0,148,15,72,2,1358,116,13.449245634872156,78.6795160829376,0
Andhra Pradesh,Chittoor,Gangadhara Nellore,312,3,141,hab,141,0,304,8,171,2,1840,116,13.236080520889773,79.22659959168098,0
Andhra Pradesh,Chittoor,Gangavaram,131,3,48,hab,47,1,74,57,83,2,1849,116,13.233809850466807,78.70728123762783,0
Andhra Pradesh,Chittoor,Gudipala,206,0,67,hab,67,0,186,20,139,2,2043,116,13.089912681309995,79.14869321632351,0
Andhra Pradesh,Chittoor,Gudupalle,106,2,72,hab,72,0,98,8,34,2,2048,116,12.776468038823438,78.28765224322308,0
Andhra Pradesh,Chittoor,Gurramkonda,164,1,92,hab,92,0,153,11,72,2,2083,116,13.789907388847139,78.61641354603351,0
Andhra Pradesh,Chittoor,Irala,267,1,37,hab,36,1,115,152,230,2,2305,116,13.383570214169414,78.9991802482126,0
Andhra Pradesh,Chittoor,K V P Puram,125,0,59,hab,58,1,111,14,66,2,2550,116,13.58311314411722,79.73667911677529,0
Andhra Pradesh,Chittoor,Kalakada,176,1,85,hab,84,1,157,19,91,2,2605,116,13.806633531874041,78.727852749709,0
Andhra Pradesh,Chittoor,Kalikiri,225,1,100,hab,100,0,213,12,125,2,2636,116,13.692807499998182,78.7981339886072,0
Andhra Pradesh,Chittoor,Kambhamvaripalle,390,4,168,hab,166,2,355,35,222,2,2680,116,13.815642838812762,78.89685117225667,0
Andhra Pradesh,Chittoor,Karvetinagar,186,2,48,hab,47,1,132,54,138,2,2802,116,13.413166124149782,79.42994706895198,0
Andhra Pradesh,Chittoor,Kuppam,256,0,87,hab,86,1,196,60,169,2,3273,116,12.718301436278457,78.41135125461076,0
Andhra Pradesh,Chittoor,Kurabalakota,242,0,133,hab,133,0,235,7,109,2,3275,116,13.668235218729501,78.49376951808168,0
Andhra Pradesh,Chittoor,Mandanpalle,407,8,152,hab,152,0,344,63,255,2,3639,116,13.54426227310254,78.48398572636474,0
Andhra Pradesh,Chittoor,Mulakalacheruvu,228,1,135,hab,135,0,213,15,93,2,3967,116,13.794922007596229,78.31444421654018,0
Andhra Pradesh,Chittoor,Nagalapuram,98,4,24,hab,24,0,78,20,74,2,4056,116,13.415551436940815,79.82072181518274,0
Andhra Pradesh,Chittoor,Nagari,154,2,50,hab,50,0,132,22,104,2,4065,116,13.332300487754782,79.59740126700824,0
Andhra Pradesh,Chittoor,Narayanavanam,86,23,23,hab,23,0,69,17,63,2,4169,116,13.48054496340842,79.61540825779137,0
Andhra Pradesh,Chittoor,Nimmanapalle,177,0,94,hab,94,0,172,5,83,2,4310,116,13.550177847450525,78.64928374361908,0
Andhra Pradesh,Chittoor,Nindra,123,6,41,hab,39,2,116,7,82,2,4312,116,13.3697438562822,79.69204664057688,0
Andhra Pradesh,Chittoor,Pakala,289,11,79,hab,79,0,218,71,210,2,4433,116,13.484603575975777,79.08218354268274,0
Andhra Pradesh,Chittoor,Palamaner,101,0,48,hab,48,0,85,16,53,2,4450,116,13.148484997755494,78.75809038962807,0
Andhra Pradesh,Chittoor,Palasamudram,137,2,29,hab,29,0,104,33,108,2,4454,116,13.20637405124138,79.35894306258021,0
Andhra Pradesh,Chittoor,Pedda Panjani,167,3,94,hab,89,5,142,25,73,2,4669,116,13.298765618687804,78.67394568458128,0
Andhra Pradesh,Chittoor,Peddamandyam,160,1,102,hab,102,0,155,5,58,2,4672,116,13.910524197417068,78.51491492465235,0
Andhra Pradesh,Chittoor,Peddathippasamudram,143,0,95,hab,95,0,132,11,48,2,4677,116,13.707328045491863,78.18228347553884,0
Andhra Pradesh,Chittoor,Penumuru,258,0,82,hab,82,0,236,22,176,2,4702,116,13.333915924649862,79.17706705111475,0
Andhra Pradesh,Chittoor,Pichatur,135,3,39,hab,38,1,122,13,96,2,4746,116,13.366099683016019,79.770233043481,0
Andhra Pradesh,Chittoor,Pileru,241,2,125,hab,122,3,229,12,116,2,4751,116,13.712769853683099,78.949670467512,0
Andhra Pradesh,Chittoor,Pulicherla,225,0,76,hab,76,0,188,37,149,2,4845,116,13.574056144957646,79.06613210385078,0
Andhra Pradesh,Chittoor,Punganur,187,8,88,hab,86,2,141,46,99,2,4856,116,13.388934647103426,78.55960129573475,0
Andhra Pradesh,Chittoor,Puthalapattu,294,4,67,hab,67,0,215,79,227,2,4886,116,13.365779303016307,79.08820788119718,0
Andhra Pradesh,Chittoor,Puttur,138,7,50,hab,50,0,111,27,88,2,4889,116,13.420766494931883,79.5416467598366,0
Andhra Pradesh,Chittoor,Rama Kuppam,144,1,75,hab,75,0,118,26,69,2,5015,116,12.84997559894837,78.52312144061803,0
Andhra Pradesh,Chittoor,Ramachandrapuram,179,3,59,hab,59,0,142,37,120,2,5018,116,13.523292862473445,79.3616629765261,0
Andhra Pradesh,Chittoor,Ramasamudram,160,4,88,hab,88,0,128,32,72,2,5031,116,13.387777353702345,78.44463077850457,0
Andhra Pradesh,Chittoor,Renigunta,158,1,16,hab,16,0,46,112,142,2,5157,116,13.683351602124098,79.5002949277548,0
Andhra Pradesh,Chittoor,Rompicherla,194,0,85,hab,84,1,189,5,109,2,5190,116,13.699770457924451,79.03841730749842,0
Andhra Pradesh,Chittoor,Santhi Puram,145,1,87,hab,86,1,125,20,58,2,5386,116,12.861977248114382,78.3809088112155,0
Andhra Pradesh,Chittoor,Satyavedu,71,1,48,hab,46,2,64,7,23,2,5447,116,13.456784765116105,79.92863452109646,0
Andhra Pradesh,Chittoor,Sodam,187,3,57,hab,57,0,107,80,130,2,5705,116,13.550522390367329,78.88602041236729,0
Andhra Pradesh,Chittoor,Somala,212,0,92,hab,92,0,185,27,120,2,5716,116,13.434323589344833,78.82991860933923,0
Andhra Pradesh,Chittoor,Srikalahasti,178,3,94,hab,92,2,159,19,84,2,5762,116,13.80829221532127,79.57754439565711,0
Andhra Pradesh,Chittoor,Srirangarajapuram,179,3,64,hab,64,0,166,13,115,2,5770,116,13.300778596106031,79.32330219225942,0
Andhra Pradesh,Chittoor,Thamballapalle,308,0,165,hab,162,3,291,17,143,2,5985,116,13.824142877379286,78.4327360017414,0
Andhra Pradesh,Chittoor,Thavanampalle,227,4,71,hab,71,0,201,26,156,2,6002,116,13.28449771066007,78.96895474090914,0
Andhra Pradesh,Chittoor,Thottambedu,174,1,57,hab,56,1,146,28,117,2,6059,116,13.789059525216224,79.7252176069081,0
Andhra Pradesh,Chittoor,Tirupati Rural,224,0,25,hab,25,0,69,155,199,2,6100,116,13.59405577021041,79.4130393690617,0
Andhra Pradesh,Chittoor,Tirupati Urban,85,0,0,hab,0,0,0,85,85,2,6101,116,13.686413971696368,79.36800543981157,0
Andhra Pradesh,Chittoor,Vadamalapeta,128,0,18,hab,18,0,52,76,110,2,6253,116,13.528660645472721,79.50778845657103,0
Andhra Pradesh,Chittoor,Varadaiahpalem,167,2,74,hab,69,5,150,17,93,2,6286,116,13.582321638258952,79.9127324287589,0
Andhra Pradesh,Chittoor,Vayalpad,125,1,81,hab,81,0,123,2,44,2,6297,116,13.647505288800113,78.68042277898753,0
Andhra Pradesh,Chittoor,Veduru Kuppam,230,3,45,hab,45,0,121,109,185,2,6302,116,13.415236511216113,79.30329707510651,0
Andhra Pradesh,Chittoor,Venkatagiri Kota,174,1,102,hab,102,0,157,17,72,2,6337,116,12.985640493407377,78.54779847824452,0
Andhra Pradesh,Chittoor,Vijaya Puram,118,3,36,hab,36,0,102,16,82,2,6356,116,13.278741245197125,79.71655379015664,0
Andhra Pradesh,Chittoor,Yadamari,205,0,78,hab,78,0,194,11,127,2,6444,116,13.126866024166457,79.00301078846375,0
Andhra Pradesh,Chittoor,Yerpedu,233,2,67,hab,67,0,204,29,166,2,6468,116,13.692617860985719,79.59198260131271,0
Andhra Pradesh,Chittoor,Yerravaripalem,276,1,107,hab,107,0,244,32,169,2,6471,116,13.770808375285908,79.13297894606484,0
Andhra Pradesh,East Godavari,Addateegala,102,1,38,hab,36,2,41,61,64,2,20,167,17.50358128487508,82.06068968693326,0
Andhra Pradesh,East Godavari,Ainavilli,69,1,37,hab,37,0,60,9,32,2,44,167,16.654952723689117,82.01862403812035,0
Andhra Pradesh,East Godavari,Alamuru,24,2,21,hab,21,0,23,1,3,2,73,167,16.81904722312854,81.87066588839018,0
Andhra Pradesh,East Godavari,Allavaram,116,0,23,hab,23,0,77,39,93,2,95,167,16.477634417917812,81.99945303493305,0
Andhra Pradesh,East Godavari,Amalapuram,104,2,29,hab,29,0,77,27,75,2,106,167,16.574464811092952,82.00568584751107,0
Andhra Pradesh,East Godavari,Ambajipeta,81,2,18,hab,16,2,53,28,63,2,128,167,16.61699305502429,81.94408892740505,0
Andhra Pradesh,East Godavari,Anaparthi,17,1,15,hab,15,0,16,1,2,2,179,167,16.91010446870591,81.96566800593074,0
Andhra Pradesh,East Godavari,Atreyapuram,59,0,20,hab,19,1,52,7,39,2,300,167,16.828874401510618,81.78547780943765,0
Andhra Pradesh,East Godavari,Bhadrachalam,128,0,6,hab,6,0,12,116,122,2,6938,167,17.68940539123845,81.0127130284815,0
Andhra Pradesh,East Godavari,Biccavolu,19,0,16,hab,15,1,15,4,3,2,901,167,16.953383708527983,82.02851670570253,0
Andhra Pradesh,East Godavari,Chintur,122,0,49,hab,46,3,57,65,73,2,6890,167,17.758635664294314,81.40843908813883,0
Andhra Pradesh,East Godavari,Devipatnam,84,3,89,osm,77,12,80,4,-5,2,1533,167,17.3636245392225,81.6757766377406,0
Andhra Pradesh,East Godavari,Gandepalle,20,0,16,hab,15,1,16,4,4,2,1829,167,17.145553681184747,81.99159748331513,0
Andhra Pradesh,East Godavari,Gangavaram,59,1,34,hab,33,1,34,25,25,2,1850,167,17.388354931359384,81.94763297271858,0
Andhra Pradesh,East Godavari,Gokavaram,32,0,27,hab,26,1,29,3,5,2,1977,167,17.25788570650739,81.90678755370323,0
Andhra Pradesh,East Godavari,Gollaprolu,13,0,12,hab,11,1,12,1,1,2,1989,167,17.192224667650237,82.30859646042434,0
Andhra Pradesh,East Godavari,I Polavaram,52,4,23,hab,21,2,32,20,29,2,2269,167,16.662836617624546,82.20313171712222,0
Andhra Pradesh,East Godavari,Jaggampeta,25,1,23,hab,21,2,21,4,2,2,2343,167,17.215141399836035,82.03909447340952,0
Andhra Pradesh,East Godavari,Kadiam,17,0,13,hab,13,0,16,1,4,2,2569,167,16.899612893944784,81.83332541900174,0
Andhra Pradesh,East Godavari,Kajuluru,37,2,41,osm,37,4,31,6,-4,2,2589,167,16.798679175751566,82.1619675801833,0
Andhra Pradesh,East Godavari,Kakinada (Rural),41,0,19,hab,19,0,29,12,22,2,2594,167,16.987105352659242,82.2443552073301,0
Andhra Pradesh,East Godavari,Kapileswarapuram,34,0,26,hab,26,0,31,3,8,2,2744,167,16.760206009829478,81.94403374977264,0
Andhra Pradesh,East Godavari,Karapa,40,1,33,hab,32,1,37,3,7,2,2767,167,16.885383653691918,82.1632169727579,0
Andhra Pradesh,East Godavari,Katrenikona,66,1,49,hab,39,10,48,18,17,2,2847,167,16.610440012933232,82.23695747567456,0
Andhra Pradesh,East Godavari,Kirlampudi,22,2,14,hab,14,0,19,3,8,2,3045,167,17.195933531150207,82.14468360205872,0
Andhra Pradesh,East Godavari,Korukonda,23,0,21,hab,21,0,19,4,2,2,3142,167,17.155673412147884,81.82373337864645,0
Andhra Pradesh,East Godavari,Kotananduru,70,0,63,hab,60,3,63,7,7,2,3155,167,17.429726725199117,82.42642263490647,0
Andhra Pradesh,East Godavari,Kothapalli,57,1,30,hab,30,0,52,5,27,2,3167,167,17.111434364217136,82.33201404815283,0
Andhra Pradesh,East Godavari,Kothapeta,114,5,21,hab,20,1,79,35,93,2,3169,167,16.689620357293588,81.90332269527654,0
Andhra Pradesh,East Godavari,Kunavaram,75,4,2,hab,2,0,2,73,73,2,6892,167,17.645470053721592,81.2455425509598,0
Andhra Pradesh,East Godavari,Malikipuram,78,2,14,hab,14,0,45,33,64,2,3594,167,16.4106002084314,81.84898325909148,0
Andhra Pradesh,East Godavari,Mamidikuduru,51,1,25,hab,25,0,45,6,26,2,3616,167,16.497544793741163,81.93049236058978,0
Andhra Pradesh,East Godavari,Mandapeta,18,0,18,hab,18,0,17,1,0,2,3641,167,16.896342446128617,81.91084358658206,0
Andhra Pradesh,East Godavari,Maredumilli,69,2,98,osm,76,22,65,4,-29,2,3724,167,17.642276422296547,81.69455201823811,0
Andhra Pradesh,East Godavari,Mummidivaram,77,4,34,hab,32,2,66,11,43,2,3980,167,16.639032993576485,82.11274912713252,0
Andhra Pradesh,East Godavari,P Gannavaram,96,0,33,hab,30,3,71,25,63,2,4402,167,16.587437191342737,81.88252090043736,0
Andhra Pradesh,East Godavari,Pamarru,76,6,45,hab,45,0,62,14,31,2,4484,167,16.74146707997247,82.05926321727443,0
Andhra Pradesh,East Godavari,Pedapudi,36,0,27,hab,26,1,34,2,9,2,4665,167,16.937375844436684,82.12175450118619,0
Andhra Pradesh,East Godavari,Peddapuram,25,0,27,osm,25,2,25,0,-2,2,4676,167,17.091306972804745,82.11763844472053,0
Andhra Pradesh,East Godavari,Pithapuram,30,1,28,hab,27,1,26,4,2,2,4777,167,17.137723385475997,82.22608933146978,0
Andhra Pradesh,East Godavari,Prathipadu,38,0,31,hab,30,1,34,4,7,2,4831,167,17.310962348782002,82.23486490080013,0
Andhra Pradesh,East Godavari,Rajahmundry(Rural),16,1,12,hab,11,1,12,4,4,2,4959,167,17.01275818385798,81.77942816451323,0
Andhra Pradesh,East Godavari,Rajanagaram,36,1,34,hab,32,2,34,2,2,2,4964,167,17.036107877547252,81.88536869553421,0
Andhra Pradesh,East Godavari,Rajavommangi,81,0,45,hab,44,1,50,31,36,2,4973,167,17.516080674753415,82.21894274889922,0
Andhra Pradesh,East Godavari,Ramachandrapuram,68,3,47,hab,42,5,67,1,21,2,5019,167,16.819732598110892,82.0610645383375,0
Andhra Pradesh,East Godavari,Rampachodavaram,95,6,73,hab,64,9,70,25,22,2,5057,167,17.428388107944517,81.78853747731678,0
Andhra Pradesh,East Godavari,Rangampeta,27,0,25,hab,25,0,25,2,2,2,5081,167,17.054606119917313,81.9908035432424,0
Andhra Pradesh,East Godavari,Ravulapalem,45,3,18,hab,18,0,39,6,27,2,5129,167,16.733247798536688,81.8362357699002,0
Andhra Pradesh,East Godavari,Rayavaram,31,0,18,hab,17,1,29,2,13,2,5137,167,16.844203415090032,82.00401853776009,0
Andhra Pradesh,East Godavari,Razole,79,2,15,hab,14,1,48,31,64,2,5139,167,16.457080222557682,81.87868587077581,0
Andhra Pradesh,East Godavari,Sakhinetipalle,101,0,19,hab,19,0,71,30,82,2,5285,167,16.389428884740205,81.76079330451431,0
Andhra Pradesh,East Godavari,Samalkota,28,0,25,hab,25,0,28,0,3,2,5314,167,17.024073213735747,82.1630363202017,0
Andhra Pradesh,East Godavari,Sankhavaram,49,2,31,hab,31,0,40,9,18,2,5373,167,17.338187205840647,82.34030338727378,0
Andhra Pradesh,East Godavari,Seethanagaram,31,0,25,hab,25,0,31,0,6,2,5466,167,17.163318202014608,81.7100425029574,0
Andhra Pradesh,East Godavari,Tallarevu,53,1,38,hab,34,4,45,8,15,2,5876,167,16.81305695580774,82.25803982813825,0
Andhra Pradesh,East Godavari,Thondangi,54,0,38,hab,38,0,50,4,16,2,6051,167,17.232139721641634,82.43625147016715,0
Andhra Pradesh,East Godavari,Tuni,64,1,41,hab,40,1,61,3,23,2,6155,167,17.37116226512181,82.51458793591505,0
Andhra Pradesh,East Godavari,Uppalaguptam,79,0,28,hab,28,0,60,19,51,2,6225,167,16.526020676601288,82.08850457114455,0
Andhra Pradesh,East Godavari,Vararamachandrapuram,73,0,51,hab,49,2,55,18,22,2,6895,167,17.573168634125125,81.39904788388071,0
Andhra Pradesh,East Godavari,Y Ramavaram,165,0,173,osm,145,28,149,16,-8,2,6441,167,17.771695305500042,81.90782274046316,0
Andhra Pradesh,East Godavari,Yeleswaram,18,1,12,hab,11,1,11,7,6,2,6458,167,17.30863887007033,82.11862078659637,0
Andhra Pradesh,Guntur,Achampeta,29,1,29,osm,28,1,27,2,0,2,10,206,16.638440841463833,80.13010887460783,0
Andhra Pradesh,Guntur,Amaravathi,23,0,27,osm,27,0,23,0,-4,2,112,206,16.549462226355523,80.33116437271718,0
Andhra Pradesh,Guntur,Amruthalur,19,0,15,hab,14,1,17,2,4,2,164,206,16.109834064198918,80.65169756201529,0
Andhra Pradesh,Guntur,Bapatla,53,1,44,hab,40,4,45,8,9,2,549,206,15.920830913910805,80.46211225455865,0
Andhra Pradesh,Guntur,Bellamkonda,22,1,24,osm,21,3,20,2,-2,2,707,206,16.636984717930442,80.02613331706276,0
Andhra Pradesh,Guntur,Bhattiprolu,34,2,26,hab,26,0,32,2,8,2,823,206,16.08345248786172,80.80851588203326,0
Andhra Pradesh,Guntur,Bollapalle,59,0,46,hab,45,1,48,11,13,2,1018,206,16.222830876926153,79.6400233142683,0
Andhra Pradesh,Guntur,Chebrole,22,0,17,hab,17,0,19,3,5,2,1217,206,16.228213616954744,80.52999891233381,0
Andhra Pradesh,Guntur,Cherukupalle,59,0,44,hab,44,0,59,0,15,2,1243,206,16.047994676803878,80.68793255820476,0
Andhra Pradesh,Guntur,Chilakaluripet,30,3,29,osm,27,2,27,3,1,2,1284,206,16.089469752672418,80.13905478487357,0
Andhra Pradesh,Guntur,Dachepalle,23,0,22,hab,22,0,23,0,1,2,1387,206,16.632834068247664,79.74720227777031,0
Andhra Pradesh,Guntur,Duggirala,22,1,18,hab,18,0,20,2,4,2,1688,206,16.356847212898746,80.63974060023813,0
Andhra Pradesh,Guntur,Durgi,25,0,16,hab,16,0,17,8,9,2,1716,206,16.369552575327297,79.50859383694596,0
Andhra Pradesh,Guntur,Edlapadu,24,0,23,hab,23,0,22,2,1,2,1727,206,16.200476966581054,80.25889153729797,0
Andhra Pradesh,Guntur,Guntur,33,0,21,hab,21,0,23,10,12,2,2075,206,16.300103154988978,80.41588593722851,0
Andhra Pradesh,Guntur,Gurazala,22,1,17,hab,17,0,17,5,5,2,2078,206,16.567068841060433,79.62172189117328,0
Andhra Pradesh,Guntur,Ipuru,36,1,24,hab,23,1,24,12,12,2,2303,206,16.234679613218248,79.77594288553954,0
Andhra Pradesh,Guntur,Kakumanu,30,1,20,hab,20,0,23,7,10,2,2600,206,16.061875641276284,80.42492584978069,0
Andhra Pradesh,Guntur,Karempudi,23,0,19,hab,19,0,21,2,4,2,2772,206,16.44280810982712,79.7060032813197,0
Andhra Pradesh,Guntur,Karlapalem,55,1,34,hab,33,1,52,3,21,2,2787,206,15.93330134293499,80.56269819072592,0
Andhra Pradesh,Guntur,Kollipara,34,0,25,hab,25,0,31,3,9,2,3100,206,16.29737313813484,80.73178530314418,0
Andhra Pradesh,Guntur,Kollur,35,1,32,hab,32,0,34,1,3,2,3101,206,16.17744648258995,80.80344073389286,0
Andhra Pradesh,Guntur,Krosuru,21,0,22,osm,21,1,21,0,-1,2,3209,206,16.530228255641507,80.11802731200531,0
Andhra Pradesh,Guntur,Machavaram,19,0,19,hab,19,0,19,0,0,2,3455,206,16.593205630450413,79.87202356211121,0
Andhra Pradesh,Guntur,Macherla,31,0,33,osm,25,8,29,2,-2,2,3456,206,16.50238287485244,79.35879218065119,0
Andhra Pradesh,Guntur,Mangalagiri,18,0,14,hab,14,0,13,5,4,2,3662,206,16.426986214566394,80.56766755407642,0
Andhra Pradesh,Guntur,Medikonduru,19,0,18,hab,18,0,19,0,1,2,3806,206,16.36923269242137,80.29870046735483,0
Andhra Pradesh,Guntur,Muppalla,16,1,15,hab,15,0,15,1,1,2,4002,206,16.35151308422708,80.09547520483984,0
Andhra Pradesh,Guntur,Nadendla,20,0,20,hab,20,0,20,0,0,2,4048,206,16.20378673625721,80.15524996659583,0
Andhra Pradesh,Guntur,Nagaram,113,1,67,hab,67,0,100,13,46,2,4064,206,15.989715329320388,80.7377454575702,0
Andhra Pradesh,Guntur,Nakarikallu,19,0,20,osm,19,1,19,0,-1,2,4098,206,16.348255700591192,79.91741251276311,0
Andhra Pradesh,Guntur,Narasaraopeta,36,2,27,hab,26,1,30,6,9,2,4165,206,16.218195542267562,80.03960727149634,0
Andhra Pradesh,Guntur,Nizampatnam,80,3,63,hab,58,5,76,4,17,2,4329,206,15.884596370745331,80.74051972180246,0
Andhra Pradesh,Guntur,Nuzendla,62,0,50,hab,50,0,55,7,12,2,4361,206,15.94941594052931,79.71377374756847,0
Andhra Pradesh,Guntur,Pedakakani,14,0,13,hab,13,0,13,1,1,2,4659,206,16.33011016130829,80.5187701301596,0
Andhra Pradesh,Guntur,Pedakurapadu,20,0,20,hab,20,0,20,0,0,2,4660,206,16.48924219233897,80.27444075262994,0
Andhra Pradesh,Guntur,Pedanandipadu,19,0,23,osm,23,0,19,0,-4,2,4662,206,16.092885429998958,80.31764636338097,0
Andhra Pradesh,Guntur,Phirangipuram,20,0,19,hab,19,0,20,0,1,2,4734,206,16.3035142617978,80.21904787371712,0
Andhra Pradesh,Guntur,Piduguralla,22,0,17,hab,15,2,17,5,5,2,4748,206,16.473758510442078,79.84886702846316,0
Andhra Pradesh,Guntur,Pittalavanipalem,31,0,27,hab,26,1,31,0,4,2,4780,206,15.983797421403626,80.60823118350599,0
Andhra Pradesh,Guntur,Ponnur,32,0,31,hab,30,1,32,0,1,2,4806,206,16.081549424549838,80.53144691039118,0
Andhra Pradesh,Guntur,Prathipadu,26,0,25,hab,23,2,26,0,1,2,4832,206,16.17993596881601,80.34233404170362,0
Andhra Pradesh,Guntur,Rajupalem,21,0,18,hab,18,0,19,2,3,2,5007,206,16.431761019781028,79.98337546815476,0
Andhra Pradesh,Guntur,Rentachintala,16,0,12,hab,12,0,14,2,4,2,5158,206,16.56318240042059,79.50252375129807,0
Andhra Pradesh,Guntur,Repalle,78,0,39,hab,36,3,61,17,39,2,5163,206,15.948539647270868,80.85254885989117,0
Andhra Pradesh,Guntur,Rompicherla,36,0,30,hab,30,0,32,4,6,2,5189,206,16.233548012839858,79.9213894769881,0
Andhra Pradesh,Guntur,Sattenapalle,29,0,28,hab,28,0,28,1,1,2,5444,206,16.428100227674143,80.16300855879643,0
Andhra Pradesh,Guntur,Savalyapuram,24,0,22,hab,22,0,23,1,2,2,5451,206,16.102163855726655,79.84195653021942,0
Andhra Pradesh,Guntur,Tadikonda,21,1,18,hab,17,1,19,2,3,2,5848,206,16.416664250477073,80.41013246010009,0
Andhra Pradesh,Guntur,Tenali,23,0,19,hab,19,0,18,5,4,2,5953,206,16.260841731469935,80.6395526066608,0
Andhra Pradesh,Guntur,Thadepalle,12,0,13,osm,11,2,11,1,-1,2,5968,206,16.468662579187647,80.61326448930329,0
Andhra Pradesh,Guntur,Thullur,21,0,23,osm,23,0,21,0,-2,2,6067,206,16.52074841336454,80.47772470214036,0
Andhra Pradesh,Guntur,Tsundur,22,0,17,hab,16,1,19,3,5,2,6141,206,16.17101467003502,80.60093449298743,0
Andhra Pradesh,Guntur,Vatticherukuru,17,0,16,hab,16,0,16,1,1,2,6295,206,16.195219334353638,80.43135637059838,0
Andhra Pradesh,Guntur,Veldurthi,33,0,25,hab,25,0,28,5,8,2,6312,206,16.343543979430414,79.31452223952223,0
Andhra Pradesh,Guntur,Vemuru,23,0,16,hab,16,0,19,4,7,2,6332,206,16.173285698621978,80.7273399484505,0
Andhra Pradesh,Guntur,Vinukonda,48,0,32,hab,31,1,34,14,16,2,6372,206,16.03524334830729,79.72249610119371,0
Andhra Pradesh,Krishna,A Konduru,26,0,32,osm,25,7,26,0,-6,2,2,315,16.959236893024933,80.6475603086905,0
Andhra Pradesh,Krishna,Agiripalle,37,0,38,osm,38,0,35,2,-1,2,33,315,16.68303441423229,80.78341336661009,0
Andhra Pradesh,Krishna,Avanigadda,31,1,15,hab,15,0,23,8,16,2,321,315,16.007331665003242,80.92755590986837,0
Andhra Pradesh,Krishna,Bantumilli,55,1,42,hab,42,0,50,5,13,2,545,315,16.373654569099088,81.25057153291962,0
Andhra Pradesh,Krishna,Bapulapadu,43,3,43,osm,39,4,39,4,0,2,551,315,16.636541859615637,80.93814550975392,0
Andhra Pradesh,Krishna,Challapalli,31,1,27,hab,27,0,27,4,4,2,1129,315,16.128011949118232,80.94052256121074,0
Andhra Pradesh,Krishna,Chandarlapadu,32,0,28,hab,28,0,30,2,4,2,1149,315,16.686943109577903,80.22116936691766,0
Andhra Pradesh,Krishna,Chatrai,37,1,33,hab,28,5,32,5,4,2,1197,315,16.994312176526858,80.8817642034033,0
Andhra Pradesh,Krishna,G Konduru,33,0,26,hab,25,1,27,6,7,2,1790,315,16.694832953138857,80.600832463104,0
Andhra Pradesh,Krishna,Gampalagudem,38,0,41,osm,38,3,34,4,-3,2,1824,315,16.997902707904935,80.48238771763128,0
Andhra Pradesh,Krishna,Gannavaram,42,1,26,hab,26,0,28,14,16,2,1864,315,16.57315964758027,80.77604965365654,0
Andhra Pradesh,Krishna,Ghantasala,31,0,38,osm,37,1,30,1,-7,2,1919,315,16.17565685358022,80.92576604540012,0
Andhra Pradesh,Krishna,Gudivada,36,1,32,hab,31,1,35,1,4,2,2044,315,16.43095655699859,81.01866446989294,0
Andhra Pradesh,Krishna,Gudlavalleru,50,4,40,hab,36,4,44,6,10,2,2046,315,16.34246491525062,81.06578812002834,0
Andhra Pradesh,Krishna,Gudur,56,1,49,hab,48,1,53,3,7,2,2050,315,16.224103739818613,81.07133368623327,0
Andhra Pradesh,Krishna,Ibrahimpatnam,18,0,15,hab,14,1,13,5,3,2,2272,315,16.628389042034634,80.5005141920731,0
Andhra Pradesh,Krishna,Jaggayyapeta,28,0,24,hab,22,2,22,6,4,2,2344,315,16.883125195468164,80.10751332060616,0
Andhra Pradesh,Krishna,Kaikalur,50,0,43,hab,43,0,49,1,7,2,2582,315,16.584099428658597,81.27386750939861,0
Andhra Pradesh,Krishna,Kalidindi,65,0,51,hab,49,2,61,4,14,2,2633,315,16.483483131717385,81.31284865774117,0
Andhra Pradesh,Krishna,Kanchika Cherla,18,0,18,hab,18,0,18,0,0,2,2697,315,16.664005210615013,80.37173987266603,0
Andhra Pradesh,Krishna,Kankipadu,26,1,25,hab,24,1,24,2,1,2,2727,315,16.445458369649092,80.77995885648173,0
Andhra Pradesh,Krishna,Koduru,42,0,37,hab,37,0,40,2,5,2,3074,315,15.988564234902062,81.03874187421789,0
Andhra Pradesh,Krishna,Kruthivennu,48,0,35,hab,33,2,35,13,13,2,3211,315,16.36903203679761,81.39011000426697,0
Andhra Pradesh,Krishna,Machilipatnam,99,1,74,hab,71,3,86,13,25,2,3461,315,16.145654685647603,81.14363588952173,0
Andhra Pradesh,Krishna,Mandavalli,51,0,42,hab,41,1,47,4,9,2,3644,315,16.537439315806722,81.14757603215182,0
Andhra Pradesh,Krishna,Mopidevi,41,1,33,hab,33,0,35,6,8,2,3916,315,16.07636509029536,80.94200180123973,0
Andhra Pradesh,Krishna,Movva,36,1,32,hab,30,2,33,3,4,2,3942,315,16.236834112619686,80.96319084244439,0
Andhra Pradesh,Krishna,Mudinepalli,79,1,44,hab,42,2,62,17,35,2,3952,315,16.430958970290966,81.16261671480189,0
Andhra Pradesh,Krishna,Musunuru,32,1,40,osm,38,2,31,1,-8,2,4024,315,16.83685508302025,80.94562544861827,0
Andhra Pradesh,Krishna,Mylavaram,28,0,23,hab,22,1,25,3,5,2,4035,315,16.796524465142245,80.65552361338628,0
Andhra Pradesh,Krishna,Nagayalanka,48,1,43,hab,43,0,46,2,5,2,4070,315,15.833450531428392,80.93832486472365,0
Andhra Pradesh,Krishna,Nandigama,32,0,31,hab,30,1,29,3,1,2,4143,315,16.78544588225141,80.29190453569122,0
Andhra Pradesh,Krishna,Nandivada,46,0,44,hab,42,2,43,3,2,2,4147,315,16.520169977127928,81.02498527510419,0
Andhra Pradesh,Krishna,Nuzvid,38,0,58,osm,43,15,35,3,-20,2,4362,315,16.784012166756526,80.85851057950026,0
Andhra Pradesh,Krishna,Pamarru,54,0,45,hab,43,2,45,9,9,2,4485,315,16.320103882825027,80.97216548380784,0
Andhra Pradesh,Krishna,Pamidimukkala,39,2,49,osm,42,7,38,1,-10,2,4488,315,16.290453493667542,80.86660057068761,0
Andhra Pradesh,Krishna,Pedana,62,2,53,hab,50,3,59,3,9,2,4661,315,16.315442187908186,81.16457579239562,0
Andhra Pradesh,Krishna,Pedaparupudi,30,1,32,osm,30,2,29,1,-2,2,4664,315,16.43238336218824,80.93521992355835,0
Andhra Pradesh,Krishna,Penamaluru,11,0,7,hab,7,0,8,3,4,2,4689,315,16.458746880781355,80.7056456702496,0
Andhra Pradesh,Krishna,Penuganchiprolu,17,0,22,osm,20,2,17,0,-5,2,4699,315,16.86321786117203,80.25216727218996,0
Andhra Pradesh,Krishna,Reddigudem,29,0,27,hab,24,3,25,4,2,2,5144,315,16.870190610686574,80.72575936627075,0
Andhra Pradesh,Krishna,Thotlavalluru,33,2,24,hab,24,0,27,6,9,2,6058,315,16.33540456913373,80.78966784232833,0
Andhra Pradesh,Krishna,Tiruvuru,32,1,30,hab,27,3,25,7,2,2,6111,315,17.07751631607422,80.58903509930535,0
Andhra Pradesh,Krishna,Unguturu,34,0,39,osm,36,3,32,2,-5,2,6219,315,16.517339885108196,80.87165431289615,0
Andhra Pradesh,Krishna,Vatsavai,29,1,26,hab,26,0,27,2,3,2,6294,315,16.95399477124328,80.21306496880773,0
Andhra Pradesh,Krishna,Veerullapadu,27,0,26,hab,26,0,25,2,1,2,6308,315,16.76128752681472,80.42690403917288,0
Andhra Pradesh,Krishna,Vijayawada Rural,27,1,17,hab,17,0,18,9,10,2,6357,315,16.573426242899263,80.64738470317427,0
Andhra Pradesh,Krishna,Vissannapet,34,0,32,hab,32,0,28,6,2,2,6385,315,16.984179837434084,80.76586634571517,0
Andhra Pradesh,Krishna,Vuyyuru,17,0,22,osm,15,7,15,2,-5,2,6391,315,16.40071296840903,80.85914212379893,0
Andhra Pradesh,Kurnool,Adoni,47,0,43,hab,40,3,42,5,4,2,24,319,15.635860604191913,77.23908864916774,0
Andhra Pradesh,Kurnool,Allagadda,41,1,35,hab,30,5,33,8,6,2,94,319,15.13837262137842,78.52717870996217,0
Andhra Pradesh,Kurnool,Alur,22,0,20,hab,19,1,20,2,2,2,102,319,15.41229947643367,77.2560823060496,0
Andhra Pradesh,Kurnool,Aspari,33,0,31,hab,31,0,32,1,2,2,270,319,15.518464638546961,77.393402460245,0
Andhra Pradesh,Kurnool,Atmakur,25,1,20,hab,15,5,19,6,5,2,292,319,15.895795955421322,78.7103993845069,0
Andhra Pradesh,Kurnool,Banaganapalle,52,1,55,osm,52,3,48,4,-3,2,490,319,15.354461740340007,78.21171193028981,0
Andhra Pradesh,Kurnool,Bandi Atmakur,25,0,23,hab,22,1,24,1,2,2,496,319,15.586710063913245,78.63660196391753,0
Andhra Pradesh,Kurnool,Bethamcherla,35,2,44,osm,32,12,30,5,-9,2,735,319,15.458344968708792,78.0992944399277,0
Andhra Pradesh,Kurnool,C.Belagal,22,1,22,osm,22,0,21,1,0,2,1090,319,15.833525728204815,77.70807521157913,0
Andhra Pradesh,Kurnool,Chagalamarri,33,1,27,hab,27,0,29,4,6,2,1101,319,15.015669426814693,78.62733031125885,0
Andhra Pradesh,Kurnool,Chippagiri,16,0,15,hab,15,0,15,1,1,2,1315,319,15.24036090565286,77.28492744424877,0
Andhra Pradesh,Kurnool,Devanakonda,45,0,46,osm,43,3,42,3,-1,2,1524,319,15.562788285545142,77.61005833333074,0
Andhra Pradesh,Kurnool,Dhone,49,1,45,hab,43,2,42,7,4,2,1613,319,15.3772700391138,77.8436859355276,0
Andhra Pradesh,Kurnool,Dornipadu,14,7,7,hab,7,0,6,8,7,2,1670,319,15.227944209341278,78.41387683610883,0
Andhra Pradesh,Kurnool,Gadivemula,22,1,21,hab,20,1,20,2,1,2,1798,319,15.642200516135384,78.40191510298949,0
Andhra Pradesh,Kurnool,Gonegandla,28,1,29,osm,28,1,27,1,-1,2,1998,319,15.700715452763873,77.6251273325569,0
Andhra Pradesh,Kurnool,Gospadu,22,1,23,osm,20,3,21,1,-1,2,2020,319,15.353036828261802,78.43827654203866,0
Andhra Pradesh,Kurnool,Gudur,12,0,11,hab,11,0,11,1,1,2,2052,319,15.769649083315402,77.81510287690135,0
Andhra Pradesh,Kurnool,Halaharvi,24,0,23,hab,23,0,23,1,1,2,2109,319,15.3133078348704,77.1451329508977,0
Andhra Pradesh,Kurnool,Holagunda,28,4,19,hab,19,0,21,7,9,2,2236,319,15.506438364636837,77.09425446943168,0
Andhra Pradesh,Kurnool,Jupadu Bungalow,19,3,14,hab,13,1,13,6,5,2,2546,319,15.83788969579585,78.37892076100644,0
Andhra Pradesh,Kurnool,Kallur,31,1,30,hab,28,2,29,2,1,2,2646,319,15.724109587482456,77.96746362571285,0
Andhra Pradesh,Kurnool,Kodumur,21,0,21,hab,20,1,20,1,0,2,3071,319,15.679901927176978,77.81569748061362,0
Andhra Pradesh,Kurnool,Koilkuntla,20,2,15,hab,14,1,15,5,5,2,3081,319,15.245250847080337,78.3293569456118,0
Andhra Pradesh,Kurnool,Kolimigundla,35,1,29,hab,29,0,30,5,6,2,3093,319,15.040568113925469,78.12214878718169,0
Andhra Pradesh,Kurnool,Kosigi,34,0,26,hab,25,1,30,4,8,2,3146,319,15.887445994171818,77.2338021846769,0
Andhra Pradesh,Kurnool,Kothapalle,32,2,12,hab,10,2,11,21,20,2,3166,319,15.992295207562952,78.49347114406021,0
Andhra Pradesh,Kurnool,Kowthalam,43,0,35,hab,34,1,40,3,8,2,3192,319,15.79729704653341,77.12755078925235,0
Andhra Pradesh,Kurnool,Krishnagiri,36,0,36,hab,36,0,34,2,0,2,3203,319,15.525634652411641,77.78462501855111,0
Andhra Pradesh,Kurnool,Kurnool,39,2,31,hab,30,1,31,8,8,2,3287,319,15.826282459124497,78.00586012651837,0
Andhra Pradesh,Kurnool,Maddikera East,13,0,12,hab,11,1,11,2,1,2,3472,319,15.28294650086443,77.4401565041533,0
Andhra Pradesh,Kurnool,Mahanandi,22,1,16,hab,16,0,17,5,6,2,3518,319,15.455223989182462,78.64738522968113,0
Andhra Pradesh,Kurnool,Mantralayam,24,2,18,hab,18,0,20,4,6,2,3712,319,15.892704486099657,77.3631436437522,0
Andhra Pradesh,Kurnool,Midthur,24,0,26,osm,24,2,24,0,-2,2,3854,319,15.74586094977051,78.29552088792273,0
Andhra Pradesh,Kurnool,Nandavaram,25,0,25,hab,25,0,24,1,0,2,4136,319,15.865862733275147,77.51117886971778,0
Andhra Pradesh,Kurnool,Nandi Kotkur,15,0,13,hab,12,1,13,2,2,2,4141,319,15.866382062682385,78.23114179614376,0
Andhra Pradesh,Kurnool,Nandyal,38,2,33,hab,28,5,31,7,5,2,4151,319,15.471639078528758,78.45939933596217,0
Andhra Pradesh,Kurnool,Orvakal,28,1,26,hab,26,0,26,2,2,2,4395,319,15.661497309154393,78.13871762492701,0
Andhra Pradesh,Kurnool,Owk,36,0,33,hab,30,3,30,6,3,2,4401,319,15.209389607040462,78.07255703691489,0
Andhra Pradesh,Kurnool,Pagidyala,22,3,7,hab,7,0,15,7,15,2,4422,319,15.941901976468143,78.32266057987164,0
Andhra Pradesh,Kurnool,Pamulapadu,27,2,25,hab,22,3,24,3,2,2,4492,319,15.812056481275397,78.48433639860461,0
Andhra Pradesh,Kurnool,Panyam,26,2,22,hab,19,3,19,7,4,2,4532,319,15.530621710943127,78.31043096194401,0
Andhra Pradesh,Kurnool,Pattikonda,30,1,24,hab,24,0,25,5,6,2,4638,319,15.419513732014718,77.49373707765926,0
Andhra Pradesh,Kurnool,Peapally,60,2,43,hab,42,1,43,17,17,2,4653,319,15.229294211765534,77.83276988662841,0
Andhra Pradesh,Kurnool,Pedda Kadubur,26,3,24,osm,21,3,23,3,2,2,4668,319,15.769608790353697,77.33664188905576,0
Andhra Pradesh,Kurnool,Rudravaram,42,0,42,hab,40,2,40,2,0,2,5206,319,15.251240423207769,78.64729599475015,0
Andhra Pradesh,Kurnool,Sanjamala,25,0,20,hab,19,1,20,5,5,2,5368,319,15.11680002943609,78.25843255474263,0
Andhra Pradesh,Kurnool,Sirvel,29,3,22,hab,21,1,25,4,7,2,5685,319,15.34155725414133,78.52642157675929,0
Andhra Pradesh,Kurnool,Srisailam,6,0,0,hab,0,0,0,6,6,2,5771,319,16.0804484109015,78.87361506913689,0
Andhra Pradesh,Kurnool,Tuggali,50,1,48,hab,46,2,49,1,2,2,6144,319,15.31535313517637,77.60657470685193,0
Andhra Pradesh,Kurnool,Uyyalawada,22,2,21,osm,20,1,20,2,1,2,6247,319,15.097288375291974,78.39129722842449,0
Andhra Pradesh,Kurnool,Veldurthi,41,3,38,hab,35,3,36,5,3,2,6311,319,15.536020405394302,77.98046324812246,0
Andhra Pradesh,Kurnool,Velgodu,14,0,9,hab,9,0,8,6,5,2,6314,319,15.71567802926299,78.63749502683339,0
Andhra Pradesh,Kurnool,Yemmiganur,33,0,39,osm,37,2,33,0,-6,2,6464,319,15.738618470833593,77.48812544292299,0
Andhra Pradesh,Nellore,Allur,66,1,46,hab,46,0,60,6,20,2,96,400,14.692440782863386,80.0586968841244,0
Andhra Pradesh,Nellore,Ananthasagaram,51,0,42,hab,40,2,43,8,9,2,178,400,14.581603583448569,79.37443220036523,0
Andhra Pradesh,Nellore,Anumasamudrampeta,35,0,49,osm,45,4,35,0,-14,2,212,400,14.714549391796677,79.6821396843732,0
Andhra Pradesh,Nellore,Atmakur,44,0,39,hab,38,1,39,5,5,2,291,400,14.651039874013097,79.567832813369,0
Andhra Pradesh,Nellore,Balayapalle,74,0,49,hab,49,0,56,18,25,2,444,400,13.988670721174259,79.70413346944353,0
Andhra Pradesh,Nellore,Bogole,49,1,33,hab,32,1,41,8,16,2,1007,400,14.780294845847065,79.9930271323772,0
Andhra Pradesh,Nellore,Butchireddipalem,46,1,29,hab,29,0,42,4,17,2,1083,400,14.535708663851805,79.88713456844376,0
Andhra Pradesh,Nellore,Chejerla,47,0,47,hab,46,1,46,1,0,2,1222,400,14.503001269822093,79.5891709641614,0
Andhra Pradesh,Nellore,Chillakur,83,1,55,hab,54,1,69,14,28,2,1289,400,14.13060470040938,79.9880252217567,0
Andhra Pradesh,Nellore,Chittamur,85,1,49,hab,48,1,68,17,36,2,1329,400,13.91520847578237,80.05333243580965,0
Andhra Pradesh,Nellore,Dagadarthi,39,0,41,osm,41,0,39,0,-2,2,1395,400,14.67987641585146,79.90505071759321,0
Andhra Pradesh,Nellore,Dakkili,77,0,40,hab,40,0,55,22,37,2,1401,400,14.092606929661608,79.54201794487534,0
Andhra Pradesh,Nellore,Doravarisatram,90,3,68,hab,67,1,76,14,22,2,1667,400,13.798769576441593,79.99260682107274,0
Andhra Pradesh,Nellore,Duttalur,41,1,32,hab,32,0,39,2,9,2,1718,400,14.851337044187428,79.42261137164301,0
Andhra Pradesh,Nellore,Gudur,53,0,34,hab,34,0,41,12,19,2,2049,400,14.13218289050415,79.80257631700172,0
Andhra Pradesh,Nellore,Indukurpet,64,0,40,hab,40,0,51,13,24,2,2299,400,14.506888688354648,80.12369181572065,0
Andhra Pradesh,Nellore,Jaladanki,41,0,39,hab,38,1,38,3,2,2,2378,400,14.870648380345132,79.86861164302321,0
Andhra Pradesh,Nellore,Kaligiri,103,0,75,hab,74,1,97,6,28,2,2635,400,14.835016518064364,79.72036910351534,0
Andhra Pradesh,Nellore,Kaluvoya,41,0,34,hab,33,1,35,6,7,2,2658,400,14.447737309257803,79.45558649933542,0
Andhra Pradesh,Nellore,Kavali,85,0,48,hab,46,2,70,15,37,2,2862,400,14.923245709781225,79.9914049033246,0
Andhra Pradesh,Nellore,Kodavalur,96,0,47,hab,47,0,92,4,49,2,3065,400,14.580958678334941,79.97970673260795,0
Andhra Pradesh,Nellore,Kondapuram,61,1,44,hab,42,2,54,7,17,2,3116,400,14.984259302684283,79.66585677534466,0
Andhra Pradesh,Nellore,Kota,59,1,37,hab,36,1,50,9,22,2,3151,400,14.071331540456615,80.04982533967646,0
Andhra Pradesh,Nellore,Kovur,72,0,12,hab,12,0,41,31,60,2,3189,400,14.5135114333153,79.99929709621928,0
Andhra Pradesh,Nellore,Manubolu,33,0,30,hab,28,2,28,5,3,2,3714,400,14.237895104001048,79.87892853377072,0
Andhra Pradesh,Nellore,Marripadu,61,1,59,hab,56,3,53,8,2,2,3738,400,14.703743540853866,79.31606127788123,0
Andhra Pradesh,Nellore,Muthukur,96,4,48,hab,47,1,82,14,48,2,4028,400,14.301001688323801,80.08980844127841,0
Andhra Pradesh,Nellore,Naidupeta,85,1,44,hab,44,0,66,19,41,2,4089,400,13.92154955556174,79.90594531102995,0
Andhra Pradesh,Nellore,Nellore,62,2,34,hab,32,2,34,28,28,2,4274,400,14.432200849471405,79.92021591921319,0
Andhra Pradesh,Nellore,Ojili,62,1,53,hab,52,1,59,3,9,2,4378,400,13.988291844451295,79.83848409107011,0
Andhra Pradesh,Nellore,Pellakur,65,0,54,hab,52,2,63,2,11,2,4686,400,13.83439942692567,79.83111315808148,0
Andhra Pradesh,Nellore,Podlakur,64,0,54,hab,53,1,56,8,10,2,4785,400,14.425891485293711,79.71866068151489,0
Andhra Pradesh,Nellore,Rapur,66,2,36,hab,35,1,41,25,30,2,5107,400,14.283296424305885,79.51301870612325,0
Andhra Pradesh,Nellore,Sangam,34,0,21,hab,21,0,27,7,13,2,5345,400,14.601476982134146,79.78393836071395,0
Andhra Pradesh,Nellore,Seetharamapuram,51,1,30,hab,30,0,32,19,21,2,5467,400,15.004527337876732,79.15594484543186,0
Andhra Pradesh,Nellore,Sullurpeta,75,2,64,hab,64,0,61,14,11,2,5792,400,13.73256703032533,80.10825590357938,0
Andhra Pradesh,Nellore,Sydapuram,68,0,46,hab,46,0,57,11,22,2,5837,400,14.216851074037326,79.70103292059906,0
Andhra Pradesh,Nellore,Tada,65,1,52,hab,47,5,55,10,13,2,5846,400,13.594187022020778,80.12731042495109,0
Andhra Pradesh,Nellore,Thotapalligudur,80,0,29,hab,29,0,49,31,51,2,6057,400,14.407124129728771,80.10974546506573,0
Andhra Pradesh,Nellore,Udayagiri,58,0,42,hab,41,1,48,10,16,2,6176,400,14.896070463322411,79.2619992252584,0
Andhra Pradesh,Nellore,Vakadu,97,0,59,hab,54,5,86,11,38,2,6266,400,13.938453820061135,80.14306226799215,0
Andhra Pradesh,Nellore,Varikuntapadu,57,0,49,hab,48,1,57,0,8,2,6288,400,15.025225220855006,79.38132176674758,0
Andhra Pradesh,Nellore,Venkatachalam,72,0,51,hab,48,3,59,13,21,2,6335,400,14.300207778323582,79.94679438105368,0
Andhra Pradesh,Nellore,Venkatagiri,99,1,42,hab,40,2,66,33,57,2,6336,400,13.950890072351218,79.56045650571043,0
Andhra Pradesh,Nellore,Vidavalur,49,1,30,hab,30,0,38,11,19,2,6351,400,14.601809101183976,80.10870819557914,0
Andhra Pradesh,Nellore,Vinjamur,50,2,32,hab,30,2,37,13,18,2,6371,400,14.84352119437785,79.5359695480737,0
Andhra Pradesh,Prakasam,Addanki,46,1,34,hab,34,0,39,7,12,2,19,434,15.82302006752549,79.96671990413002,0
Andhra Pradesh,Prakasam,Ardhaveedu,37,0,30,hab,29,1,32,5,7,2,232,434,15.682849718986422,79.0123735843411,0
Andhra Pradesh,Prakasam,Ballikuruva,36,2,30,hab,28,2,31,5,6,2,468,434,15.997243881975944,79.99457072250145,0
Andhra Pradesh,Prakasam,Bestavaripeta,46,0,38,hab,36,2,36,10,8,2,732,434,15.41575229701867,79.13867587770616,0
Andhra Pradesh,Prakasam,Chadrasekarapuram,71,0,65,hab,64,1,67,4,6,2,1100,434,15.186462606619314,79.21501177373324,0
Andhra Pradesh,Prakasam,Chimakurthi,45,0,41,hab,40,1,40,5,4,2,1290,434,15.595432771485056,79.85544754367851,0
Andhra Pradesh,Prakasam,Chinaganjam,42,0,16,hab,16,0,28,14,26,2,1293,434,15.704270310177124,80.23487002567471,0
Andhra Pradesh,Prakasam,Chirala,38,0,15,hab,14,1,25,13,23,2,1318,434,15.844629883833518,80.38154196770765,0
Andhra Pradesh,Prakasam,Cumbum,31,0,23,hab,23,0,26,5,8,2,1378,434,15.570713653576071,79.08193401562535,0
Andhra Pradesh,Prakasam,Darsi,72,2,45,hab,45,0,54,18,27,2,1452,434,15.752352162561742,79.67309167484936,0
Andhra Pradesh,Prakasam,Donakonda,48,0,43,hab,43,0,46,2,5,2,1661,434,15.816956415918606,79.43902506505337,0
Andhra Pradesh,Prakasam,Dornala,44,3,25,hab,22,3,28,16,19,2,1669,434,15.859374908686696,79.00805689631599,0
Andhra Pradesh,Prakasam,Giddaluru,65,0,51,hab,50,1,54,11,14,2,1952,434,15.48751605215778,78.86335726298306,0
Andhra Pradesh,Prakasam,Gudluru,42,3,35,hab,35,0,37,5,7,2,2047,434,15.051711590355971,79.92127404765574,0
Andhra Pradesh,Prakasam,Hanumanthunipadu,88,0,71,hab,69,2,79,9,17,2,2132,434,15.466555485798885,79.34325595200944,0
Andhra Pradesh,Prakasam,Inkollu,23,0,17,hab,17,0,21,2,6,2,2301,434,15.83687966293906,80.18483066917753,0
Andhra Pradesh,Prakasam,Janakavarampanguluru,21,0,23,osm,23,0,21,0,-2,2,2435,434,15.822173986482284,80.0919897869938,0
Andhra Pradesh,Prakasam,Kandukur,48,3,39,hab,34,5,39,9,9,2,2707,434,15.224378021693902,79.91222262213687,0
Andhra Pradesh,Prakasam,Kanigiri,109,0,82,hab,79,3,93,16,27,2,2717,434,15.363295522605476,79.49532563442378,0
Andhra Pradesh,Prakasam,Karamchedu,15,0,12,hab,12,0,15,0,3,2,2757,434,15.87557550255222,80.28660199224683,0
Andhra Pradesh,Prakasam,Komarolu,78,2,70,hab,69,1,72,6,8,2,3105,434,15.275312959795327,78.99372096584487,0
Andhra Pradesh,Prakasam,Konakanamitla,64,0,67,osm,64,3,61,3,-3,2,3108,434,15.619338090625584,79.46939474223109,0
Andhra Pradesh,Prakasam,Kondapi,37,0,26,hab,26,0,29,8,11,2,3114,434,15.411273107128915,79.8444236682145,0
Andhra Pradesh,Prakasam,Korisapadu,21,0,20,hab,18,2,18,3,1,2,3140,434,15.72749532266691,80.06353945788035,0
Andhra Pradesh,Prakasam,Kothapatnam,53,1,23,hab,21,2,40,13,30,2,3168,434,15.44187898363196,80.12965489704071,0
Andhra Pradesh,Prakasam,Kurichedu,36,1,19,hab,19,0,24,12,17,2,3283,434,15.895025591493534,79.5581975542942,0
Andhra Pradesh,Prakasam,Lingasamudram,45,4,30,hab,28,2,33,12,15,2,3418,434,15.06790484770671,79.73741530079947,0
Andhra Pradesh,Prakasam,Maddipadu,36,1,29,hab,27,2,29,7,7,2,3473,434,15.629593280704063,80.01118396655802,0
Andhra Pradesh,Prakasam,Markapur,44,0,42,hab,41,1,42,2,2,2,3734,434,15.731445855082757,79.25331042284657,0
Andhra Pradesh,Prakasam,Marripudi,53,0,52,hab,50,2,45,8,1,2,3739,434,15.48324857413381,79.67941923477511,0
Andhra Pradesh,Prakasam,Martur,19,0,18,hab,17,1,17,2,1,2,3742,434,15.940619699451085,80.09493275942918,0
Andhra Pradesh,Prakasam,Mundlamuru,51,2,34,hab,32,2,38,13,17,2,3990,434,15.843851004718834,79.81977848829519,0
Andhra Pradesh,Prakasam,Naguluppalapadu,40,1,28,hab,27,1,32,8,12,2,4084,434,15.645220636148649,80.14692764923979,0
Andhra Pradesh,Prakasam,Ongole,29,0,32,osm,28,4,26,3,-3,2,4388,434,15.510946266536065,80.08986469848296,0
Andhra Pradesh,Prakasam,Pamur,77,5,64,hab,64,0,67,10,13,2,4493,434,15.122388951871931,79.47999912369862,0
Andhra Pradesh,Prakasam,Parchur,33,1,33,osm,32,1,32,1,0,2,4561,434,15.982747339914887,80.30241528789442,0
Andhra Pradesh,Prakasam,Pedaaraveedu,44,0,38,hab,37,1,44,0,6,2,4655,434,15.855457644485966,79.23557051744488,0
Andhra Pradesh,Prakasam,Pedacherlopalle,69,0,65,hab,64,1,66,3,4,2,4657,434,15.249853085260183,79.57975238425983,0
Andhra Pradesh,Prakasam,Podili,53,0,49,hab,49,0,48,5,4,2,4783,434,15.62634255910424,79.63011632558792,0
Andhra Pradesh,Prakasam,Ponnaluru,51,1,50,hab,46,4,45,6,1,2,4804,434,15.28628296022509,79.74914655426264,0
Andhra Pradesh,Prakasam,Pullalacheruvu,52,2,39,hab,39,0,44,8,13,2,4849,434,16.169422225160467,79.42600471190127,0
Andhra Pradesh,Prakasam,Racherla,36,1,30,hab,30,0,32,4,6,2,4905,434,15.48545796438356,78.98449885088537,0
Andhra Pradesh,Prakasam,Santhamaguluru,24,0,20,hab,20,0,22,2,4,2,5384,434,16.08103209471571,79.94327179730512,0
Andhra Pradesh,Prakasam,Santhanuthlapadu,31,0,26,hab,26,0,28,3,5,2,5385,434,15.523465950205555,79.93869909815274,0
Andhra Pradesh,Prakasam,Singarayakonda,43,0,23,hab,23,0,37,6,20,2,5653,434,15.250854254891616,80.03278061695056,0
Andhra Pradesh,Prakasam,Tangutur,31,1,26,hab,26,0,24,7,5,2,5903,434,15.393907456502241,80.01089310686427,0
Andhra Pradesh,Prakasam,Tarlapadu,34,0,33,hab,33,0,34,0,1,2,5928,434,15.642222667602606,79.30104204431073,0
Andhra Pradesh,Prakasam,Thallur,35,0,28,hab,27,1,28,7,7,2,5982,434,15.707993533419344,79.82416285545942,0
Andhra Pradesh,Prakasam,Tripuranthakam,48,0,37,hab,35,2,40,8,11,2,6137,434,15.993871868755722,79.44569812591162,0
Andhra Pradesh,Prakasam,Ulavapadu,63,1,34,hab,32,2,49,14,29,2,6194,434,15.141813196161433,80.00470305686737,0
Andhra Pradesh,Prakasam,Veligandla,64,1,61,hab,60,1,61,3,3,2,6316,434,15.342567720371354,79.30555936450203,0
Andhra Pradesh,Prakasam,Vetapalem,39,1,9,hab,9,0,11,28,30,2,6348,434,15.775343170912675,80.33030146339173,0
Andhra Pradesh,Prakasam,Voletivaripalem,39,1,44,osm,42,2,36,3,-5,2,6388,434,15.169058529449243,79.74159554542969,0
Andhra Pradesh,Prakasam,Yeddanapudi,19,1,16,hab,15,1,17,2,3,2,6451,434,15.985337069539224,80.1835306639606,0
Andhra Pradesh,Prakasam,Yerragondapalem,67,0,33,hab,31,2,37,30,34,2,6469,434,16.075894583634266,79.1353455727854,0
Andhra Pradesh,Prakasam,Zarugumilli,35,2,25,hab,24,1,29,6,10,2,6481,434,15.32897924334584,79.89925934349716,0
Andhra Pradesh,Srikakulam,Amadalavalasa,75,0,75,hab,65,10,73,2,0,2,105,528,18.414000080137075,83.87242298739896,0
Andhra Pradesh,Srikakulam,Bhamini,89,0,42,hab,42,0,76,13,47,2,788,528,18.89877924394838,83.81472424841796,0
Andhra Pradesh,Srikakulam,Burja,81,0,56,hab,54,2,71,10,25,2,1079,528,18.5317083201211,83.82780070957479,0
Andhra Pradesh,Srikakulam,Etcherla,119,1,64,hab,64,0,106,13,55,2,1751,528,18.239893792586702,83.85103233014175,0
Andhra Pradesh,Srikakulam,Ganguvari Singadam,65,1,52,hab,52,0,59,6,13,2,1859,528,18.364088435900587,83.68231670683602,0
Andhra Pradesh,Srikakulam,Gara,138,1,95,hab,95,0,136,2,43,2,1866,528,18.300238751647232,84.02363396786689,0
Andhra Pradesh,Srikakulam,Hiramandalam,100,6,52,hab,46,6,85,15,48,2,2225,528,18.67636974797107,83.96911633592755,0
Andhra Pradesh,Srikakulam,Ichchapuram,48,0,41,hab,38,3,47,1,7,2,2275,528,19.10005247839482,84.68503841669938,0
Andhra Pradesh,Srikakulam,Jalumuru,102,2,77,hab,77,0,94,8,25,2,2404,528,18.512421103222305,84.01299826921431,0
Andhra Pradesh,Srikakulam,Kanchili,158,3,78,hab,77,1,133,25,80,2,2698,528,18.9898027009428,84.55619757906426,0
Andhra Pradesh,Srikakulam,Kaviti,126,2,56,hab,56,0,102,24,70,2,2867,528,19.01255620394508,84.6664761684693,0
Andhra Pradesh,Srikakulam,Kotabommili,125,1,112,hab,112,0,125,0,13,2,3153,528,18.50759761484979,84.1309386946041,0
Andhra Pradesh,Srikakulam,Kothuru,143,0,78,hab,76,2,111,32,65,2,3173,528,18.753078069811693,83.9196251179636,0
Andhra Pradesh,Srikakulam,L N Peta,72,7,44,hab,44,0,67,5,28,2,3317,528,18.605484359852085,83.92996703234643,0
Andhra Pradesh,Srikakulam,Laveru,89,4,64,hab,64,0,79,10,25,2,3394,528,18.242796082984636,83.74088860779355,0
Andhra Pradesh,Srikakulam,Mandasa,246,6,136,hab,135,1,223,23,110,2,3643,528,18.87168982674022,84.46766458411177,0
Andhra Pradesh,Srikakulam,Meilaputti,165,3,96,hab,95,1,141,24,69,2,3824,528,18.743449274205577,84.22598219448778,0
Andhra Pradesh,Srikakulam,Nandigam,140,5,79,hab,78,1,117,23,61,2,4142,528,18.677830639967905,84.30745198057105,0
Andhra Pradesh,Srikakulam,Narasannapeta,89,1,65,hab,65,0,81,8,24,2,4163,528,18.417422855701034,84.00646809463936,0
Andhra Pradesh,Srikakulam,Palakonda,65,1,47,hab,47,0,54,11,18,2,4447,528,18.620604398289,83.72762609331177,0
Andhra Pradesh,Srikakulam,Palasa,92,1,78,hab,67,11,87,5,14,2,4453,528,18.781971624175082,84.41198174529275,0
Andhra Pradesh,Srikakulam,Pathapatnam,157,5,65,hab,63,2,114,43,92,2,4609,528,18.709598056658493,84.08437969425165,0
Andhra Pradesh,Srikakulam,Polaki,123,3,87,hab,87,0,119,4,36,2,4791,528,18.395621577683816,84.11184674053155,0
Andhra Pradesh,Srikakulam,Ponduru,73,5,47,hab,47,0,64,9,26,2,4800,528,18.335449549378936,83.79489198381732,0
Andhra Pradesh,Srikakulam,Rajam,50,1,36,hab,36,0,40,10,14,2,4962,528,18.43795994488636,83.63858450924738,0
Andhra Pradesh,Srikakulam,Ranastalam,120,2,75,hab,75,0,107,13,45,2,5077,528,18.158373089457765,83.68401312952008,0
Andhra Pradesh,Srikakulam,Regidiamadalavalasa,69,0,62,hab,62,0,65,4,7,2,5145,528,18.5324447356601,83.70568687225652,0
Andhra Pradesh,Srikakulam,Santhabommali,130,2,96,hab,94,2,127,3,34,2,5382,528,18.522866998677102,84.25305231499829,0
Andhra Pradesh,Srikakulam,Santhakaviti,75,1,65,hab,61,4,73,2,10,2,5383,528,18.444947242529523,83.7615597568447,0
Andhra Pradesh,Srikakulam,Saravakota,119,8,87,hab,86,1,106,13,32,2,5408,528,18.60243611572326,84.06112140382507,0
Andhra Pradesh,Srikakulam,Sarubujjili,66,0,56,hab,56,0,63,3,10,2,5424,528,18.50992298169881,83.92509791169175,0
Andhra Pradesh,Srikakulam,Seethampeta,522,12,156,hab,153,3,429,93,366,2,5464,528,18.702169671336733,83.77740694337479,0
Andhra Pradesh,Srikakulam,Sompeta,74,2,41,hab,41,0,58,16,33,2,5719,528,18.90696543033833,84.55662152055879,0
Andhra Pradesh,Srikakulam,Srikakulam,116,3,68,hab,65,3,98,18,48,2,5761,528,18.328851650472266,83.93153123098979,0
Andhra Pradesh,Srikakulam,Tekkali,126,15,82,hab,82,0,110,16,44,2,5943,528,18.612878912823792,84.22780161166175,0
Andhra Pradesh,Srikakulam,Vajrapukothuru,127,20,58,hab,58,0,106,21,69,2,6265,528,18.68572021875936,84.41659537600344,0
Andhra Pradesh,Srikakulam,Vangara,47,1,32,hab,32,0,41,6,15,2,6281,528,18.60933904258923,83.58692316170915,0
Andhra Pradesh,Srikakulam,Veeraghattam,68,4,47,hab,46,1,61,7,21,2,6305,528,18.67372551191272,83.62736168919093,0
Andhra Pradesh,Visakhapatnam,Anakapalli,62,0,51,hab,49,2,52,10,11,2,169,582,17.717422484793307,83.00208430151595,0
Andhra Pradesh,Visakhapatnam,Anandapuram,116,1,79,hab,79,0,112,4,37,2,173,582,17.885320010058138,83.31020717179183,0
Andhra Pradesh,Visakhapatnam,Ananthagiri,484,34,175,hab,163,12,362,122,309,2,177,582,18.185682672655485,83.04283869783,0
Andhra Pradesh,Visakhapatnam,Araku Valley,307,4,173,hab,169,4,276,31,134,2,219,582,18.312385773041832,82.94682227102874,0
Andhra Pradesh,Visakhapatnam,Atchutapuram,68,7,47,hab,46,1,51,17,21,2,279,582,17.567233133286134,83.0042404396892,0
Andhra Pradesh,Visakhapatnam,Bheemunipatnam,101,3,74,hab,65,9,90,11,27,2,842,582,17.899207433607636,83.41573378184782,0
Andhra Pradesh,Visakhapatnam,Butchayyapeta,60,3,54,hab,53,1,58,2,6,2,1082,582,17.768123420558847,82.86179483764049,0
Andhra Pradesh,Visakhapatnam,Cheedikada,57,1,42,hab,42,0,46,11,15,2,1218,582,17.929782358130176,82.89253738049315,0
Andhra Pradesh,Visakhapatnam,Chinagadila,17,16,0,hab,0,0,0,17,17,2,1292,582,17.71221286583938,83.27539568800172,0
Andhra Pradesh,Visakhapatnam,Chintapalle,374,13,195,hab,171,24,309,65,179,2,1306,582,17.89585835892955,82.44787287975622,0
Andhra Pradesh,Visakhapatnam,Chodavaram,46,0,39,hab,39,0,41,5,7,2,1340,582,17.814315395833724,82.96872884741268,0
Andhra Pradesh,Visakhapatnam,Devarapalle,102,11,44,hab,44,0,81,21,58,2,1526,582,17.99672486698303,82.98781861730215,0
Andhra Pradesh,Visakhapatnam,Dumbriguda,296,19,176,hab,174,2,268,28,120,2,1697,582,18.309499688244244,82.78016271842027,0
Andhra Pradesh,Visakhapatnam,Gajuwaka,7,0,8,osm,7,1,7,0,-1,2,1813,582,17.682486489620295,83.18033844165578,0
Andhra Pradesh,Visakhapatnam,Gangaraju Madugula,464,15,236,hab,232,4,409,55,228,2,1846,582,17.991656917576766,82.53102097470838,0
Andhra Pradesh,Visakhapatnam,Golugonda,90,1,79,hab,71,8,84,6,11,2,1990,582,17.670574886712643,82.49206012556063,0
Andhra Pradesh,Visakhapatnam,Gudem Kothaveedhi,303,10,161,hab,149,12,248,55,142,2,2036,582,17.909363462717916,82.1708216594299,0
Andhra Pradesh,Visakhapatnam,Hukumpeta,356,4,279,hab,259,20,345,11,77,2,2254,582,18.1425980608385,82.77423757326504,0
Andhra Pradesh,Visakhapatnam,K Kotapadu,63,0,48,hab,48,0,60,3,15,2,2549,582,17.888648297351807,83.05497740600602,0
Andhra Pradesh,Visakhapatnam,Kasimkota,50,1,34,hab,34,0,41,9,16,2,2814,582,17.64662260988515,82.88288677178355,0
Andhra Pradesh,Visakhapatnam,Kotauratla,57,1,42,hab,42,0,53,4,15,2,3157,582,17.53292772391465,82.66519685870237,0
Andhra Pradesh,Visakhapatnam,Koyyuru,236,13,146,hab,135,11,185,51,90,2,3195,582,17.717187928248936,82.21748074173493,0
Andhra Pradesh,Visakhapatnam,Madugula,109,1,74,hab,73,1,102,7,35,2,3496,582,17.88432277341751,82.77680363248528,0
Andhra Pradesh,Visakhapatnam,Makavarapalem,67,1,46,hab,46,0,60,7,21,2,3570,582,17.63397806591121,82.73047351024948,0
Andhra Pradesh,Visakhapatnam,Munagapaka,48,2,36,hab,36,0,44,4,12,2,3982,582,17.618754071894955,82.9850715386604,0
Andhra Pradesh,Visakhapatnam,Munchingiputtu,389,5,243,hab,241,2,345,44,146,2,3984,582,18.376138861691366,82.46792070101614,0
Andhra Pradesh,Visakhapatnam,Nakkapalli,67,1,58,hab,58,0,66,1,9,2,4101,582,17.400539853801952,82.66968329696164,0
Andhra Pradesh,Visakhapatnam,Narsipatnam,48,3,28,hab,28,0,39,9,20,2,4210,582,17.64181057744537,82.6135679338166,0
Andhra Pradesh,Visakhapatnam,Nathavaram,88,1,72,hab,65,7,78,10,16,2,4222,582,17.54766546442306,82.46249407303596,0
Andhra Pradesh,Visakhapatnam,Paderu,350,15,179,hab,173,6,289,61,171,2,4415,582,18.038746440430383,82.69532400829364,0
Andhra Pradesh,Visakhapatnam,Padmanabham,52,1,44,hab,43,1,50,2,8,2,4418,582,17.986646325063834,83.32838895952781,0
Andhra Pradesh,Visakhapatnam,Paravada,86,4,15,hab,14,1,24,62,71,2,4555,582,17.62908547929837,83.09597848968599,0
Andhra Pradesh,Visakhapatnam,Payakaraopeta,36,1,34,hab,33,1,35,1,2,2,4650,582,17.3328326244298,82.58107338084528,0
Andhra Pradesh,Visakhapatnam,Pedabayalu,398,9,207,hab,202,5,332,66,191,2,4656,582,18.19986384236436,82.48926244414784,0
Andhra Pradesh,Visakhapatnam,Pedagantyada,22,1,0,hab,0,0,0,22,22,2,4658,582,17.61335890669312,83.18258570839951,0
Andhra Pradesh,Visakhapatnam,Pendurthi,80,3,38,hab,38,0,57,23,42,2,4693,582,17.795908906511496,83.20082670805559,0
Andhra Pradesh,Visakhapatnam,Rambilli,69,2,50,hab,50,0,62,7,19,2,5034,582,17.496204306520998,82.92400949228926,0
Andhra Pradesh,Visakhapatnam,Ravikamatham,88,2,65,hab,62,3,82,6,23,2,5127,582,17.774244807559775,82.74139052943886,0
Andhra Pradesh,Visakhapatnam,Rolugunta,63,1,46,hab,46,0,60,3,17,2,5188,582,17.727519234485346,82.65672261270683,0
Andhra Pradesh,Visakhapatnam,S Rayavaram,50,1,38,hab,36,2,41,9,12,2,5219,582,17.44709772357665,82.79192733551403,0
Andhra Pradesh,Visakhapatnam,Sabbavaram,79,2,62,hab,61,1,73,6,17,2,5226,582,17.79342167112337,83.11222243399274,0
Andhra Pradesh,Visakhapatnam,Yelamanchili,45,0,39,hab,39,0,43,2,6,2,6453,582,17.55103699607413,82.82032959858225,0
Andhra Pradesh,Vizianagaram,Badangi,45,4,36,hab,35,1,40,5,9,2,354,583,18.492014496258548,83.40293639678,0
Andhra Pradesh,Vizianagaram,Balijipeta,41,1,40,hab,38,2,39,2,1,2,459,583,18.60312461716744,83.52798146647822,0
Andhra Pradesh,Vizianagaram,Bhoghapuram,94,5,50,hab,50,0,83,11,44,2,871,583,17.995567619142786,83.50593884090854,0
Andhra Pradesh,Vizianagaram,Bobbili,66,4,33,hab,31,2,36,30,33,2,997,583,18.578465040320484,83.36333229920442,0
Andhra Pradesh,Vizianagaram,Bondapalle,54,5,34,hab,31,3,41,13,20,2,1025,583,18.22589718663639,83.32255968287589,0
Andhra Pradesh,Vizianagaram,Cheepurupalle,55,2,40,hab,40,0,52,3,15,2,1219,583,18.276188860464977,83.62100672557249,0
Andhra Pradesh,Vizianagaram,Dattirajeru,55,3,40,hab,39,1,44,11,15,2,1467,583,18.390169129371348,83.37160326607497,0
Andhra Pradesh,Vizianagaram,Denkada,81,3,51,hab,48,3,74,7,30,2,1492,583,18.05398455192395,83.45851292379253,0
Andhra Pradesh,Vizianagaram,Gajapathinagaram,49,4,26,hab,24,2,32,17,23,2,1811,583,18.30321496106903,83.34938777562229,0
Andhra Pradesh,Vizianagaram,Gantyada,53,4,41,hab,40,1,45,8,12,2,1865,583,18.150216298161038,83.27534903734343,0
Andhra Pradesh,Vizianagaram,Garividi,51,1,42,hab,41,1,46,5,9,2,1880,583,18.310500006102846,83.55089433556192,0
Andhra Pradesh,Vizianagaram,Garugubilli,46,4,41,hab,38,3,42,4,5,2,1888,583,18.73168749471486,83.50160460366546,0
Andhra Pradesh,Vizianagaram,Gummalakshmipuram,208,3,88,hab,84,4,139,69,120,2,2064,583,19.013097844372588,83.59288504146183,0
Andhra Pradesh,Vizianagaram,Gurla,70,2,48,hab,47,1,64,6,22,2,2082,583,18.245013427829015,83.48013805615129,0
Andhra Pradesh,Vizianagaram,Jami,57,0,39,hab,38,1,52,5,18,2,2417,583,18.04008852822374,83.25810913102443,0
Andhra Pradesh,Vizianagaram,Jiyyamma Valasa,115,7,63,hab,63,0,92,23,52,2,2515,583,18.808715380097553,83.59113601843431,0
Andhra Pradesh,Vizianagaram,Komarada,154,8,92,hab,90,2,116,38,62,2,3104,583,18.911424883477196,83.4327646376481,0
Andhra Pradesh,Vizianagaram,Kothavalasa,77,0,53,hab,53,0,72,5,24,2,3170,583,17.909024433280926,83.18693251343257,0
Andhra Pradesh,Vizianagaram,Kurupam,347,6,97,hab,93,4,250,97,250,2,3296,583,18.88416625763216,83.67790213806755,0
Andhra Pradesh,Vizianagaram,Lakkavarapukota,57,1,41,hab,40,1,50,7,16,2,3350,583,17.993887718215337,83.16245601939866,0
Andhra Pradesh,Vizianagaram,Makkuva,101,9,62,hab,60,2,83,18,39,2,3575,583,18.68043959857312,83.2479148474886,0
Andhra Pradesh,Vizianagaram,Mentada,94,6,46,hab,43,3,65,29,48,2,3841,583,18.362141444033792,83.24461255302172,0
Andhra Pradesh,Vizianagaram,Merakamudidam,66,2,53,hab,52,1,63,3,13,2,3842,583,18.395987532638713,83.48483954225583,0
Andhra Pradesh,Vizianagaram,Nellimarla,58,1,39,hab,38,1,51,7,19,2,4273,583,18.17730360173299,83.49411607880059,0
Andhra Pradesh,Vizianagaram,Pachipenta,238,3,98,hab,97,1,156,82,140,2,4408,583,18.45098224422978,83.13422814405754,0
Andhra Pradesh,Vizianagaram,Parvathipuram,113,6,87,hab,85,2,97,16,26,2,4582,583,18.764955518395887,83.35956523244604,0
Andhra Pradesh,Vizianagaram,Pusapatirega,83,1,47,hab,46,1,64,19,36,2,4883,583,18.09355343425682,83.5769895658492,0
Andhra Pradesh,Vizianagaram,Ramabhadrapuram,51,2,41,hab,38,3,43,8,10,2,5016,583,18.474357192519093,83.27539999150667,0
Andhra Pradesh,Vizianagaram,Salur,255,7,76,hab,72,4,112,143,179,2,5310,583,18.624627534740256,83.14068145377723,0
Andhra Pradesh,Vizianagaram,Seethanagaram,53,1,44,hab,44,0,45,8,9,2,5465,583,18.66436248620237,83.39481158581594,0
Andhra Pradesh,Vizianagaram,Srungavarapukota,94,21,45,hab,43,2,60,34,49,2,5774,583,18.120501172383417,83.16639261873729,0
Andhra Pradesh,Vizianagaram,Therlam,64,1,63,hab,63,0,59,5,1,2,6009,583,18.49189440787726,83.53345909219782,0
Andhra Pradesh,Vizianagaram,Vepada,73,1,53,hab,46,7,66,7,20,2,6341,583,18.021641097202952,83.07642989293102,0
Andhra Pradesh,Vizianagaram,Vizianagaram,45,0,28,hab,25,3,37,8,17,2,6387,583,18.105460986193922,83.38640033847322,0
Andhra Pradesh,West Godavari,AKIVIDU,38,1,31,hab,30,1,35,3,7,2,59,591,16.613953211527793,81.37818844406783,0
Andhra Pradesh,West Godavari,Achanta,89,9,28,hab,28,0,64,25,61,2,12,591,16.585841997177262,81.81875071734322,0
Andhra Pradesh,West Godavari,Attili,30,1,37,osm,37,0,29,1,-7,2,305,591,16.673372633854566,81.60001451738381,0
Andhra Pradesh,West Godavari,Bheemavaram,68,1,50,hab,44,6,54,14,18,2,839,591,16.472334249258978,81.50971948416851,0
Andhra Pradesh,West Godavari,Bhimadole,32,5,25,hab,25,0,23,9,7,2,853,591,16.760727446014943,81.28978667369658,0
Andhra Pradesh,West Godavari,Burgampadu,14,6,0,hab,0,0,0,14,14,2,6980,591,17.620065165080334,80.95209753788326,0
Andhra Pradesh,West Godavari,Buttayagudem,137,2,173,osm,164,9,129,8,-36,2,1084,591,17.27152998365224,81.38485100398779,0
Andhra Pradesh,West Godavari,Chagallu,19,0,28,osm,28,0,18,1,-9,2,1102,591,16.969155398239725,81.64630519094538,0
Andhra Pradesh,West Godavari,Chintalapudi,77,0,99,osm,89,10,68,9,-22,2,1305,591,17.095677361259355,80.981184066408,0
Andhra Pradesh,West Godavari,Denduluru,42,0,42,hab,38,4,38,4,0,2,1491,591,16.769915607101538,81.1855576124976,0
Andhra Pradesh,West Godavari,Devarapalle,24,0,35,osm,34,1,24,0,-11,2,1527,591,17.02791638687874,81.53140358939021,0
Andhra Pradesh,West Godavari,Dwaraka Tirumala,64,1,64,osm,61,3,56,8,0,2,1722,591,16.931847385512032,81.28470324843708,0
Andhra Pradesh,West Godavari,Eluru,58,3,31,hab,29,2,25,33,27,2,1741,591,16.662747276881163,81.16745179458597,0
Andhra Pradesh,West Godavari,Ganapavaram,30,1,32,osm,32,0,29,1,-2,2,1825,591,16.703594445443027,81.5233827642101,0
Andhra Pradesh,West Godavari,Gopalapuram,32,0,54,osm,52,2,32,0,-22,2,2003,591,17.139861024560513,81.54841395415465,0
Andhra Pradesh,West Godavari,Iragavaram,48,2,39,hab,39,0,46,2,9,2,2304,591,16.691398079569062,81.6998417704211,0
Andhra Pradesh,West Godavari,Jangareddigudem,45,0,46,osm,43,3,37,8,-1,2,2439,591,17.109805537995253,81.27928351823337,0
Andhra Pradesh,West Godavari,Jeelugumilli,42,1,54,osm,50,4,40,2,-12,2,2477,591,17.231560466296592,81.19228067240074,0
Andhra Pradesh,West Godavari,Kalla,32,3,33,osm,32,1,29,3,-1,2,2641,591,16.51000919250967,81.42032064327304,0
Andhra Pradesh,West Godavari,Kamavarapukota,53,2,45,hab,45,0,52,1,8,2,2678,591,16.976976814390564,81.18027239598408,0
Andhra Pradesh,West Godavari,Kovvur,20,2,37,osm,30,7,17,3,-17,2,3190,591,17.01358829367653,81.69395966936709,0
Andhra Pradesh,West Godavari,Koyyalagudem,42,1,58,osm,58,0,41,1,-16,2,3194,591,17.118037365390194,81.40481761454882,0
Andhra Pradesh,West Godavari,Kukunoor,73,3,8,hab,7,1,13,60,65,2,6893,591,17.543269508440005,81.09468769570361,0
Andhra Pradesh,West Godavari,Lingapalem,42,0,47,osm,43,4,41,1,-5,2,3417,591,16.93470833114558,81.03493930934606,0
Andhra Pradesh,West Godavari,Mogalthur,85,0,47,hab,43,4,78,7,38,2,3878,591,16.394956432893064,81.57525594147299,0
Andhra Pradesh,West Godavari,Nallajerla,34,0,40,osm,39,1,29,5,-6,2,4115,591,16.95381062227115,81.40459877695574,0
Andhra Pradesh,West Godavari,Narasapuram,83,1,39,hab,34,5,53,30,44,2,4164,591,16.41275413234848,81.6716737632127,0
Andhra Pradesh,West Godavari,Nidadavole,25,0,34,osm,33,1,24,1,-9,2,4291,591,16.902234744904952,81.65260877098193,0
Andhra Pradesh,West Godavari,Nidamarru,25,0,24,hab,21,3,24,1,1,2,4293,591,16.712299579615966,81.39636058836847,0
Andhra Pradesh,West Godavari,Palacole,66,1,38,hab,38,0,53,13,28,2,4443,591,16.51656450914534,81.69221267670113,0
Andhra Pradesh,West Godavari,Palakoderu,29,1,27,hab,25,2,27,2,2,2,4446,591,16.57846410459515,81.56325716182623,0
Andhra Pradesh,West Godavari,Pedapadu,56,1,48,hab,47,1,49,7,8,2,4663,591,16.6411596205198,81.0386296853298,0
Andhra Pradesh,West Godavari,Pedavegi,67,4,54,hab,49,5,55,12,13,2,4666,591,16.81881005931276,81.08065741146127,0
Andhra Pradesh,West Godavari,Pentapadu,31,1,31,osm,28,3,30,1,0,2,4696,591,16.767364493228246,81.53708510732888,0
Andhra Pradesh,West Godavari,Penugonda,55,1,36,hab,36,0,52,3,19,2,4700,591,16.65142953456971,81.7892552773926,0
Andhra Pradesh,West Godavari,Penumantra,32,0,22,hab,22,0,27,5,10,2,4701,591,16.63688708704278,81.67676720206238,0
Andhra Pradesh,West Godavari,Peravali,28,0,27,hab,27,0,28,0,1,2,4706,591,16.76484709407948,81.75046561884648,0
Andhra Pradesh,West Godavari,Poduru,91,1,46,hab,46,0,85,6,45,2,4786,591,16.567961799681648,81.74866361377931,0
Andhra Pradesh,West Godavari,Polavaram,66,2,80,osm,73,7,56,10,-14,2,4793,591,17.320199388927676,81.56291470914967,0
Andhra Pradesh,West Godavari,T Narasapuram,60,0,63,osm,62,1,54,6,-3,2,5838,591,17.100039722572436,81.1238947881138,0
Andhra Pradesh,West Godavari,Tadepalligudem,38,0,54,osm,51,3,37,1,-16,2,5847,591,16.868701503265445,81.54560225894602,0
Andhra Pradesh,West Godavari,Tanuku,14,0,10,hab,8,2,8,6,4,2,5907,591,16.757708537616704,81.65920899768561,0
Andhra Pradesh,West Godavari,Thallapudi,17,0,25,osm,23,2,17,0,-8,2,5981,591,17.118353316437272,81.63976816427947,0
Andhra Pradesh,West Godavari,Undi,44,0,34,hab,33,1,37,7,10,2,6217,591,16.617299097849877,81.47255229350127,0
Andhra Pradesh,West Godavari,Undrajavaram,16,0,21,osm,21,0,16,0,-5,2,6218,591,16.806878260282243,81.68322170282829,0
Andhra Pradesh,West Godavari,Unguturu,49,4,47,osm,46,1,42,7,2,2,6220,591,16.824873163037083,81.41095088325687,0
Andhra Pradesh,West Godavari,Veeravasaram,53,2,39,hab,39,0,50,3,14,2,6307,591,16.551558157214018,81.63118008369143,0
Andhra Pradesh,West Godavari,Velairpad,67,1,59,hab,50,9,46,21,8,2,6894,591,17.44859287708719,81.32055562358939,0
Andhra Pradesh,West Godavari,Yelamanchili,71,4,27,hab,27,0,54,17,44,2,6454,591,16.489825994223445,81.78606644314765,0
Andhra Pradesh,Y S R Kadapa,Atlur,151,0,56,hab,49,7,119,32,95,2,289,122,14.579197299291781,79.0694352021271,0
Andhra Pradesh,Y S R Kadapa,B Kodur,57,0,36,hab,36,0,46,11,21,2,330,122,14.864520451632096,78.99700592498621,0
Andhra Pradesh,Y S R Kadapa,B Mattam,76,0,42,hab,41,1,59,17,34,2,332,122,14.77750257135823,78.91938231259394,0
Andhra Pradesh,Y S R Kadapa,Badvel,91,0,48,hab,43,5,76,15,43,2,368,122,14.71350034296273,79.04058721512811,0
Andhra Pradesh,Y S R Kadapa,C K Dinne,133,3,50,hab,49,1,117,16,83,2,1089,122,14.386400235544427,78.80014626792688,0
Andhra Pradesh,Y S R Kadapa,Chakrayapet,141,1,74,hab,72,2,129,12,67,2,1122,122,14.21753362435517,78.50807050321914,0
Andhra Pradesh,Y S R Kadapa,Chapadu,67,2,50,hab,50,0,62,5,17,2,1182,122,14.72149181872881,78.663076951805,0
Andhra Pradesh,Y S R Kadapa,Chennur,43,0,20,hab,19,1,35,8,23,2,1236,122,14.56000211942573,78.82166634294173,0
Andhra Pradesh,Y S R Kadapa,Chinnamandem,137,3,68,hab,68,0,119,18,69,2,1301,122,13.951319654895071,78.65968535950125,0
Andhra Pradesh,Y S R Kadapa,Chitvel,167,1,57,hab,57,0,133,34,110,2,1336,122,14.099970175330835,79.38497333960059,0
Andhra Pradesh,Y S R Kadapa,Cuddapah,38,3,12,hab,11,1,15,23,26,2,1376,122,14.477841564966937,78.84103124583848,0
Andhra Pradesh,Y S R Kadapa,Duvvur,47,0,32,hab,30,2,36,11,15,2,1720,122,14.865860447095047,78.67227128417368,0
Andhra Pradesh,Y S R Kadapa,Galiveedu,267,2,127,hab,127,0,258,9,140,2,1815,122,14.068201707088997,78.52222468872574,0
Andhra Pradesh,Y S R Kadapa,Gopavaram,83,0,43,hab,41,2,81,2,40,2,2008,122,14.600980669571843,79.17285446826577,0
Andhra Pradesh,Y S R Kadapa,Jammalamadugu,31,0,27,hab,24,3,24,7,4,2,2421,122,14.80208154022756,78.37752712872373,0
Andhra Pradesh,Y S R Kadapa,Kalasapadu,44,2,37,hab,37,0,42,2,7,2,2618,122,15.128031016086892,78.93947998994746,0
Andhra Pradesh,Y S R Kadapa,Kamalapuram,66,1,39,hab,38,1,55,11,27,2,2671,122,14.58600764900958,78.61279670032854,0
Andhra Pradesh,Y S R Kadapa,Khajipet,125,1,45,hab,43,2,105,20,80,2,2924,122,14.64582125036053,78.79317363634925,0
Andhra Pradesh,Y S R Kadapa,Kodur,189,0,58,hab,57,1,158,31,131,2,3073,122,13.926629637040062,79.36302901373416,0
Andhra Pradesh,Y S R Kadapa,Kondapuram,55,0,46,hab,46,0,50,5,9,2,3117,122,14.806981866145366,78.1518249464766,0
Andhra Pradesh,Y S R Kadapa,Lakkireddipalle,170,1,93,hab,91,2,166,4,77,2,3351,122,14.181739040414744,78.65879171657133,0
Andhra Pradesh,Y S R Kadapa,Lingala,29,0,28,hab,27,1,25,4,1,2,3414,122,14.490743083821142,78.09863722447712,0
Andhra Pradesh,Y S R Kadapa,Muddanur,44,0,38,hab,38,0,44,0,6,2,3945,122,14.674665675110562,78.34478472699983,0
Andhra Pradesh,Y S R Kadapa,Mydukur,117,1,58,hab,57,1,99,18,59,2,4033,122,14.933223862582643,78.78987263651926,0
Andhra Pradesh,Y S R Kadapa,Mylavaram,49,0,42,hab,40,2,44,5,7,2,4036,122,14.921846761436514,78.2805709585285,0
Andhra Pradesh,Y S R Kadapa,Nandalur,91,2,38,hab,37,1,71,20,53,2,4134,122,14.341065321443224,79.1568625280373,0
Andhra Pradesh,Y S R Kadapa,Obulavaripalle,184,7,61,hab,60,1,165,19,123,2,4370,122,13.949930249370706,79.21410180630261,0
Andhra Pradesh,Y S R Kadapa,Peddamudium,28,0,25,hab,25,0,23,5,3,2,4673,122,14.967325168132984,78.42840325569243,0
Andhra Pradesh,Y S R Kadapa,Penagaluru,146,0,62,hab,62,0,138,8,84,2,4688,122,14.307411659199591,79.29736871097883,0
Andhra Pradesh,Y S R Kadapa,Pendlimarri,144,1,67,hab,66,1,132,12,77,2,4691,122,14.384017069064576,78.61561831622954,0
Andhra Pradesh,Y S R Kadapa,Porumamilla,103,0,60,hab,60,0,89,14,43,2,4814,122,14.995534240208071,79.0448252671587,0
Andhra Pradesh,Y S R Kadapa,Proddutur,68,0,46,hab,39,7,55,13,22,2,4835,122,14.757953045974272,78.55800771666777,0
Andhra Pradesh,Y S R Kadapa,Pulivendla,36,0,27,hab,24,3,31,5,9,2,4847,122,14.416944637129129,78.221324278132,0
Andhra Pradesh,Y S R Kadapa,Pullampeta,197,0,79,hab,79,0,189,8,118,2,4851,122,14.109696003300698,79.18765251018561,0
Andhra Pradesh,Y S R Kadapa,Rajampet,260,2,94,hab,92,2,212,48,166,2,4963,122,14.20410251402139,79.10143523017325,0
Andhra Pradesh,Y S R Kadapa,Raju Palem,25,1,22,hab,21,1,22,3,3,2,5005,122,14.874907167924961,78.55996383664564,0
Andhra Pradesh,Y S R Kadapa,Ramapuram,156,0,68,hab,68,0,139,17,88,2,5030,122,14.196072202888994,78.74986120110808,0
Andhra Pradesh,Y S R Kadapa,Rayachoti,161,1,98,hab,92,6,148,13,63,2,5133,122,14.053524473776532,78.70817152532757,0
Andhra Pradesh,Y S R Kadapa,S A Kasinayana,49,1,33,hab,33,0,40,9,16,2,5218,122,15.004110292845697,78.89856993155111,0
Andhra Pradesh,Y S R Kadapa,Sambepalle,243,5,127,hab,126,1,228,15,116,2,5320,122,13.93830953272292,78.78615806738655,0
Andhra Pradesh,Y S R Kadapa,Sidhout,117,0,44,hab,43,1,107,10,73,2,5607,122,14.51684785916375,78.95906002848305,0
Andhra Pradesh,Y S R Kadapa,Simhadripuram,34,0,32,hab,30,2,33,1,2,2,5641,122,14.616005651516971,78.17958522009451,0
Andhra Pradesh,Y S R Kadapa,T Sundupalle,287,3,132,hab,130,2,257,30,155,2,5841,122,13.961871780395777,78.96685544942541,0
Andhra Pradesh,Y S R Kadapa,Thondur,29,0,27,hab,27,0,28,1,2,2,6052,122,14.547511322898934,78.29946551555712,0
Andhra Pradesh,Y S R Kadapa,V N Palli,52,0,41,hab,40,1,46,6,11,2,6249,122,14.50667281257041,78.47424058818713,0
Andhra Pradesh,Y S R Kadapa,Vallur,85,1,41,hab,41,0,77,8,44,2,6274,122,14.548759611403538,78.70912098585612,0
Andhra Pradesh,Y S R Kadapa,Veeraballe,206,0,112,hab,112,0,201,5,94,2,6304,122,14.17301083916522,78.89601758428702,0
Andhra Pradesh,Y S R Kadapa,Vempalle,39,2,22,hab,22,0,30,9,17,2,6327,122,14.375646591181107,78.42457870805848,0
Andhra Pradesh,Y S R Kadapa,Vemula,33,3,31,osm,30,1,30,3,2,2,6329,122,14.363834695064003,78.34066260861513,0
Andhra Pradesh,Y S R Kadapa,Vontimitta,141,1,52,hab,49,3,110,31,89,2,6389,122,14.380809787047236,79.0464351142005,0
Andhra Pradesh,Y S R Kadapa,Yerraguntla,32,1,31,hab,28,3,26,6,1,2,6470,122,14.661549317655366,78.50979841214983,0
Arunachal Pradesh,Anjaw,Hawai-Walong,80,0,55,hab,48,7,39,41,25,3,2197,24,28.012580820156643,97.00883085208916,0
Arunachal Pradesh,Anjaw,Hayuliang,192,0,146,hab,116,30,100,92,46,3,2203,24,28.160303872290577,96.58676598275136,0
Arunachal Pradesh,Changlang,Bordumsa-Diyun,73,0,3,hab,3,0,7,66,70,3,1033,106,27.525461112151113,96.01257966110212,0
Arunachal Pradesh,Changlang,Changlang,72,1,32,hab,31,1,36,36,40,3,1175,106,27.15785591831969,95.71943352874263,0
Arunachal Pradesh,Changlang,Khagam Miao,88,0,29,hab,25,4,33,55,59,3,2910,106,27.441193063085887,96.6140443015154,0
Arunachal Pradesh,Changlang,Khimiyang,39,0,27,hab,20,7,27,12,12,3,3006,106,27.05469110815807,95.79309637905845,0
Arunachal Pradesh,Changlang,Nampong Manmao,77,1,26,hab,22,4,32,45,51,3,4128,106,27.2895376813704,96.13094519802388,0
Arunachal Pradesh,Dibang Valley,Anelieh Arzoo,40,1,4,hab,3,1,4,36,36,3,192,155,28.543397398465885,95.66795452745109,0
Arunachal Pradesh,Dibang Valley,Anini Mipi,61,0,22,hab,16,6,34,27,39,3,195,155,29.074428896217462,95.91132836284814,0
Arunachal Pradesh,Dibang Valley,Etalin Malinye,34,0,34,hab,18,16,16,18,0,3,1749,155,28.769000536402842,96.01038973531794,0
Arunachal Pradesh,East Kameng,Bameng,93,0,43,hab,41,2,50,43,50,3,483,168,27.69062142623538,92.78537460749492,0
Arunachal Pradesh,East Kameng,Bana,39,0,3,hab,3,0,6,33,36,3,489,168,27.289927300266104,92.93272800898946,0
Arunachal Pradesh,East Kameng,Chayangtajo,52,0,17,hab,14,3,17,35,35,3,1214,168,27.738472271525122,93.10199016853619,0
Arunachal Pradesh,East Kameng,Pipu,36,0,19,hab,18,1,22,14,17,3,4771,168,27.489942260053326,93.19814531672426,0
Arunachal Pradesh,East Kameng,Seppa,35,1,15,hab,11,4,12,23,20,3,5489,168,27.396467218472498,93.01658758519686,0
Arunachal Pradesh,East Siang,Mebo,18,0,9,hab,9,0,11,7,9,3,3801,170,28.14788614064909,95.43672900164188,0
Arunachal Pradesh,East Siang,Pasighat,27,0,1,hab,1,0,1,26,26,3,4588,170,28.01271937627646,95.3161709363579,0
Arunachal Pradesh,East Siang,Ruksin,31,0,6,hab,6,0,6,25,25,3,5207,170,27.905111494460435,95.24950377187307,0
Arunachal Pradesh,Kamale,Raga,206,0,3,hab,3,0,7,199,203,3,7668,679,27.738476169152747,94.1130257875746,0
Arunachal Pradesh,Kra Daadi,Chambang,153,0,4,hab,4,0,19,134,149,3,7675,673,27.83611270063273,93.8026580240178,0
Arunachal Pradesh,Kra Daadi,Palin,108,0,1,hab,1,0,14,94,107,3,7673,673,27.739054939495965,93.65023372425792,0
Arunachal Pradesh,Kra Daadi,Tali,78,0,8,hab,6,2,9,69,70,3,7674,673,28.08930371215375,93.74885575735688,0
Arunachal Pradesh,Kurung Kumey,Damin,118,0,13,hab,11,2,30,88,105,3,1416,321,28.14821721703793,93.34831250321842,0
Arunachal Pradesh,Kurung Kumey,Koloriang,68,0,0,hab,0,0,0,68,68,3,3103,321,27.894247487848762,93.35720942064594,0
Arunachal Pradesh,Kurung Kumey,Nyapin,70,0,11,hab,11,0,25,45,59,3,4364,321,27.70755082098347,93.38164608707004,0
Arunachal Pradesh,Kurung Kumey,Sangram,69,0,1,hab,1,0,5,64,68,3,5358,321,27.834225157054302,93.54501105465015,0
Arunachal Pradesh,Kurung Kumey,Sarli,38,0,5,hab,4,1,6,32,33,3,5415,321,28.019916760246456,93.0015344904483,0
Arunachal Pradesh,Lepa Rada,Basar,72,0,11,hab,11,0,13,59,61,3,7664,677,27.934246122614535,94.71812265157885,0
Arunachal Pradesh,Lohit,Tezu,64,0,5,hab,4,1,5,59,59,3,5965,334,28.04350287287922,96.18821267923016,0
Arunachal Pradesh,Lohit,Wakro,52,0,3,hab,3,0,9,43,49,3,6409,334,27.757885053654068,96.44521365655284,0
Arunachal Pradesh,Longding,Kanubari,37,0,22,hab,20,2,21,16,15,3,7667,676,27.003223313277097,95.29508858628475,0
Arunachal Pradesh,Longding,Niausa,15,0,17,osm,13,4,11,4,-2,3,7666,676,26.841744971551865,95.2822868301685,0
Arunachal Pradesh,Longding,Pongchau Wakka,26,0,19,hab,14,5,16,10,7,3,7665,676,26.77041690179338,95.37945107627546,0
Arunachal Pradesh,Lower Dibang Valley,Dambuk,41,0,8,hab,6,2,20,21,33,3,1412,336,28.268435448056263,95.53924605184348,0
Arunachal Pradesh,Lower Dibang Valley,Hunli Desali,56,0,2,hab,1,1,2,54,54,3,2258,336,28.336489555676994,96.04150162362718,0
Arunachal Pradesh,Lower Dibang Valley,Roing,166,0,7,hab,6,1,24,142,159,3,5186,336,28.093718173007602,95.83682750143414,0
Arunachal Pradesh,Lower Siang,Gensi,26,0,5,hab,5,0,5,21,21,3,7670,675,27.77143774094685,94.49827396408234,0
Arunachal Pradesh,Lower Siang,Likabali,46,2,4,hab,3,1,6,40,42,3,7671,675,27.6727990104702,94.56730982163222,0
Arunachal Pradesh,Lower Siang,Ramle Bango,32,0,4,hab,4,0,4,28,28,3,7669,675,27.885076726342216,95.00080084467268,0
Arunachal Pradesh,Lower Subansiri,Ziro-I,213,0,1,hab,1,0,6,207,212,3,6487,337,27.55437778706206,93.88637779779916,0
Arunachal Pradesh,Lower Subansiri,Ziro-II,176,0,4,hab,4,0,10,166,172,3,6488,337,27.50821173525518,93.72200792943178,0
Arunachal Pradesh,Namsai,Lekang,54,0,2,hab,1,1,2,52,52,3,7122,640,27.619752271111295,95.84077953034297,0
Arunachal Pradesh,Namsai,Namsai-Chowkham,118,0,5,hab,4,1,8,110,113,3,7123,640,27.699357598145298,96.04208219359849,0
Arunachal Pradesh,Pakke kessang,Pakkekessang,74,1,4,hab,4,0,6,68,70,3,7672,674,27.110681130846064,93.02233543748909,0
Arunachal Pradesh,Papum Pare,Balijan,109,0,6,hab,4,2,18,91,103,3,457,418,27.03476417667084,93.44683423278757,0
Arunachal Pradesh,Papum Pare,Doimukh,159,0,5,hab,5,0,19,140,154,3,1655,418,27.260922818183957,93.83719025747455,0
Arunachal Pradesh,Papum Pare,Mengio,42,0,1,hab,1,0,7,35,41,3,3840,418,27.49888561776537,93.44674839684689,0
Arunachal Pradesh,Papum Pare,Sagalee,144,0,5,hab,5,0,20,124,139,3,5241,418,27.260037929794805,93.49783516815556,0
Arunachal Pradesh,Shi Yomi,Mechuka,52,0,8,hab,5,3,6,46,44,3,7662,678,28.547554003213552,94.23996926744799,0
Arunachal Pradesh,Shi Yomi,Monigong,59,0,7,hab,4,3,13,46,52,3,7663,678,28.81111578191022,94.29448581056113,0
Arunachal Pradesh,Siang,Kaying,27,0,8,hab,8,0,8,19,19,3,7676,672,28.57408741419511,94.63427587152756,0
Arunachal Pradesh,Siang,Pangin Boleng,43,0,9,hab,8,1,11,32,34,3,7678,672,28.29551357287799,94.99134747437348,0
Arunachal Pradesh,Siang,Rumgong,24,0,4,hab,4,0,7,17,20,3,7677,672,28.306569888692337,94.82539739398425,0
Arunachal Pradesh,Tawang,Lumla Zemithang,65,0,20,hab,13,7,10,55,45,3,3444,538,27.666857471417075,91.69705151372787,0
Arunachal Pradesh,Tawang,Mukto Thingbu,57,1,17,hab,10,7,18,39,40,3,3964,538,27.657467231574586,92.11144020094186,0
Arunachal Pradesh,Tawang,Tawang,89,0,5,hab,2,3,10,79,84,3,5936,538,27.656612759575587,91.86336147084191,0
Arunachal Pradesh,Tirap,Khonsa,63,0,45,hab,40,5,43,20,18,3,3013,549,27.004151849459756,95.49751029236732,0
Arunachal Pradesh,Tirap,Lazu,19,0,16,hab,16,0,18,1,3,3,3402,549,26.890120177585217,95.58689779747185,0
Arunachal Pradesh,Tirap,Namsang,32,0,17,hab,17,0,18,14,15,3,4130,549,27.163950482458667,95.53512843396754,0
Arunachal Pradesh,Upper Siang,Geku,21,0,3,hab,3,0,5,16,18,3,1905,569,28.314617602215012,95.17535938312218,0
Arunachal Pradesh,Upper Siang,Jengging,11,0,3,hab,3,0,5,6,8,3,2478,569,28.660510134858626,94.90974093217561,0
Arunachal Pradesh,Upper Siang,Mariyang,18,0,5,hab,4,1,9,9,13,3,3732,569,28.52105741216435,95.26800009965048,0
Arunachal Pradesh,Upper Siang,Tuting,42,0,25,hab,21,4,21,21,17,3,6160,569,28.978866150581684,94.83163340830619,0
Arunachal Pradesh,Upper Siang,Yingkiong,7,0,2,hab,2,0,2,5,5,3,6473,569,28.71041640918409,95.03698437915153,0
Arunachal Pradesh,Upper Subansiri,Baririjo,41,0,4,hab,4,0,8,33,37,3,605,570,27.91509750202855,94.43128244988475,0
Arunachal Pradesh,Upper Subansiri,Daporijo,26,0,0,hab,0,0,0,26,26,3,1441,570,28.006487961079305,94.15521007534178,0
Arunachal Pradesh,Upper Subansiri,Dumporijo,77,0,1,hab,0,1,0,77,76,3,1701,570,28.080076830217934,94.28173694521098,0
Arunachal Pradesh,Upper Subansiri,Giba,91,0,7,hab,7,0,15,76,84,3,1951,570,28.111289337024417,93.99309757413664,0
Arunachal Pradesh,Upper Subansiri,Nacho,69,0,50,hab,25,25,32,37,19,3,4044,570,28.456679939083273,93.62923812983348,0
Arunachal Pradesh,Upper Subansiri,Siyum,48,0,8,hab,5,3,7,41,40,3,5702,570,28.48233230362089,94.02174166484693,0
Arunachal Pradesh,Upper Subansiri,Taliha,106,0,13,hab,13,0,28,78,93,3,5873,570,28.27584112340833,94.20941451673646,0
Arunachal Pradesh,West Kameng,Dirang,93,0,9,hab,5,4,8,85,84,3,1645,592,27.430074045478783,92.2513103320651,0
Arunachal Pradesh,West Kameng,Kalaktang,60,0,7,hab,7,0,13,47,53,3,2609,592,27.09008888863197,92.24038979018384,0
Arunachal Pradesh,West Kameng,Nafra,37,0,2,hab,2,0,2,35,35,3,4054,592,27.493279342278647,92.53656693915319,0
Arunachal Pradesh,West Kameng,Thrizino,73,0,16,hab,14,2,23,50,57,3,6065,592,27.188438780071067,92.5947868289848,0
Arunachal Pradesh,West Siang,Along  West,39,0,12,hab,12,0,14,25,27,3,97,594,28.13242371007069,94.71304317098341,0
Arunachal Pradesh,West Siang,Along East,22,0,4,hab,4,0,7,15,18,3,98,594,28.096428205961605,94.83979961917738,0
Arunachal Pradesh,West Siang,Liromoba,77,0,24,hab,20,4,29,48,53,3,3420,594,28.232244585781164,94.532868002874,0
Assam,Baksa,Baksa,330,0,2,hab,2,0,11,319,328,4,7083,634,26.671341214404748,91.3353463461719,0
Assam,Baksa,Dhamdhama,251,0,4,hab,3,1,17,234,247,4,7084,634,26.679372266971228,91.44701373651361,0
Assam,Baksa,Gobardhana,194,0,2,hab,2,0,5,189,192,4,7071,634,26.607090184658666,90.97124321005462,0
Assam,Baksa,Goreswar,244,0,1,hab,1,0,2,242,243,4,7075,634,26.57638279298855,91.70148183966204,0
Assam,Baksa,Jalah,462,0,7,hab,7,0,60,402,455,4,7072,634,26.699648431955797,91.15402170310725,0
Assam,Baksa,Nagrijuli,241,0,0,hab,0,0,0,241,241,4,7085,634,26.69263339153975,91.6361694726438,0
Assam,Baksa,Tamulpur,274,0,2,hab,2,0,10,264,272,4,7086,634,26.689539898865668,91.5434369275072,0
Assam,Baksa,Tihu Barama,146,1,1,hab,1,0,8,138,145,4,7087,634,26.551914280229003,91.36444699871419,0
Assam,Barpeta,Bajali,187,0,0,hab,0,0,0,187,187,4,425,56,26.52670616829671,91.16946331831303,0
Assam,Barpeta,Barpeta,177,0,0,hab,0,0,0,177,177,4,617,56,26.37341250747209,91.1112446216281,0
Assam,Barpeta,Bhabanipur,165,0,0,hab,0,0,0,165,165,4,742,56,26.421920925681352,91.00602488571701,0
Assam,Barpeta,Chakchaka,204,0,1,hab,1,0,2,202,203,4,1115,56,26.499299362168625,90.87509537844772,0
Assam,Barpeta,Chenga,114,0,1,hab,1,0,12,102,113,4,1229,56,26.21404392954124,91.13764546631467,0
Assam,Barpeta,Gama-Fulbari,110,0,0,hab,0,0,0,110,110,4,1818,56,26.217511485912205,91.0461593753404,0
Assam,Barpeta,Mandia,401,0,1,hab,1,0,2,399,400,4,3648,56,26.210325840225256,90.85630189555945,0
Assam,Barpeta,Paka-Betbari,187,0,0,hab,0,0,0,187,187,4,4432,56,26.396417393877048,91.08861766359226,0
Assam,Barpeta,Rupsi,204,0,1,hab,1,0,6,198,203,4,5216,56,26.337026916290494,90.84331482433434,0
Assam,Barpeta,Sarukhetri,147,0,0,hab,0,0,0,147,147,4,5425,56,26.33119199765754,91.2045321709745,0
Assam,Bongaigaon,Boitamari,174,0,2,hab,2,0,7,167,172,4,1011,88,26.27490492696434,90.52359507004337,0
Assam,Bongaigaon,Dangtol,146,0,0,hab,0,0,0,146,146,4,1427,88,26.43013491270821,90.52937808776483,0
Assam,Bongaigaon,Manikpur,135,0,0,hab,0,0,0,135,135,4,3682,88,26.477922671806127,90.74723981355615,0
Assam,Bongaigaon,Srijangram,114,0,2,hab,2,0,5,109,112,4,5760,88,26.3754400945935,90.711151452607,0
Assam,Bongaigaon,Tapattari,99,0,0,hab,0,0,0,99,99,4,5913,88,26.291515709140576,90.68074710645243,0
Assam,Cachar,Banskandi,48,0,1,hab,0,1,0,48,47,4,540,97,24.810214843476224,92.90590172554609,0
Assam,Cachar,Binnakandi,52,0,2,hab,2,0,2,50,50,4,960,97,24.658955305920298,93.01827580304743,0
Assam,Cachar,Borjalenga,62,0,4,hab,4,0,11,51,58,4,1037,97,24.644861960107526,92.74540074911246,0
Assam,Cachar,Borkhola,101,0,2,hab,2,0,3,98,99,4,1039,97,24.95895875108302,92.78568621158773,0
Assam,Cachar,Kalain,124,0,2,hab,1,1,2,122,122,4,2603,97,25.026323374640153,92.60091872389589,0
Assam,Cachar,Katigorah,64,0,1,hab,1,0,5,59,63,4,2836,97,24.892349876286023,92.58426326563301,0
Assam,Cachar,Lakhipur,83,0,6,hab,6,0,11,72,77,4,3344,97,24.809765892106526,93.09139014739605,0
Assam,Cachar,Narsingpur,110,0,1,hab,1,0,3,107,109,4,4209,97,24.520018859136826,92.86916554019548,0
Assam,Cachar,Palonghat,89,0,1,hab,1,0,2,87,88,4,4480,97,24.599974202093286,92.9431066213171,0
Assam,Cachar,Rajabazar,108,0,1,hab,1,0,2,106,107,4,4958,97,24.918201624914882,93.10958857192779,0
Assam,Cachar,Salchapra,60,0,0,hab,0,0,0,60,60,4,5298,97,24.867316092940722,92.69795464649124,0
Assam,Cachar,Silchar,44,0,0,hab,0,0,0,44,44,4,5630,97,24.814439598988443,92.78205542084919,0
Assam,Cachar,Sonai,94,0,1,hab,1,0,4,90,93,4,5721,97,24.714830331511408,92.88800200566556,0
Assam,Cachar,Tapang,45,0,0,hab,0,0,0,45,45,4,5912,97,24.737292737763063,92.70391371934744,0
Assam,Cachar,Udharbond,104,0,3,hab,3,0,7,97,101,4,6181,97,24.966129167550545,92.94005234051598,0
Assam,Chirang,Borobajar,310,1,1,hab,1,0,2,308,309,4,7073,635,26.663143284934144,90.7080473343962,0
Assam,Chirang,Sidli Chirang I,146,0,0,hab,0,0,0,146,146,4,7074,635,26.551041331963315,90.45731092722632,0
Assam,Chirang,Sidli Chirang II,286,1,2,hab,2,0,6,280,284,4,7076,635,26.71793749894546,90.44616078167094,0
Assam,Darrang,Bechimari,85,0,2,hab,2,0,7,78,83,4,680,134,26.625957216296086,92.2014329097534,0
Assam,Darrang,Dalgaon Sialmari,146,0,3,hab,3,0,12,134,143,4,1404,134,26.53007275893703,92.23674310006562,0
Assam,Darrang,Kalaigaon,254,1,0,hab,0,0,0,254,254,4,2602,134,26.58522591699469,91.98104798723307,0
Assam,Darrang,Pachim Mangaldoi,98,0,0,hab,0,0,0,98,98,4,4407,134,26.415273370896717,91.98782465621316,0
Assam,Darrang,Pub Mangaldoi,103,0,0,hab,0,0,0,103,103,4,4837,134,26.43886643184136,92.0801543015955,0
Assam,Darrang,Sipajhar,352,0,3,hab,3,0,12,340,349,4,5665,134,26.37465023056558,91.8592132332468,0
Assam,Dhemaji,Bordoloni,235,0,2,hab,1,1,3,232,233,4,1032,151,27.477495286170978,94.35281419489135,0
Assam,Dhemaji,Dhemaji,266,0,3,hab,3,0,6,260,263,4,1607,151,27.465449717228857,94.51537791067716,0
Assam,Dhemaji,Machkhowa,63,0,0,hab,0,0,0,63,63,4,3462,151,27.331484847295226,94.56575631502935,0
Assam,Dhemaji,Murkongsellek,372,0,23,hab,19,4,44,328,349,4,4010,151,27.74763415360083,95.1585452078612,0
Assam,Dhemaji,Sissiborgaon,387,1,28,hab,27,1,71,316,359,4,5687,151,27.541168833935075,94.71937102966854,0
Assam,Dhubri,Agomoni,72,0,2,hab,1,1,1,71,70,4,34,153,26.23122853045144,89.76816397129397,0
Assam,Dhubri,Bilasipara,89,0,1,hab,1,0,5,84,88,4,942,153,26.275635951824633,90.22822332236102,0
Assam,Dhubri,Birshing Jarua,156,0,1,hab,1,0,2,154,155,4,974,153,25.97508216167142,89.99705943284434,0
Assam,Dhubri,Chapar Salkocha,145,0,1,hab,1,0,3,142,144,4,1183,153,26.270405184363067,90.35869691092762,0
Assam,Dhubri,Debitola,192,1,0,hab,0,0,0,192,192,4,1475,153,26.217186464181324,90.01781408336946,0
Assam,Dhubri,Fekamari,88,0,2,hab,2,0,3,85,86,4,1782,153,25.72012720901378,89.89511151388173,0
Assam,Dhubri,Gauripur,92,0,0,hab,0,0,0,92,92,4,1899,153,26.018312084685746,89.90766126326905,0
Assam,Dhubri,Golakganj,94,0,1,hab,1,0,2,92,93,4,1985,153,26.20192450914797,89.84550059011669,0
Assam,Dhubri,Hatidhura,99,0,2,hab,1,1,1,98,97,4,7077,153,26.369376726142878,89.86974587110352,0
Assam,Dhubri,Jamadarhat,63,0,0,hab,0,0,0,63,63,4,2407,153,26.01495921441894,90.13029157462731,0
Assam,Dhubri,Mahamaya,146,1,1,hab,1,0,7,139,145,4,3517,153,26.25162431254185,90.13427279739543,0
Assam,Dhubri,Mankachar,64,1,0,hab,0,0,0,64,64,4,3691,153,25.5862249478884,89.92492814731534,0
Assam,Dhubri,Nayeralga,49,0,0,hab,0,0,0,49,49,4,4260,153,26.174138232185925,90.19644195519209,0
Assam,Dhubri,Rupsi,128,0,1,hab,1,0,2,126,127,4,5215,153,26.147043981640707,89.89785618655262,0
Assam,Dhubri,South Salmara,58,0,2,hab,2,0,4,54,56,4,5753,153,25.920593099441895,90.02612337748792,0
Assam,Dibrugarh,Borbarua,271,0,1,hab,0,1,0,271,270,4,1031,156,27.363825909347966,94.79472200932956,0
Assam,Dibrugarh,Jaipur,205,0,5,hab,5,0,10,195,200,4,2359,156,27.242231373781006,95.32876531190365,0
Assam,Dibrugarh,Khowang,310,0,0,hab,0,0,0,310,310,4,3018,156,27.237580778296763,94.89335914927851,0
Assam,Dibrugarh,Lahowal,146,0,6,hab,6,0,11,135,140,4,3330,156,27.540373516242106,95.04180671380955,0
Assam,Dibrugarh,Panitola,114,1,4,hab,3,1,9,105,110,4,4521,156,27.533114468948362,95.20334156119051,0
Assam,Dibrugarh,Tengakhat,255,0,2,hab,2,0,7,248,253,4,5955,156,27.356490167671236,95.26889043064806,0
Assam,Dibrugarh,Tingkhong,247,1,2,hab,2,0,2,245,245,4,6091,156,27.21579979612685,95.1053279387268,0
Assam,Goalpara,Balijana,199,0,4,hab,4,0,19,180,195,4,458,196,26.101280338149955,90.54676297275361,0
Assam,Goalpara,Joleshwar,154,0,0,hab,0,0,0,154,154,4,2523,196,26.046885071800173,90.22875187715891,0
Assam,Goalpara,Kharmoja,155,0,0,hab,0,0,0,155,155,4,2978,196,26.12696221579554,90.41783565056637,0
Assam,Goalpara,Krishnai,171,0,2,hab,2,0,7,164,169,4,3204,196,26.001588136391568,90.63659810725883,0
Assam,Goalpara,Kushdhuwa,188,0,0,hab,0,0,0,188,188,4,3301,196,25.99061721253741,90.81308727709967,0
Assam,Goalpara,Lakhipur,164,1,2,hab,2,0,3,161,162,4,3343,196,26.064018925898008,90.34319909540076,0
Assam,Goalpara,Matia,125,0,2,hab,1,1,5,120,123,4,3768,196,26.10327745703899,90.74733326603607,0
Assam,Goalpara,Rangjuli,183,0,1,hab,1,0,1,182,182,4,5084,196,25.991115425295092,90.98997984584346,0
Assam,Golaghat,Gamariguri ,228,0,0,hab,0,0,0,228,228,4,1819,198,26.312790334070076,94.04582202400344,0
Assam,Golaghat,Golaghat  East ,176,0,0,hab,0,0,0,176,176,4,1980,198,26.46528347289835,94.02198908045253,0
Assam,Golaghat,Golaghat  West ,246,0,3,hab,3,0,17,229,243,4,1981,198,26.678934219128855,93.59586241134252,0
Assam,Golaghat,Golaghat Central ,272,0,1,hab,1,0,3,269,271,4,1982,198,26.597106862448484,93.94699760539059,0
Assam,Golaghat,Golaghat North ,71,0,0,hab,0,0,0,71,71,4,1983,198,26.70194507900161,93.93302868461274,0
Assam,Golaghat,Golaghat South ,462,0,5,hab,4,1,10,452,457,4,1984,198,26.094167753057025,93.89432548168853,0
Assam,Golaghat,Kakodonga ,90,0,1,hab,1,0,2,88,89,4,2596,198,26.693572190875045,94.0192788537105,0
Assam,Golaghat,Morongi ,154,0,3,hab,3,0,5,149,151,4,3928,198,26.496621703169613,93.84272149320716,0
Assam,Hailakandi,Algapur,92,0,2,hab,2,0,3,89,90,4,83,210,24.78380602556433,92.60593087524589,0
Assam,Hailakandi,Hailakandi,88,0,0,hab,0,0,0,88,88,4,2103,210,24.678338594424197,92.58287718764429,0
Assam,Hailakandi,Katlicherra,72,0,0,hab,0,0,0,72,72,4,2839,210,24.475856916848223,92.55319495189153,0
Assam,Hailakandi,Lala,125,0,3,hab,1,2,1,124,122,4,3355,210,24.563711779752406,92.62636438109116,0
Assam,Hailakandi,South Hailakandi,112,0,1,hab,1,0,2,110,111,4,5751,210,24.332442575536835,92.56746443813172,0
Assam,Jorhat,Jorhat  ,191,1,0,hab,0,0,0,191,191,4,2525,261,26.674659208224895,94.20274892089894,0
Assam,Jorhat,Jorhat Central ,121,0,1,hab,1,0,2,119,120,4,2526,261,26.771762811281796,94.33233838266231,0
Assam,Jorhat,Jorhat East ,131,0,1,hab,1,0,2,129,130,4,2527,261,26.71363516924662,94.46334832264795,0
Assam,Jorhat,Jorhat North West ,182,0,3,hab,2,1,6,176,179,4,2528,261,26.801270677026473,94.13549528017742,0
Assam,Jorhat,Kaliapani ,122,0,3,hab,3,0,7,115,119,4,2632,261,26.855490186886865,94.41242476700043,0
Assam,Jorhat,Majuli ,184,0,8,hab,7,1,21,163,176,4,3569,261,26.896901556499056,94.07431942779752,0
Assam,Jorhat,Titabar ,181,0,3,hab,3,0,5,176,178,4,6116,261,26.53669647397418,94.22545539751364,0
Assam,Jorhat,Ujani Majuli ,131,0,0,hab,0,0,0,131,131,4,6187,261,27.0517430869572,94.39742147947827,0
Assam,Kamrup Rural,Bezera,408,0,2,hab,2,0,28,380,406,4,740,266,26.258694145268322,91.72762010836226,0
Assam,Kamrup Rural,Bihdia Jajikona,220,0,0,hab,0,0,0,220,220,4,918,266,26.411295031430484,91.72870315466639,0
Assam,Kamrup Rural,Boko,336,0,0,hab,0,0,0,336,336,4,1014,266,25.90384159690504,91.1597525506864,0
Assam,Kamrup Rural,Bongaon,86,0,0,hab,0,0,0,86,86,4,1027,266,25.928375136367958,91.29430545081819,0
Assam,Kamrup Rural,Chamaria,220,0,3,hab,3,0,18,202,217,4,1130,266,26.096893196909562,91.09351820234187,0
Assam,Kamrup Rural,Chandrapur,162,0,4,hab,3,1,16,146,158,4,1166,266,26.181999636298645,91.8734203119162,0
Assam,Kamrup Rural,Chayani Borduar,279,0,2,hab,2,0,23,256,277,4,1215,266,25.977240320099472,91.46898251336863,0
Assam,Kamrup Rural,Chaygaon,283,0,1,hab,1,0,7,276,282,4,1216,266,26.008473237333952,91.37647060201142,0
Assam,Kamrup Rural,Dimoria,328,0,0,hab,0,0,0,328,328,4,1636,266,26.107234686308264,92.01337559332953,0
Assam,Kamrup Rural,Goroimari,198,1,1,hab,1,0,15,183,197,4,2016,266,26.112513810956703,91.24817654487026,0
Assam,Kamrup Rural,Hajo,538,0,1,hab,1,0,11,527,537,4,2108,266,26.24352420545986,91.51118991476528,0
Assam,Kamrup Rural,Kamalpur,162,1,1,hab,1,0,4,158,161,4,2673,266,26.31243101431045,91.66847268336444,0
Assam,Kamrup Rural,Rampur,139,0,1,hab,1,0,7,132,138,4,5058,266,26.115536881386454,91.42819356397762,0
Assam,Kamrup Rural,Rangia,266,0,2,hab,2,0,13,253,264,4,5083,266,26.421779169288293,91.58987189023819,0
Assam,Kamrup Rural,Rani,259,0,1,hab,1,0,6,253,258,4,5087,266,26.03018241669613,91.6237229238756,0
Assam,Kamrup Rural,Sualkuchi,177,0,0,hab,0,0,0,177,177,4,5776,266,26.196594081143218,91.60065518773372,0
Assam,Karbi Anglong,Amri,146,0,11,hab,11,0,24,122,135,4,162,277,26.008289263641203,92.37024082952257,0
Assam,Karbi Anglong,Bokajan,357,2,16,hab,10,6,11,346,341,4,1012,277,26.072052641718255,93.64679088013334,0
Assam,Karbi Anglong,Chinthong,160,0,2,hab,1,1,1,159,158,4,1311,277,25.837716873768905,92.37948509763463,0
Assam,Karbi Anglong,Howraghat,328,0,8,hab,8,0,21,307,320,4,2250,277,26.11645407822592,93.0833266496678,0
Assam,Karbi Anglong,Langsomepi,150,0,15,hab,15,0,33,117,135,4,3375,277,26.154414628192605,93.33134887829465,0
Assam,Karbi Anglong,Lumbajong,264,0,14,hab,10,4,13,251,250,4,3443,277,25.799686056860814,93.38638527019381,0
Assam,Karbi Anglong,Nilip,173,0,1,hab,1,0,4,169,172,4,4305,277,26.310621928866475,93.69470021789063,0
Assam,Karbi Anglong,Rongkhang,382,4,2,hab,2,0,5,377,380,4,5193,277,25.875397971373413,92.75814149445209,0
Assam,Karbi Anglong,Rongmongwe,196,6,34,hab,25,9,35,161,162,4,5195,277,26.438558459201943,93.35959348329665,0
Assam,Karbi Anglong,Samelangso,245,0,68,hab,51,17,100,145,177,4,5323,277,26.31180736079246,93.10264375497933,0
Assam,Karbi Anglong,Socheng,88,2,2,hab,2,0,2,86,86,4,5704,277,25.693634535391652,92.62840222303683,0
Assam,Karimganj,Badarpur,138,0,0,hab,0,0,0,138,138,4,355,279,24.825025508614,92.50456246236067,0
Assam,Karimganj,Dullav Cherra,222,0,1,hab,1,0,5,217,221,4,1693,279,24.414128398113593,92.42150491084381,0
Assam,Karimganj,Lowairpoa,229,0,3,hab,1,2,6,223,226,4,3440,279,24.424124542533317,92.28295075309569,0
Assam,Karimganj,North Karimganj,159,0,0,hab,0,0,0,159,159,4,4342,279,24.828760573130655,92.29823030555536,0
Assam,Karimganj,Patharkandi,233,1,4,hab,4,0,21,212,229,4,4614,279,24.630489944520455,92.31773405754967,0
Assam,Karimganj,Rknagar,154,0,0,hab,0,0,0,154,154,4,5175,279,24.62715369213519,92.46243447787242,0
Assam,Karimganj,South Karimganj,202,0,1,hab,1,0,10,192,201,4,5752,279,24.766861720310523,92.40377555844154,0
Assam,Kokrajhar,Dotoma,220,0,2,hab,2,0,4,216,218,4,1672,303,26.575623270846584,90.18807306498914,0
Assam,Kokrajhar,Gossaigaon,117,0,2,hab,2,0,2,115,115,4,2021,303,26.38343170527035,90.02032735337986,0
Assam,Kokrajhar,Kachugaon,244,0,1,hab,1,0,3,241,243,4,2557,303,26.595574163199764,90.01111652384884,0
Assam,Kokrajhar,Kokrajhar,370,3,2,hab,2,0,3,367,368,4,3085,303,26.55837663274363,90.30937449522641,0
Assam,Lakhimpur,Bihpuria,154,0,0,hab,0,0,0,154,154,4,921,325,26.998513801947496,93.9750509542494,0
Assam,Lakhimpur,Boginodi,217,0,1,hab,1,0,3,214,216,4,1006,325,27.37717668350515,94.19878898333121,0
Assam,Lakhimpur,Dhakuakhana,193,0,1,hab,1,0,4,189,192,4,1541,325,27.213269769853607,94.46853896214051,0
Assam,Lakhimpur,Ghilamara,137,0,1,hab,1,0,6,131,136,4,1938,325,27.22373026439426,94.33517950321605,0
Assam,Lakhimpur,Karunabari,118,0,1,hab,1,0,1,117,117,4,2797,325,27.107457741641074,93.93097760660356,0
Assam,Lakhimpur,Lakhimpur,137,0,0,hab,0,0,0,137,137,4,3342,325,27.231070168370564,94.14416156883816,0
Assam,Lakhimpur,Narayanpur,208,0,1,hab,1,0,2,206,207,4,4177,325,26.958899495159386,93.82365424037953,0
Assam,Lakhimpur,Nowboicha,168,2,3,hab,3,0,10,158,165,4,4344,325,27.198322455777852,93.99596812492794,0
Assam,Lakhimpur,Telahi,121,0,2,hab,2,0,3,118,119,4,5946,325,27.088746840687328,94.1469680206262,0
Assam,Morigaon,Bhurbandha,192,0,3,hab,3,0,9,183,189,4,894,371,26.276081120957244,92.338797618173,0
Assam,Morigaon,Kopili,129,0,0,hab,0,0,0,129,129,4,3127,371,26.27267385041665,92.45180136555528,0
Assam,Morigaon,Lahorighat,252,0,1,hab,1,0,8,244,251,4,3329,371,26.379270149436014,92.25321687375188,0
Assam,Morigaon,Mayong,314,0,9,hab,8,1,24,290,305,4,3796,371,26.199081004841553,92.20430768220213,0
Assam,Morigaon,Moirabari,139,0,0,hab,0,0,0,139,139,4,3903,371,26.45219989844634,92.41441986501412,0
Assam,N.C.Hills,Diyung Valley,231,0,9,hab,9,0,19,212,222,4,1647,378,25.453926562569464,93.17065028889364,0
Assam,N.C.Hills,Diyungbra,110,0,0,hab,0,0,0,110,110,4,1648,378,25.634276159115434,92.89307004765445,0
Assam,N.C.Hills,Harangajao,99,0,2,hab,2,0,12,87,97,4,2138,378,25.17897518579072,92.86826477478716,0
Assam,N.C.Hills,Jatinga Valley,144,0,7,hab,7,0,13,131,137,4,2460,378,25.14377774150653,93.1960503289014,0
Assam,N.C.Hills,New Sangbar,91,0,4,hab,4,0,8,83,87,4,4283,378,25.424404998042217,92.79812025970983,0
Assam,Nalbari,Barbhag,110,0,1,hab,1,0,12,98,109,4,577,385,26.354552999120948,91.46977430101089,0
Assam,Nalbari,Borigog Bonbhag,208,0,1,hab,1,0,7,201,207,4,1034,385,26.492813755076565,91.51586310965705,0
Assam,Nalbari,Borkhetri,153,1,1,hab,1,0,8,145,152,4,1038,385,26.247771506342676,91.33441067935523,0
Assam,Nalbari,Madhupur,85,0,1,hab,1,0,1,84,84,4,3488,385,26.466811822593243,91.37207404851344,0
Assam,Nalbari,Paschim Nalbari,155,0,1,hab,1,0,5,150,154,4,4586,385,26.384971076138893,91.32790309641433,0
Assam,Nalbari,Pub Nalbari,200,0,0,hab,0,0,0,200,200,4,4838,385,26.427179103424063,91.44386232084302,0
Assam,Nalbari,Tihu,66,0,2,hab,2,0,7,59,64,4,6077,385,26.476968076976146,91.28558745922577,0
Assam,Nowgaon,Bajiagaon,131,0,1,hab,1,0,5,126,130,4,426,407,26.425258005238017,92.86840051925657,0
Assam,Nowgaon,Barhampur,153,0,1,hab,1,0,5,148,152,4,592,407,26.31832556668647,92.80186855936046,0
Assam,Nowgaon,Batadrava,124,0,0,hab,0,0,0,124,124,4,659,407,26.431234063227105,92.51910907355246,0
Assam,Nowgaon,Binnakandi,160,0,23,hab,17,6,10,150,137,4,959,407,26.115619840973924,92.89568668727,0
Assam,Nowgaon,Dalanghat,118,0,0,hab,0,0,0,118,118,4,1403,407,26.34181103825361,92.55594044338142,0
Assam,Nowgaon,Dhalapukhuri,138,0,0,hab,0,0,0,138,138,4,1542,407,25.9408292806408,92.87319667636365,0
Assam,Nowgaon,Jugijan,81,0,0,hab,0,0,0,81,81,4,2534,407,26.045009119731517,92.83633439242396,0
Assam,Nowgaon,Juria,165,0,0,hab,0,0,0,165,165,4,2547,407,26.465969395750708,92.61033521353154,0
Assam,Nowgaon,Kaliabar,158,0,29,hab,27,2,40,118,129,4,2627,407,26.584348569467622,93.09021820608973,0
Assam,Nowgaon,Kathiatali,297,0,2,hab,2,0,15,282,295,4,2829,407,26.132334639053532,92.68450444720186,0
Assam,Nowgaon,Khagarijan,80,0,1,hab,1,0,5,75,79,4,2912,407,26.350312745231694,92.65673835680242,0
Assam,Nowgaon,Lamding,163,0,0,hab,0,0,0,163,163,4,3371,407,25.861069081574783,93.1258490545655,0
Assam,Nowgaon,Laowkhowa,77,0,0,hab,0,0,0,77,77,4,3379,407,26.51042623859667,92.7914236071784,0
Assam,Nowgaon,Odali,132,0,0,hab,0,0,0,132,132,4,4373,407,25.96748275282583,93.01410022825851,0
Assam,Nowgaon,Pakhimaria,130,0,1,hab,1,0,2,128,129,4,4434,407,26.281093639099694,92.68521006054607,0
Assam,Nowgaon,Paschim Kaliabar,100,0,19,hab,16,3,32,68,81,4,4585,407,26.468030044797967,92.97526626944311,0
Assam,Nowgaon,Raha,227,0,1,hab,1,0,2,225,226,4,4923,407,26.189256660945762,92.53849681548357,0
Assam,Nowgaon,Rupahihat,107,0,1,hab,1,0,6,101,106,4,5210,407,26.433724578286515,92.73927081304863,0
Assam,Sibsagar,Amguri,138,0,0,hab,0,0,0,138,138,4,148,501,26.793468789178522,94.5954508713743,0
Assam,Sibsagar,Demow,319,0,0,hab,0,0,0,319,319,4,1490,501,27.12507239681847,94.70876807330677,0
Assam,Sibsagar,Gauri Sagar,194,0,5,hab,4,1,19,175,189,4,1896,501,26.91835390031837,94.5442214162318,0
Assam,Sibsagar,Lakwa,195,0,1,hab,1,0,4,191,194,4,3354,501,26.98350949148098,94.86553737143502,0
Assam,Sibsagar,Nazira,314,0,0,hab,0,0,0,314,314,4,4261,501,26.8644222529453,94.75164668275725,0
Assam,Sibsagar,Paschim Abhayapur,220,0,0,hab,0,0,0,220,220,4,4584,501,26.999749971772385,95.01738060229965,0
Assam,Sibsagar,Sapekhati,471,0,6,hab,2,4,23,448,465,4,5392,501,27.10019255538332,95.21895397493607,0
Assam,Sibsagar,Sivasagar,243,0,0,hab,0,0,0,243,243,4,5698,501,26.99941271058599,94.64204992186136,0
Assam,Sibsagar,Sonari,353,0,3,hab,3,0,10,343,350,4,5723,501,27.110045104816955,94.9468097023331,0
Assam,Sonitpur,Baghmora,116,0,1,hab,1,0,3,113,115,4,383,521,26.788134167053215,93.22285818311472,0
Assam,Sonitpur,Balipara,290,0,3,hab,3,0,5,285,287,4,461,521,26.877476973794103,92.77297274915557,0
Assam,Sonitpur,Barchola,142,0,1,hab,1,0,3,139,141,4,579,521,26.601736585277838,92.46292695025389,0
Assam,Sonitpur,Behali,107,0,0,hab,0,0,0,107,107,4,688,521,26.848625825360273,93.34278047850734,0
Assam,Sonitpur,Bihaguri,97,0,1,hab,1,0,1,96,96,4,914,521,26.629136741785892,92.64872430796676,0
Assam,Sonitpur,Biswanath,97,0,1,hab,1,0,6,91,96,4,992,521,26.704640220544043,93.1527886637071,0
Assam,Sonitpur,Chaiduar,216,0,2,hab,1,1,1,215,214,4,1105,521,26.835572991940868,93.52678667727896,0
Assam,Sonitpur,Dhekiajuli,242,1,1,hab,0,1,0,242,241,4,1606,521,26.815721090400807,92.4760705451815,0
Assam,Sonitpur,Gabharu,89,0,3,hab,3,0,10,79,86,4,1792,521,26.61061973093214,92.80467431693353,0
Assam,Sonitpur,Naduar,135,0,2,hab,2,0,7,128,133,4,4053,521,26.751200454231988,92.92537533982197,0
Assam,Sonitpur,Pub Chaiduar,241,0,1,hab,1,0,3,238,240,4,4836,521,26.879746777149307,93.68131402206647,0
Assam,Sonitpur,Rangapara,101,0,0,hab,0,0,0,101,101,4,5082,521,26.812644303760152,92.67516351269647,0
Assam,Sonitpur,Sakomatha,94,0,0,hab,0,0,0,94,94,4,5289,521,26.82885938502044,93.1132793280676,0
Assam,Sonitpur,Sootia,135,0,1,hab,1,0,6,129,134,4,5741,521,26.746385138057402,93.03401837356468,0
Assam,Tinsukia,Guijan,100,0,3,hab,2,1,3,97,97,4,2058,548,27.59481616844657,95.34317113669184,0
Assam,Tinsukia,Hapjan,183,0,5,hab,5,0,7,176,178,4,2134,548,27.55313723774784,95.49752983381119,0
Assam,Tinsukia,Itakhuli,145,0,1,hab,1,0,2,143,144,4,2319,548,27.43070480694496,95.4118990893309,0
Assam,Tinsukia,Kakopathar,255,0,2,hab,1,1,2,253,253,4,2597,548,27.574330151552964,95.71202057690817,0
Assam,Tinsukia,Margherita,233,0,29,hab,20,9,35,198,204,4,3726,548,27.351819573324807,95.7164318337973,0
Assam,Tinsukia,Sadiya,182,1,10,hab,9,1,18,164,172,4,5237,548,27.86549482551826,95.70259665540782,0
Assam,Tinsukia,Saikhowa,112,0,3,hab,3,0,6,106,109,4,5272,548,27.72349360353375,95.59019431068744,0
Assam,Udalguri,Bhergaon,278,0,6,hab,6,0,25,253,272,4,7078,636,26.732404125377336,91.80345605067242,0
Assam,Udalguri,Khoirabari,98,0,0,hab,0,0,0,98,98,4,7079,636,26.570491360263322,91.82641390095435,0
Assam,Udalguri,Mazbat,250,0,1,hab,1,0,8,242,249,4,7080,636,26.79973347221143,92.26811495060693,0
Assam,Udalguri,Rowta Charali,129,0,1,hab,1,0,5,124,128,4,7081,636,26.701385398366288,92.15445176065884,0
Assam,Udalguri,Udalguri,508,2,5,hab,5,0,20,488,503,4,7082,636,26.776605818532033,92.00433209913965,0
Bihar,Araria,Araria,219,5,0,hab,0,0,0,219,219,5,225,26,26.146642669752907,87.4681481162725,0
Bihar,Araria,Bhargama,124,4,2,hab,2,0,5,119,122,5,809,26,26.07356137151752,87.13974140581773,0
Bihar,Araria,Forbisganj,372,5,1,hab,0,1,0,372,371,5,1787,26,26.250556952441574,87.29160199447843,0
Bihar,Araria,Joukihat,300,0,2,hab,2,0,8,292,298,5,2530,26,26.0890117341772,87.5922315448107,0
Bihar,Araria,Kursakanta,237,3,2,hab,2,0,4,233,235,5,3288,26,26.348630264526395,87.40288301865256,0
Bihar,Araria,Narpatganj,247,2,22,hab,19,3,43,204,225,5,4201,26,26.339015523215707,87.13356008046416,0
Bihar,Araria,Palasi,381,1,1,hab,1,0,6,375,380,5,4455,26,26.244952682159372,87.60558094258698,0
Bihar,Araria,Raniganj,205,1,0,hab,0,0,0,205,205,5,5093,26,26.058597804360293,87.29268496840004,0
Bihar,Araria,Sikti,123,1,0,hab,0,0,0,123,123,5,5628,26,26.36478940375823,87.52820987623697,0
Bihar,Arwal,Arwal,144,3,1,hab,1,0,5,139,143,5,253,28,25.226412240299215,84.65195017079428,0
Bihar,Arwal,Banshi Surajpur,55,0,1,hab,1,0,3,52,54,5,538,28,25.106787750110936,84.73646423251448,0
Bihar,Arwal,Kaler,119,0,1,hab,0,1,0,119,118,5,2624,28,25.152720959040995,84.53302896334647,0
Bihar,Arwal,Karpi,151,2,14,hab,14,0,28,123,137,5,2792,28,25.17709590443437,84.71020158108819,0
Bihar,Arwal,Kurtha,101,6,12,hab,12,0,13,88,89,5,3291,28,25.125468780042695,84.8164051341631,0
Bihar,Aurangabad,Aurangabad,254,4,2,hab,2,0,7,247,252,5,316,32,24.790772520696688,84.42302963133704,0
Bihar,Aurangabad,Barun,256,0,5,hab,5,0,22,234,251,5,625,32,24.844436692484468,84.25678109521701,0
Bihar,Aurangabad,Daudnagar,133,0,1,hab,0,1,0,133,132,5,1468,32,25.039857438426143,84.43923799829355,0
Bihar,Aurangabad,Deo,241,1,1,hab,1,0,6,235,240,5,1493,32,24.624317048736106,84.40177849966003,0
Bihar,Aurangabad,Goh,202,0,1,hab,1,0,3,199,201,5,1972,32,24.984591464323376,84.65280011729796,0
Bihar,Aurangabad,Haspura,188,4,1,hab,1,0,13,175,187,5,2180,32,25.035026584990838,84.5555578100161,0
Bihar,Aurangabad,Kutumba,237,0,1,hab,1,0,2,235,236,5,3315,32,24.62455541125371,84.28836269886823,0
Bihar,Aurangabad,Madanpur,331,0,1,hab,1,0,7,324,330,5,3465,32,24.65735710409826,84.55400023630072,0
Bihar,Aurangabad,Nabinagar,410,1,1,hab,1,0,2,408,409,5,4043,32,24.66062525571591,84.13978608605427,0
Bihar,Aurangabad,Obra,279,2,1,hab,1,0,8,271,278,5,4368,32,24.929770010454664,84.40113795478571,0
Bihar,Aurangabad,Rafiganj,356,3,0,hab,0,0,0,356,356,5,4911,32,24.820693105408054,84.60268876962162,0
Bihar,Banka,Amarpur,184,1,0,hab,0,0,0,184,184,5,117,47,25.035699232850895,86.88569949205976,0
Bihar,Banka,Banka,262,5,0,hab,0,0,0,262,262,5,519,47,24.86315399608056,86.88141314784333,0
Bihar,Banka,Barahat,143,1,9,hab,9,0,13,130,134,5,560,47,24.880340902829158,87.01927405347564,0
Bihar,Banka,Baunsi,276,5,1,hab,1,0,4,272,275,5,668,47,24.731470837132562,87.00136925694106,0
Bihar,Banka,Belhar,241,7,1,hab,1,0,12,229,240,5,704,47,24.921421925353002,86.60156254713912,0
Bihar,Banka,Chanan,353,3,1,hab,1,0,17,336,352,5,1140,47,24.739303000993537,86.63630270662966,0
Bihar,Banka,Dhoraiya,208,0,15,hab,15,0,37,171,193,5,1614,47,24.973309544455635,87.10401610930542,0
Bihar,Banka,Fulli Dumar,143,2,1,hab,1,0,5,138,142,5,1788,47,24.950603361325495,86.7791069845269,0
Bihar,Banka,Katoria,584,12,2,hab,2,0,21,563,582,5,2842,47,24.705755321719234,86.80552135452501,0
Bihar,Banka,Rajaun,159,0,2,hab,2,0,3,156,157,5,4972,47,25.03044666710473,87.00367474169747,0
Bihar,Banka,Shambhuganj,139,0,1,hab,1,0,4,135,138,5,5530,47,25.050778293664887,86.72427296083038,0
Bihar,Begusarai,Bacchwara ,200,4,1,hab,1,0,11,189,199,5,346,62,25.5711535155298,85.86496376107205,0
Bihar,Begusarai,Bakhri,107,2,0,hab,0,0,0,107,107,5,431,62,25.582470061464058,86.25501262413582,0
Bihar,Begusarai,Baliya,78,0,0,hab,0,0,0,78,78,5,464,62,25.382750889256112,86.29867754420295,0
Bihar,Begusarai,Barauni,278,9,0,hab,0,0,0,278,278,5,575,62,25.437987341868492,86.03610401517597,0
Bihar,Begusarai,Begusarai,231,3,2,hab,2,0,2,229,229,5,687,62,25.447584519098584,86.16850735653259,0
Bihar,Begusarai,Bhagwanpur,314,10,1,hab,1,0,15,299,313,5,771,62,25.560176248116004,85.9993024527455,0
Bihar,Begusarai,Birpur,94,8,0,hab,0,0,0,94,94,5,972,62,25.527622824907624,86.08025447311928,0
Bihar,Begusarai,Cheriabariarpur ,143,2,3,hab,3,0,29,114,140,5,1239,62,25.603903029692713,86.09265471975226,0
Bihar,Begusarai,Chorhani,123,2,1,hab,1,0,3,120,122,5,1352,62,25.684458724450177,86.11735472958212,0
Bihar,Begusarai,Dandari,71,0,1,hab,1,0,7,64,70,5,1423,62,25.494212054013328,86.28870927530487,1
Bihar,Begusarai,Garhpura,92,2,1,hab,1,0,6,86,91,5,1875,62,25.651613713660694,86.1853773819275,0
Bihar,Begusarai,Khodwantpur,72,1,1,hab,1,0,2,70,71,5,3010,62,25.6835766374999,86.04088806581292,0
Bihar,Begusarai,Mansurchak,120,8,3,hab,3,0,44,76,117,5,3708,62,25.62854519952966,85.92509137596764,0
Bihar,Begusarai,Matihani,120,1,1,hab,1,0,13,107,119,5,3771,62,25.352503090713473,86.15393786040212,0
Bihar,Begusarai,Nawkothi,79,1,1,hab,1,0,7,72,78,5,4256,62,25.545193669965247,86.19484662208146,0
Bihar,Begusarai,Sahebpur Kamal,142,1,1,hab,1,0,6,136,141,5,5260,62,25.432057204996298,86.40326454282821,0
Bihar,Begusarai,Shamho Akha Kurha,39,0,1,hab,1,0,1,38,38,5,5531,62,25.289212083632755,86.20666931808128,0
Bihar,Begusarai,Teghara,178,11,1,hab,0,1,0,178,177,5,5938,62,25.476079511753703,85.9522904190125,0
Bihar,Bhagalpur,Bihpur,39,3,1,hab,1,0,1,38,38,5,920,67,25.399174781382115,86.92912904550246,0
Bihar,Bhagalpur,Gauradih,189,4,1,hab,1,0,7,182,188,5,1895,67,25.152186638731944,87.0662232214863,0
Bihar,Bhagalpur,Gopalpur,26,0,2,hab,2,0,3,23,24,5,2006,67,25.330502009790003,87.1818404667786,0
Bihar,Bhagalpur,Ismilepur,28,1,2,hab,1,1,3,25,26,5,2315,67,25.292848143583317,87.11776321065204,0
Bihar,Bhagalpur,Jagdishpur,306,7,1,hab,1,0,20,286,305,5,2340,67,25.1783806032896,86.97588790865244,0
Bihar,Bhagalpur,Kahalgaon,194,0,9,hab,8,1,17,177,185,5,2577,67,25.253049211693455,87.26469390141146,0
Bihar,Bhagalpur,Kharik,47,0,4,hab,4,0,11,36,43,5,2974,67,25.376465082190425,87.00025334928917,0
Bihar,Bhagalpur,Narayanpur,25,0,0,hab,0,0,0,25,25,5,4176,67,25.35977338784741,86.85103326893778,0
Bihar,Bhagalpur,Nathnagar,221,6,0,hab,0,0,0,221,221,5,4223,67,25.24064847428324,86.92602537707484,0
Bihar,Bhagalpur,Naugachhia,70,4,0,hab,0,0,0,70,70,5,4227,67,25.40209699006731,87.07016633162019,0
Bihar,Bhagalpur,Pirpaiti,277,5,23,hab,22,1,68,209,254,5,4774,67,25.30920244851624,87.41786424513349,0
Bihar,Bhagalpur,Rengra Chowk,27,7,2,hab,1,1,1,26,25,5,5155,67,25.392535022593744,87.19195347274817,0
Bihar,Bhagalpur,Sabaur,179,19,4,hab,3,1,11,168,175,5,5225,67,25.233051138558487,87.0752428991383,0
Bihar,Bhagalpur,Sanhaula,147,1,50,hab,50,0,56,91,97,5,5366,67,25.129079757659802,87.21090659839929,0
Bihar,Bhagalpur,Shahkund,357,0,1,hab,1,0,13,344,356,5,5513,67,25.149979736118663,86.84945056708753,0
Bihar,Bhagalpur,Sultanganj,370,5,1,hab,1,0,7,363,369,5,5795,67,25.209604354269302,86.76288487063484,0
Bihar,Bhojpur,Agion,79,0,1,hab,1,0,2,77,78,5,32,75,25.3496820139043,84.62684496097785,0
Bihar,Bhojpur,Arah,96,2,1,hab,1,0,1,95,95,5,215,75,25.60094203809041,84.62246103019949,0
Bihar,Bhojpur,Barhara,139,1,4,hab,4,0,6,133,135,5,593,75,25.682546476484923,84.67631329708632,0
Bihar,Bhojpur,Bihia,92,4,23,hab,23,0,38,54,69,5,919,75,25.576823150390002,84.4184800378126,0
Bihar,Bhojpur,Charpokhari,78,1,5,hab,4,1,6,72,73,5,1190,75,25.353972394141444,84.48058746938871,0
Bihar,Bhojpur,Garhani,53,0,0,hab,0,0,0,53,53,5,1872,75,25.414670530133396,84.55025049284495,0
Bihar,Bhojpur,Jagdishpur,133,1,40,hab,37,3,54,79,93,5,2341,75,25.48453844385452,84.45298923848144,0
Bihar,Bhojpur,Koilwar,94,2,3,hab,3,0,4,90,91,5,3082,75,25.580219049627487,84.75730382679356,0
Bihar,Bhojpur,Piro,136,1,31,hab,31,0,50,86,105,5,4773,75,25.346807996393395,84.35993825333598,0
Bihar,Bhojpur,Sahar,53,0,1,hab,1,0,2,51,52,5,5250,75,25.26056285615134,84.57627157926422,0
Bihar,Bhojpur,Sandesh,57,0,1,hab,1,0,5,52,56,5,5338,75,25.419502072935792,84.71549742927192,0
Bihar,Bhojpur,Shahpur,100,4,1,hab,1,0,1,99,99,5,5518,75,25.661662622828132,84.42755953319332,0
Bihar,Bhojpur,Tarari,93,0,1,hab,1,0,2,91,92,5,5921,75,25.242229499992753,84.43801204808706,0
Bihar,Bhojpur,Udwantnagar,69,0,16,hab,15,1,15,54,53,5,6186,75,25.509472489580972,84.61153852537596,0
Bihar,Buxar,Brahmpur,236,4,18,hab,18,0,69,167,218,5,1049,96,25.578945473887284,84.30767961856463,0
Bihar,Buxar,Buxar,199,5,1,hab,1,0,6,193,198,5,1086,96,25.55586406625205,84.02029508008029,0
Bihar,Buxar,Chakki,41,0,1,hab,1,0,3,38,40,5,1119,96,25.64844181147692,84.25337450079113,0
Bihar,Buxar,Chaugai,122,0,16,hab,16,0,114,8,106,5,1200,96,25.495819226255286,84.23441619169249,0
Bihar,Buxar,Chausa,129,0,0,hab,0,0,0,129,129,5,1206,96,25.451767285273103,83.86863617255365,0
Bihar,Buxar,Dumraon,305,2,14,hab,14,0,66,239,291,5,1703,96,25.526376992805673,84.15582148191169,0
Bihar,Buxar,Itarhi,365,6,1,hab,1,0,10,355,364,5,2320,96,25.44214875678643,84.02139070693818,0
Bihar,Buxar,Kesath,41,0,1,hab,1,0,4,37,40,5,2891,96,25.422295128272815,84.24372313941817,0
Bihar,Buxar,Nawanagar,238,1,4,hab,4,0,15,223,234,5,4252,96,25.410237949593796,84.21191489799044,0
Bihar,Buxar,Rajpur,325,2,6,hab,6,0,14,311,319,5,4997,96,25.348464892538434,83.9433157992837,0
Bihar,Buxar,Simri,196,0,0,hab,0,0,0,196,196,5,5643,96,25.652534290349525,84.14893682623317,0
Bihar,Chapra(Saran),Amnaur,399,8,2,hab,2,0,17,382,397,5,155,107,25.92570237734165,84.91583300464082,0
Bihar,Chapra(Saran),Baniapur,365,0,1,hab,1,0,5,360,364,5,513,107,26.00116434063497,84.70035495936457,0
Bihar,Chapra(Saran),Dariyapur,253,0,2,hab,2,0,7,246,251,5,1450,107,25.822393109735664,85.04915922469354,0
Bihar,Chapra(Saran),Dighwara,111,1,0,hab,0,0,0,111,111,5,1631,107,25.739434683936516,84.99626579461457,0
Bihar,Chapra(Saran),Ekma,227,2,2,hab,2,0,18,209,225,5,1732,107,25.99361740857441,84.52817181429984,0
Bihar,Chapra(Saran),Garkha,396,12,1,hab,1,0,13,383,395,5,1882,107,25.806090603176077,84.8726257341149,0
Bihar,Chapra(Saran),Isuapur,276,26,1,hab,1,0,17,259,275,5,2317,107,26.03187694547619,84.81836428891033,0
Bihar,Chapra(Saran),Jalalpur,105,0,1,hab,1,0,4,101,104,5,2386,107,25.889470147628657,84.67020642644071,0
Bihar,Chapra(Saran),Lahiadpur,110,3,1,hab,1,0,13,97,109,5,3328,107,26.043813612414233,84.62408121146376,0
Bihar,Chapra(Saran),Maker,56,0,0,hab,0,0,0,56,56,5,3572,107,25.964284120067894,85.01897290228794,0
Bihar,Chapra(Saran),Manjhi,303,0,1,hab,1,0,11,292,302,5,3690,107,25.90573227272291,84.54322549172576,0
Bihar,Chapra(Saran),Marhaura,343,1,0,hab,0,0,0,343,343,5,3729,107,25.937518844117267,84.82270036640311,0
Bihar,Chapra(Saran),Mashrakh,303,5,0,hab,0,0,0,303,303,5,3752,107,26.12197067128296,84.77561213036688,0
Bihar,Chapra(Saran),Nagra,92,1,1,hab,1,0,6,86,91,5,4078,107,25.879812108863423,84.76327549063001,0
Bihar,Chapra(Saran),Panapur,194,1,1,hab,1,0,9,185,193,5,4496,107,26.14721025348932,84.87076049099369,0
Bihar,Chapra(Saran),Parsa,163,1,1,hab,1,0,9,154,162,5,4573,107,25.897171718078834,85.01984523775958,0
Bihar,Chapra(Saran),Rivilganj,130,3,0,hab,0,0,0,130,130,5,5173,107,25.777129856159892,84.66394891613471,0
Bihar,Chapra(Saran),Sadar Chapra,167,3,2,hab,2,0,12,155,165,5,5231,107,25.765111090304384,84.7847014726696,0
Bihar,Chapra(Saran),Sonpur,196,0,0,hab,0,0,0,196,196,5,5739,107,25.703251591838082,85.13988539387496,0
Bihar,Chapra(Saran),Taraiya,240,42,0,hab,0,0,0,240,240,5,5916,107,26.0423659569309,84.89937004351684,0
Bihar,Darbhanga,Alinagar,86,1,1,hab,1,0,7,79,85,5,87,132,26.08374039333339,86.22403342015502,0
Bihar,Darbhanga,Bahadurpur,167,7,2,hab,2,0,12,155,165,5,400,132,26.10896925795173,85.94405791088829,0
Bihar,Darbhanga,Baheri,204,0,15,hab,15,0,61,143,189,5,407,132,25.995556173242797,86.03648960095568,0
Bihar,Darbhanga,Benipur,119,0,7,hab,5,2,13,106,112,5,721,132,26.079378074532737,86.12161498760547,0
Bihar,Darbhanga,Biraul,243,9,3,hab,3,0,26,217,240,5,964,132,25.942014461624474,86.18696102089841,0
Bihar,Darbhanga,Darbhanga,219,5,15,hab,15,0,57,162,204,5,1446,132,26.18364490484683,85.95684285258388,0
Bihar,Darbhanga,Gaura Bauram,81,1,1,hab,0,1,0,81,80,5,1894,132,25.961908984759887,86.29617172025779,0
Bihar,Darbhanga,Ghanshyampur,75,0,1,hab,1,0,4,71,74,5,1916,132,26.055369431052366,86.2967185648133,0
Bihar,Darbhanga,Hanuman Nagar,114,1,3,hab,3,0,17,97,111,5,2128,132,26.08434416926087,85.80889853673001,0
Bihar,Darbhanga,Hayaghat,103,0,9,hab,9,0,38,65,94,5,2200,132,26.036724440902066,85.91551817514498,0
Bihar,Darbhanga,Jale,198,4,13,hab,13,0,40,158,185,5,2393,132,26.353844328635603,85.7619673857874,0
Bihar,Darbhanga,Keoti,246,0,8,hab,8,0,37,209,238,5,2885,132,26.255399405769474,85.91890997699711,0
Bihar,Darbhanga,Kiratpur,51,2,1,hab,1,0,4,47,50,5,3043,132,25.98956016304719,86.36566982051845,0
Bihar,Darbhanga,Ksheshwar Sthan,189,1,3,hab,3,0,15,174,186,5,3212,132,25.834390078795575,86.27055958207443,0
Bihar,Darbhanga,Kusheshwar Sthan East,109,4,1,hab,1,0,12,97,108,5,3302,132,25.787751058870043,86.35328706128506,0
Bihar,Darbhanga,Manigachhi,129,2,3,hab,3,0,11,118,126,5,3675,132,26.181652660329892,86.14793682325188,0
Bihar,Darbhanga,Singwara,175,0,7,hab,7,0,29,146,168,5,5661,132,26.208280174587877,85.76913592633758,0
Bihar,Darbhanga,Tard Dih,69,1,2,hab,2,0,6,63,67,5,5923,132,26.153204931862707,86.25433349968499,0
Bihar,East Champaran,Adapur,89,1,16,hab,14,2,21,68,73,5,17,165,26.903821855263296,84.92209583976968,0
Bihar,East Champaran,Areraj,163,0,2,hab,1,1,4,159,161,5,234,165,26.527161525516043,84.598423656326,0
Bihar,East Champaran,Banjaria,166,4,1,hab,1,0,3,163,165,5,518,165,26.73142800691302,84.87242796889372,0
Bihar,East Champaran,Bankatwa,40,0,1,hab,1,0,1,39,39,5,523,165,26.810814905511734,85.06274806255155,0
Bihar,East Champaran,Chakia or Pipra,252,2,0,hab,0,0,0,252,252,5,1117,165,26.477836033662783,84.99360310207123,0
Bihar,East Champaran,Chiraiya,99,0,1,hab,1,0,1,98,98,5,1317,165,26.684600211089478,85.0771185400119,0
Bihar,East Champaran,Dhaka,72,1,8,hab,7,1,6,66,64,5,1540,165,26.69896418140368,85.20094706766605,0
Bihar,East Champaran,Ghorasahan,50,0,24,hab,22,2,16,34,26,5,1944,165,26.8050992020594,85.13246251183722,0
Bihar,East Champaran,Harsidhhi,287,0,1,hab,1,0,4,283,286,5,2167,165,26.615079982579093,84.72194796395024,0
Bihar,East Champaran,Kalyanpur,391,3,1,hab,1,0,9,382,390,5,2663,165,26.395479915997328,84.94879713893933,0
Bihar,East Champaran,Kesaria,166,3,0,hab,0,0,0,166,166,5,2890,165,26.357462943806016,84.82756598818939,0
Bihar,East Champaran,Kotwa,163,1,1,hab,1,0,5,158,162,5,3185,165,26.504630608211034,84.83236222515927,0
Bihar,East Champaran,Madhuban,235,5,1,hab,1,0,13,222,234,5,3485,165,26.445829455792566,85.12363721365958,0
Bihar,East Champaran,Mehsi,276,3,1,hab,1,0,19,257,275,5,3823,165,26.342879752525,85.15805904486099,0
Bihar,East Champaran,Motihari,246,6,0,hab,0,0,0,246,246,5,3939,165,26.65897390602258,84.9651135872671,0
Bihar,East Champaran,Narkatia  or  Chhauradano,86,0,4,hab,4,0,5,81,82,5,4188,165,26.823113330652586,84.96583541876441,0
Bihar,East Champaran,Paharpur,198,1,1,hab,1,0,5,193,197,5,4426,165,26.628691424156255,84.6059002048778,0
Bihar,East Champaran,Pakri Dayal,64,0,0,hab,0,0,0,64,64,5,4438,165,26.549469477138896,85.08680513270151,0
Bihar,East Champaran,Patahi,71,1,0,hab,0,0,0,71,71,5,4589,165,26.585265353888857,85.18860667531663,0
Bihar,East Champaran,Phenhara,33,0,1,hab,1,0,3,30,32,5,4732,165,26.513377501183786,85.17884699888626,0
Bihar,East Champaran,Pipra Kothi,84,0,1,hab,1,0,13,71,83,5,4766,165,26.560981918360184,84.94048851720919,0
Bihar,East Champaran,Ramgarhwa,125,0,8,hab,7,1,20,105,117,5,5042,165,26.876599933993752,84.78448207575866,0
Bihar,East Champaran,Raxaul,147,2,3,hab,3,0,14,133,144,5,5131,165,26.960497319055055,84.79056294418915,0
Bihar,East Champaran,Sangrampur,82,0,1,hab,1,0,4,78,81,5,5362,165,26.467209235688003,84.72957996782984,0
Bihar,East Champaran,Sugauli,191,2,6,hab,6,0,17,174,185,5,5781,165,26.756997197016524,84.77414646837424,0
Bihar,East Champaran,Tetaria,123,0,1,hab,1,0,7,116,122,5,5963,165,26.389595218386116,85.21030308800863,0
Bihar,East Champaran,Turkaulia,176,3,1,hab,1,0,5,171,175,5,6158,165,26.62429790972131,84.83181917053544,0
Bihar,Gaya,Amas,185,8,42,hab,42,0,52,133,143,5,120,192,24.602037126456324,84.69651003962134,0
Bihar,Gaya,Atri,108,2,15,hab,15,0,29,79,93,5,301,192,24.910871125838074,85.1945553310091,0
Bihar,Gaya,Banke Bazar,193,0,6,hab,6,0,14,179,187,5,524,192,24.529264893910426,84.65686016730736,0
Bihar,Gaya,Barachatti,196,5,3,hab,3,0,17,179,193,5,555,192,24.453229947054933,85.02516582229549,0
Bihar,Gaya,Bathani,88,2,2,hab,2,0,15,73,86,5,663,192,24.981940807712338,85.25960584453554,0
Bihar,Gaya,Belaganj,213,2,22,hab,22,0,39,174,191,5,696,192,24.9692806455184,84.98072339401276,0
Bihar,Gaya,Bodh Gaya,252,5,19,hab,19,0,31,221,233,5,1000,192,24.681228333287432,84.97075757676254,0
Bihar,Gaya,Dobhi,128,1,37,hab,29,8,8,120,91,5,1650,192,24.51597685842517,84.90467704952684,0
Bihar,Gaya,Dumaria,318,0,1,hab,1,0,9,309,317,5,1695,192,24.454160474843512,84.41657321785186,0
Bihar,Gaya,Fatehpur,276,4,3,hab,3,0,3,273,273,5,1772,192,24.60759845773009,85.25794974625634,0
Bihar,Gaya,Gaya sadar,202,3,7,hab,7,0,12,190,195,5,4061,192,24.818677598483365,84.97277910859248,0
Bihar,Gaya,Guraru,168,3,39,hab,39,0,69,99,129,5,2077,192,24.771433369105495,84.77486624301886,0
Bihar,Gaya,Gurua,275,1,37,hab,37,0,64,211,238,5,2086,192,24.655568966918636,84.75934948449833,0
Bihar,Gaya,Imamganj,295,1,3,hab,3,0,12,283,292,5,2286,192,24.425921333905983,84.55717667247417,0
Bihar,Gaya,Khijasarai,146,1,8,hab,8,0,17,129,138,5,3004,192,24.975804474242835,85.1302799324291,0
Bihar,Gaya,Konch,208,2,6,hab,6,0,8,200,202,5,3110,192,24.9207987010023,84.75519809318888,0
Bihar,Gaya,Manpur,174,4,12,hab,12,0,17,157,162,5,3703,192,24.81178471301546,85.06285881148925,0
Bihar,Gaya,Mohanpur,309,4,3,hab,3,0,7,302,306,5,3891,192,24.555805601030826,85.09754180934738,0
Bihar,Gaya,Mohra,122,2,3,hab,3,0,5,117,119,5,3901,192,24.904795111665152,85.30167813994467,0
Bihar,Gaya,Paraiya,148,1,23,hab,23,0,45,103,125,5,4541,192,24.790538081666273,84.87120865782838,0
Bihar,Gaya,Sherghati,124,1,83,hab,76,7,73,51,41,5,5559,192,24.57586284530341,84.82825174317463,0
Bihar,Gaya,Tankuppa,105,0,1,hab,0,1,0,105,104,5,5905,192,24.68915712753534,85.13928428707011,0
Bihar,Gaya,Tekari,264,2,1,hab,1,0,2,262,263,5,5942,192,24.961556880685595,84.85731338814442,0
Bihar,Gaya,Wazirganj ,273,3,0,hab,0,0,0,273,273,5,6434,192,24.793399999303094,85.2038665195899,0
Bihar,Gopalganj,Baikunthpur,421,4,1,hab,1,0,8,413,420,5,416,201,26.269348907213885,84.77211722103084,0
Bihar,Gopalganj,Barauli,537,4,2,hab,2,0,37,500,535,5,573,201,26.391716680980934,84.59470935885913,0
Bihar,Gopalganj,Bhore,472,2,1,hab,1,0,15,457,471,5,885,201,26.445730099716958,84.12213046109098,0
Bihar,Gopalganj,Gopalganj,284,3,0,hab,0,0,0,284,284,5,2004,201,26.533306809516674,84.45714944535011,0
Bihar,Gopalganj,Hathwa,440,0,1,hab,1,0,32,408,439,5,2191,201,26.36283385479156,84.27433763157067,0
Bihar,Gopalganj,Kataiya,243,1,1,hab,1,0,2,241,242,5,2822,201,26.554566531823323,84.0888086931375,0
Bihar,Gopalganj,Kuchaikot,976,13,1,hab,1,0,23,953,975,5,3217,201,26.55731110275321,84.30741568628228,0
Bihar,Gopalganj,Manjha,338,10,2,hab,2,0,33,305,336,5,3685,201,26.41453442873948,84.4945061810853,0
Bihar,Gopalganj,Panchdewari,184,1,1,hab,1,0,9,175,183,5,4498,201,26.5585092515676,84.17240491680413,0
Bihar,Gopalganj,Phulwaria,274,2,1,hab,1,0,8,266,273,5,4744,201,26.45040362145095,84.224899498926,0
Bihar,Gopalganj,Sidhwalia,241,3,1,hab,1,0,9,232,240,5,5610,201,26.354626534753127,84.67991830873841,0
Bihar,Gopalganj,Thawe,171,1,1,hab,1,0,23,148,170,5,6003,201,26.418196657589785,84.39602680417632,0
Bihar,Gopalganj,Uchkagaon,290,3,2,hab,2,0,12,278,288,5,6166,201,26.442533412437392,84.32592660654956,0
Bihar,Gopalganj,Vijaypur,379,6,1,hab,1,0,14,365,378,5,6361,201,26.46918214052946,83.99071115033428,0
Bihar,Jahanabad,Ghosi,101,0,4,hab,4,0,13,88,97,5,1948,235,25.14305988330358,85.10157390697343,0
Bihar,Jahanabad,Hulashganj,100,4,1,hab,1,0,5,95,99,5,2255,235,25.095132143137814,85.14115655335337,0
Bihar,Jahanabad,Jahanabad,166,2,1,hab,0,1,0,166,165,5,2350,235,25.223828883605403,84.95758987889029,0
Bihar,Jahanabad,Kako,193,4,1,hab,1,0,8,185,192,5,2595,235,25.208969435013678,85.04598300327002,0
Bihar,Jahanabad,Makhdumpur,256,3,4,hab,4,0,4,252,252,5,3573,235,25.072563177898555,84.99231142664813,0
Bihar,Jahanabad,Modanganj,100,2,1,hab,1,0,4,96,99,5,3874,235,25.256552905008782,85.13902543278138,0
Bihar,Jahanabad,Ratni Faridpur,180,1,27,hab,26,1,31,149,153,5,5121,235,25.160410564547597,84.87791996460547,0
Bihar,Jamui,Aliganj,84,0,2,hab,1,1,5,79,82,5,86,249,24.94085289411961,85.91715028462522,0
Bihar,Jamui,Barhat,139,1,1,hab,1,0,4,135,138,5,596,249,25.032091553891323,86.31616953067184,0
Bihar,Jamui,Chakai,904,8,5,hab,5,0,30,874,899,5,1111,249,24.563304487685876,86.40769099506996,0
Bihar,Jamui,Gidhaur,88,2,0,hab,0,0,0,88,88,5,1953,249,24.874464855879467,86.31647982897555,0
Bihar,Jamui,Jamui,79,1,2,hab,2,0,3,76,77,5,2431,249,24.955908113176363,86.19015431142788,0
Bihar,Jamui,Jhajha,519,5,0,hab,0,0,0,519,519,5,2487,249,24.792334678914557,86.4487873581754,0
Bihar,Jamui,Khaira,201,1,5,hab,5,0,11,190,196,5,2914,249,24.81887334337184,86.15186168557854,0
Bihar,Jamui,Laxmipur,207,0,0,hab,0,0,0,207,207,5,3399,249,24.965324530654314,86.4077325070892,0
Bihar,Jamui,Sikandra,98,3,1,hab,1,0,3,95,97,5,5620,249,24.926353614017355,86.05681630820592,0
Bihar,Jamui,Sono,466,3,2,hab,2,0,21,445,464,5,5737,249,24.694539326035155,86.28605604948748,0
Bihar,Kaimur (Bhabhua),Adhaura,137,1,2,hab,2,0,3,134,135,5,21,263,24.721030979103737,83.61369405280745,0
Bihar,Kaimur (Bhabhua),Bhabhua,437,7,3,hab,3,0,4,433,434,5,744,263,25.07183930472628,83.63268543904903,0
Bihar,Kaimur (Bhabhua),Bhagwanpur,116,0,1,hab,1,0,3,113,115,5,768,263,24.94044632555671,83.5869131457773,0
Bihar,Kaimur (Bhabhua),Chainpur,250,4,5,hab,5,0,20,230,245,5,1108,263,24.962815877674952,83.45068294008743,0
Bihar,Kaimur (Bhabhua),Chand,315,3,9,hab,9,0,23,292,306,5,1144,263,25.108430193192174,83.40309582375376,0
Bihar,Kaimur (Bhabhua),Durgawati,190,3,11,hab,11,0,24,166,179,5,1715,263,25.227845436888707,83.49582508412954,0
Bihar,Kaimur (Bhabhua),Kudra,279,0,6,hab,5,1,22,257,273,5,3223,263,25.111382364399603,83.78053092615254,0
Bihar,Kaimur (Bhabhua),Mohania,262,3,7,hab,7,0,16,246,255,5,3886,263,25.20267790513485,83.66999553556762,0
Bihar,Kaimur (Bhabhua),Nuawan,128,4,2,hab,2,0,10,118,126,5,4354,263,25.333606400799685,83.77366832578292,0
Bihar,Kaimur (Bhabhua),Ramgarh,147,4,1,hab,1,0,9,138,146,5,5038,263,25.295167974326926,83.66904678893962,0
Bihar,Kaimur (Bhabhua),Rampur,145,4,1,hab,1,0,5,140,144,5,5060,263,24.91144279773268,83.72313161087928,0
Bihar,Katihar,Ajamnagar,189,2,65,hab,63,2,75,114,124,5,47,285,25.54672852243016,87.83344455795441,0
Bihar,Katihar,Amdabad,78,2,0,hab,0,0,0,78,78,5,142,285,25.31288491888061,87.76286775526276,0
Bihar,Katihar,Balrampur,125,1,44,hab,41,3,43,82,81,5,477,285,25.78008359626292,87.89291768113318,0
Bihar,Katihar,Barari,183,0,1,hab,1,0,6,177,182,5,570,285,25.46244543178109,87.44167431629762,0
Bihar,Katihar,Barsoi,208,6,25,hab,25,0,37,171,183,5,623,285,25.62131998815116,87.97337516548693,0
Bihar,Katihar,Dandkhora,57,1,2,hab,2,0,3,54,55,5,1425,285,25.589948406348842,87.66581979343033,0
Bihar,Katihar,Falka,99,1,1,hab,1,0,3,96,98,5,1757,285,25.631637850247483,87.30658880734765,0
Bihar,Katihar,Hasanganj,50,1,1,hab,1,0,4,46,49,5,2171,285,25.65107768983475,87.60690294339096,0
Bihar,Katihar,Kadwa,213,2,15,hab,14,1,24,189,198,5,2574,285,25.67768141501703,87.77039995891685,0
Bihar,Katihar,Katihar,46,0,1,hab,1,0,1,45,45,5,2837,285,25.55552273476966,87.58419749823517,0
Bihar,Katihar,Korha,137,1,1,hab,1,0,2,135,136,5,3139,285,25.605351911357218,87.45339249670323,0
Bihar,Katihar,Kursela,25,1,1,hab,1,0,4,21,24,5,3289,285,25.431073737747617,87.27828338807707,0
Bihar,Katihar,Manihari,102,1,1,hab,1,0,1,101,101,5,3676,285,25.379394411864993,87.61887215403297,0
Bihar,Katihar,Mansahi,27,0,7,hab,7,0,7,20,20,5,3706,285,25.46696911876667,87.59303131105612,0
Bihar,Katihar,Pranpur,104,3,25,hab,24,1,32,72,79,5,4822,285,25.484548756884216,87.71198633384306,0
Bihar,Katihar,Sameli,64,0,1,hab,1,0,7,57,63,5,5324,285,25.520722589317536,87.28149971927282,0
Bihar,Khagaria,Alauli,182,2,1,hab,1,0,8,174,181,5,80,291,25.628781799094146,86.396003477677,0
Bihar,Khagaria,Beldaur,167,5,2,hab,2,0,7,160,165,5,700,291,25.571456010082848,86.76795779854557,0
Bihar,Khagaria,Chautham,109,1,4,hab,3,1,6,103,105,5,1208,291,25.555732916643322,86.64608685679714,0
Bihar,Khagaria,Gogari,148,0,2,hab,2,0,6,142,146,5,1967,291,25.44142002238067,86.69819430886672,0
Bihar,Khagaria,Khagaria,218,2,8,hab,3,5,1,217,210,5,2911,291,25.524640018812747,86.43733902926911,0
Bihar,Khagaria,Mansi,35,1,11,hab,6,5,6,29,24,5,3707,291,25.538410695711427,86.5611444604773,0
Bihar,Khagaria,Parbatta,122,0,1,hab,1,0,7,115,121,5,4558,291,25.336812487092324,86.73972416572533,0
Bihar,Kishanganj,Bahadurganj,521,3,2,hab,2,0,16,505,519,5,396,299,26.26432520336636,87.8313018214056,0
Bihar,Kishanganj,Dighalbank,310,3,1,hab,1,0,9,301,309,5,1630,299,26.388125370809334,87.84910126585058,0
Bihar,Kishanganj,Kishanganj,220,3,15,hab,15,0,44,176,205,5,3049,299,26.124632214895886,87.94329260895682,0
Bihar,Kishanganj,Koch Dhaman,598,15,1,hab,1,0,4,594,597,5,3058,299,26.161497542423508,87.81189130868022,0
Bihar,Kishanganj,Pothia,508,6,2,hab,2,0,12,496,506,5,4815,299,26.312542848948333,88.149865158364,0
Bihar,Kishanganj,Terhagachhi,334,6,1,hab,1,0,3,331,333,5,5962,299,26.34433678662351,87.69939476063222,0
Bihar,Kishanganj,Thakurganj,452,6,3,hab,3,0,6,446,449,5,5973,299,26.395011780975057,88.07948889966083,0
Bihar,Lakhisarai,Barahiya,126,4,0,hab,0,0,0,126,126,5,561,327,25.264118229986412,86.00566992796263,0
Bihar,Lakhisarai,Halsi,180,3,1,hab,1,0,5,175,179,5,2118,327,25.02946858312163,86.04757049531551,0
Bihar,Lakhisarai,Lakhisarai,468,225,2,hab,2,0,15,453,466,5,3345,327,25.0824016932968,86.19165500529338,0
Bihar,Lakhisarai,Piparia,53,2,1,hab,0,1,0,53,52,5,4761,327,25.246724632546023,86.14603674817619,0
Bihar,Lakhisarai,Ramgarh Chowk,137,1,2,hab,2,0,14,123,135,5,5041,327,25.093435083957342,86.05699548155307,0
Bihar,Lakhisarai,Suryagarha,318,2,1,hab,1,0,15,303,317,5,5825,327,25.187944512161845,86.27238054010748,0
Bihar,Madhepura,Alamnagar,183,1,1,hab,1,0,10,173,182,5,70,341,25.54650526373032,86.88280473853214,0
Bihar,Madhepura,Bihari Ganj,148,3,0,hab,0,0,0,148,148,5,917,341,25.738907116065597,86.98765202659484,0
Bihar,Madhepura,Chausa,134,5,2,hab,2,0,11,123,132,5,1207,341,25.51409397473543,87.00893716335759,0
Bihar,Madhepura,Gamharia,131,5,1,hab,1,0,10,121,130,5,1822,341,26.039477290437997,86.73676532734336,0
Bihar,Madhepura,Ghailar,64,0,2,hab,2,0,6,58,62,5,1910,341,25.962201955630125,86.67746722287686,0
Bihar,Madhepura,Gwalpara,177,4,1,hab,1,0,8,169,176,5,2092,341,25.76661147294462,86.89941938086353,0
Bihar,Madhepura,Kumarkhand,175,2,1,hab,1,0,3,172,174,5,3246,341,26.004466334679858,86.99267593457171,0
Bihar,Madhepura,Madhepura,151,1,12,hab,10,2,34,117,139,5,3481,341,25.920805742173783,86.80171226410195,0
Bihar,Madhepura,Murliganj,117,2,5,hab,4,1,10,107,112,5,4012,341,25.87130004379166,86.94487568429173,0
Bihar,Madhepura,Puraini,111,2,2,hab,2,0,9,102,109,5,4862,341,25.591126751046918,86.98211950556914,0
Bihar,Madhepura,Shankarpur,82,2,1,hab,1,0,3,79,81,5,5542,341,26.046524220958318,86.86978616981726,0
Bihar,Madhepura,Singheshwar,205,8,2,hab,2,0,19,186,203,5,5656,341,26.015756190956314,86.79862735429305,0
Bihar,Madhepura,Udakishanganj,156,1,1,hab,1,0,3,153,155,5,6172,341,25.661136679936842,86.92274179939841,0
Bihar,Madhubani,Andhrartharhi,134,0,2,hab,2,0,7,127,132,5,186,342,26.36221665466153,86.30193729773293,0
Bihar,Madhubani,Babu Barhi,105,1,2,hab,2,0,5,100,103,5,344,342,26.46089025212624,86.30498807846381,0
Bihar,Madhubani,Basopatti,91,2,2,hab,2,0,7,84,89,5,650,342,26.570525829108934,86.03175443781187,0
Bihar,Madhubani,Benipatti,128,1,15,hab,14,1,10,118,113,5,720,342,26.445405447512936,85.91241617881214,0
Bihar,Madhubani,Bisfi,142,2,1,hab,1,0,6,136,141,5,978,342,26.346800366096808,85.90218483074455,0
Bihar,Madhubani,Ghoghardiha,144,1,2,hab,2,0,5,139,142,5,1943,342,26.290248312745426,86.46639409626573,0
Bihar,Madhubani,Harlakhi,113,1,5,hab,4,1,13,100,108,5,2157,342,26.580138833238053,85.95063523705088,0
Bihar,Madhubani,Jainagar,88,0,3,hab,3,0,7,81,85,5,2355,342,26.57882809660765,86.13591576760923,0
Bihar,Madhubani,Jhanjharpur,163,3,1,hab,1,0,5,158,162,5,2495,342,26.28360205564649,86.26767705021129,0
Bihar,Madhubani,Kaluahi,94,2,3,hab,3,0,4,90,91,5,2657,342,26.474536143886493,86.07644952566781,0
Bihar,Madhubani,Khajauli,108,6,1,hab,1,0,8,100,107,5,2923,342,26.490268654104003,86.16816018191325,0
Bihar,Madhubani,Khutauna,120,1,1,hab,1,0,2,118,119,5,3030,342,26.500524448883233,86.46034134672504,0
Bihar,Madhubani,Ladania,114,0,1,hab,1,0,3,111,113,5,3321,342,26.560579905072345,86.30422358657212,0
Bihar,Madhubani,Lakhnaur,128,4,2,hab,2,0,8,120,126,5,3347,342,26.222522396289936,86.32034703419977,0
Bihar,Madhubani,Laukahi,130,0,5,hab,5,0,13,117,125,5,3391,342,26.412626370451676,86.60618287410347,0
Bihar,Madhubani,Madhepur,236,4,13,hab,13,0,69,167,223,5,3480,342,26.141793242652568,86.40751730164821,0
Bihar,Madhubani,Madhwapur,70,0,4,hab,4,0,14,56,66,5,3490,342,26.525264032125392,85.83789933816041,0
Bihar,Madhubani,Pandaul,110,6,2,hab,2,0,7,103,108,5,4508,342,26.266948846033603,86.122475511716,0
Bihar,Madhubani,Phulparas,103,3,1,hab,1,0,4,99,102,5,4743,342,26.37971712776098,86.44836624058533,0
Bihar,Madhubani,Rahika,108,3,8,hab,8,0,21,87,100,5,4927,342,26.33315588385401,86.03232909916288,0
Bihar,Madhubani,Rajnagar,119,4,4,hab,4,0,10,109,115,5,4991,342,26.382158791858018,86.15661044628838,0
Bihar,Munger,Asharganj,79,2,0,hab,0,0,0,79,79,5,257,373,25.1754612075349,86.66662622180618,0
Bihar,Munger,Bariarpur,77,1,1,hab,1,0,11,66,76,5,603,373,25.296286337142206,86.6156849723019,0
Bihar,Munger,Dharhara,206,1,2,hab,2,0,25,181,204,5,1580,373,25.224932210003022,86.4468046523497,0
Bihar,Munger,Jamalpur,91,2,0,hab,0,0,0,91,91,5,2410,373,25.322979896197293,86.47577186403785,0
Bihar,Munger,Kharagpur,195,1,0,hab,0,0,0,195,195,5,2965,373,25.11883726572559,86.51534062103548,0
Bihar,Munger,Munger Sadar,115,4,0,hab,0,0,0,115,115,5,3996,373,25.378190736340077,86.48478836087118,0
Bihar,Munger,Sangrampur,128,0,1,hab,1,0,11,117,127,5,5360,373,24.9994201124429,86.60134317090066,0
Bihar,Munger,Tarapur,131,0,1,hab,1,0,13,118,130,5,5920,373,25.105365696946667,86.64228083954303,0
Bihar,Munger,Tetia Bamber,94,2,1,hab,1,0,4,90,93,5,5964,373,25.052297721467426,86.56565520344213,0
Bihar,Muzaffarpur,Aurai,113,3,2,hab,2,0,4,109,111,5,312,376,26.30975112580205,85.54318706238175,0
Bihar,Muzaffarpur,Bandra,86,0,1,hab,1,0,2,84,85,5,500,376,26.052452196186064,85.61965086399618,0
Bihar,Muzaffarpur,Bochaha,165,3,1,hab,1,0,12,153,164,5,998,376,26.179650500835116,85.49015417287838,0
Bihar,Muzaffarpur,Gaighat,191,1,1,hab,1,0,3,188,190,5,1805,376,26.13685693564812,85.64213050868203,0
Bihar,Muzaffarpur,Kanti,123,2,8,hab,7,1,9,114,115,5,2739,376,26.185044583813482,85.2852981682034,0
Bihar,Muzaffarpur,Katra,101,4,2,hab,2,0,5,96,99,5,2844,376,26.24127667954113,85.63510609099647,0
Bihar,Muzaffarpur,Kurhani,173,0,0,hab,0,0,0,173,173,5,3282,376,26.015055344673762,85.3672013204467,0
Bihar,Muzaffarpur,Marwan,88,0,1,hab,1,0,4,84,87,5,3746,376,26.11411872716753,85.24860754192592,0
Bihar,Muzaffarpur,Minapur,172,0,1,hab,1,0,1,171,171,5,3860,376,26.279132801886416,85.3280272695993,0
Bihar,Muzaffarpur,Motipur,426,6,1,hab,1,0,5,421,425,5,3940,376,26.250689869097364,85.11928521690749,0
Bihar,Muzaffarpur,Muraul,39,1,1,hab,1,0,1,38,38,5,4006,376,26.01780343030074,85.56094635997044,0
Bihar,Muzaffarpur,Mushahari,128,4,0,hab,0,0,0,128,128,5,4018,376,26.11310515546701,85.42504019958187,0
Bihar,Muzaffarpur,Paru,139,0,2,hab,2,0,5,134,137,5,4580,376,26.108473555309995,85.01920008828884,0
Bihar,Muzaffarpur,Sahebganj,184,1,1,hab,1,0,2,182,183,5,5258,376,26.26100159672424,84.95522080545506,0
Bihar,Muzaffarpur,Sakra,191,0,1,hab,1,0,5,186,190,5,5290,376,25.962846583315557,85.52800829583889,0
Bihar,Muzaffarpur,Saraiya,150,2,1,hab,1,0,4,146,149,5,5400,376,26.054103302358218,85.14887493119375,0
Bihar,Nalanda,Asthawan,133,0,1,hab,1,0,4,129,132,5,276,384,25.203986663963597,85.65767585726466,0
Bihar,Nalanda,Ben,99,1,17,hab,17,0,18,81,82,5,717,384,25.147061032407574,85.37197775276424,0
Bihar,Nalanda,Bihar Sharif,153,3,2,hab,2,0,7,146,151,5,916,384,25.166966895795237,85.54872567499922,0
Bihar,Nalanda,Bind,53,6,1,hab,1,0,2,51,52,5,956,384,25.30439820527885,85.68205271632422,0
Bihar,Nalanda,Chandi,145,1,4,hab,4,0,14,131,141,5,1155,384,25.34046589109912,85.43718784623061,0
Bihar,Nalanda,Ekangarsarai,211,4,1,hab,1,0,1,210,210,5,1730,384,25.223285656611,85.22851660064602,0
Bihar,Nalanda,Giriak,72,2,0,hab,0,0,0,72,72,5,1957,384,25.05701379964326,85.54109827823919,0
Bihar,Nalanda,Harnaut,132,4,15,hab,15,0,36,96,117,5,2158,384,25.383489868730813,85.52545557541656,0
Bihar,Nalanda,Hilsa,153,3,0,hab,0,0,0,153,153,5,2212,384,25.305020019172307,85.26565314213755,0
Bihar,Nalanda,Islampur,156,2,1,hab,1,0,5,151,155,5,2314,384,25.111762428578803,85.24936275435658,0
Bihar,Nalanda,Karai Parsurai,85,3,0,hab,0,0,0,85,85,5,2753,384,25.37667297974962,85.23324924654504,0
Bihar,Nalanda,Katri Sarai,41,2,1,hab,1,0,3,38,40,5,2848,384,25.070229911707823,85.60826391200675,0
Bihar,Nalanda,Nagarnausa,101,0,0,hab,0,0,0,101,101,5,4067,384,25.380755751832904,85.34967092206614,0
Bihar,Nalanda,Noorsarai,177,5,39,hab,39,0,76,101,138,5,4341,384,25.234303962977734,85.45405053168494,0
Bihar,Nalanda,Parwalpur,76,3,1,hab,1,0,4,72,75,5,4583,384,25.22105376549707,85.34048056800256,0
Bihar,Nalanda,Rahui,131,4,1,hab,1,0,5,126,130,5,4929,384,25.279280491067745,85.56408237304514,0
Bihar,Nalanda,Rajgir,90,5,20,hab,18,2,20,70,70,5,4982,384,25.033611521031304,85.38109240147209,0
Bihar,Nalanda,Sarmera,72,5,2,hab,2,0,6,66,70,5,5416,384,25.27107772046082,85.8038854074414,0
Bihar,Nalanda,Silaw,92,0,43,hab,41,2,46,46,49,5,5629,384,25.090017390083627,85.46497627723144,0
Bihar,Nalanda,Tharthari,88,3,1,hab,1,0,4,84,87,5,5998,384,25.285586280952096,85.37505009175601,0
Bihar,Nawada,Akbarpur,297,1,1,hab,1,0,4,293,296,5,55,395,24.788181473826143,85.54338805343043,0
Bihar,Nawada,Govindpur,101,0,1,hab,1,0,3,98,100,5,2030,395,24.751882372200928,85.65267924735278,0
Bihar,Nawada,Hisua,116,4,0,hab,0,0,0,116,116,5,2232,395,24.85239564518527,85.39404061959394,0
Bihar,Nawada,Kashichak,54,1,1,hab,1,0,5,49,53,5,2808,395,25.063850995486746,85.72196663374027,0
Bihar,Nawada,Kauakol,141,0,4,hab,3,1,5,136,137,5,2857,395,24.827143267309335,85.9004929872522,0
Bihar,Nawada,Meskaur,171,9,1,hab,1,0,7,164,170,5,3846,395,24.763360541104472,85.34994471706536,0
Bihar,Nawada,Nardiganj,124,4,0,hab,0,0,0,124,124,5,4181,395,24.939441710875084,85.43422246232414,0
Bihar,Nawada,Narhat,92,0,2,hab,2,0,6,86,90,5,4185,395,24.79213880240486,85.4391584594289,0
Bihar,Nawada,Nawada,209,4,0,hab,0,0,0,209,209,5,4247,395,24.926510425865537,85.54208134545055,0
Bihar,Nawada,Pakri Barwan,137,0,0,hab,0,0,0,137,137,5,4437,395,24.9450566388355,85.75440845993255,0
Bihar,Nawada,Rajauli,217,2,10,hab,7,3,40,177,207,5,4971,395,24.625334509847164,85.53588606402515,0
Bihar,Nawada,Roh,131,0,1,hab,1,0,2,129,130,5,5178,395,24.856893037085477,85.67819107538979,0
Bihar,Nawada,Sirdala,253,1,1,hab,1,0,6,247,252,5,5669,395,24.64705965492714,85.38740829395093,0
Bihar,Nawada,Warsalliganj,126,2,0,hab,0,0,0,126,126,5,6424,395,25.002217004600602,85.63401058052746,0
Bihar,Patna,Athmalgola,62,1,2,hab,1,1,9,53,60,5,286,424,25.451567213552693,85.5975633461801,0
Bihar,Patna,Bakhtiarpur,162,7,1,hab,1,0,4,158,161,5,432,424,25.46873075273968,85.50438964914146,0
Bihar,Patna,Barh,145,7,0,hab,0,0,0,145,145,5,590,424,25.443376740482517,85.70239780316237,0
Bihar,Patna,Belchhi,77,5,1,hab,1,0,2,75,76,5,697,424,25.368761970049878,85.67444211751027,0
Bihar,Patna,Bihta,184,4,3,hab,3,0,13,171,181,5,922,424,25.560917867658148,84.8648239647044,0
Bihar,Patna,Bikram,122,2,1,hab,1,0,4,118,121,5,936,424,25.449166913548,84.84452726451228,0
Bihar,Patna,Danapur,75,5,1,hab,1,0,1,74,74,5,1421,424,25.646352693507882,85.03428441484957,0
Bihar,Patna,Daniyawan,50,0,1,hab,1,0,3,47,49,5,1428,424,25.430756671907673,85.28922175298939,0
Bihar,Patna,Dhanarua,165,4,2,hab,2,0,5,160,163,5,1552,424,25.364812185675156,85.12002689899707,0
Bihar,Patna,Dulhin Bazar,90,1,2,hab,2,0,14,76,88,5,1692,424,25.37278127158313,84.84991537713628,0
Bihar,Patna,Fatuhan,99,1,0,hab,0,0,0,99,99,5,1779,424,25.478727835410712,85.2512510762987,0
Bihar,Patna,Fulwari,144,3,0,hab,0,0,0,144,144,5,1789,424,25.541632247332725,85.06101553865338,0
Bihar,Patna,Ghoswari,34,1,1,hab,1,0,3,31,33,5,1949,424,25.33775496031357,85.87094761542782,0
Bihar,Patna,Khushrupur,43,0,0,hab,0,0,0,43,43,5,3028,424,25.462759694683125,85.36462260433031,0
Bihar,Patna,Maner,70,2,0,hab,0,0,0,70,70,5,3660,424,25.659910939878618,84.91998486257833,0
Bihar,Patna,Masaurhi,135,5,0,hab,0,0,0,135,135,5,3750,424,25.351815026857256,84.99518428850959,0
Bihar,Patna,Mokama,46,1,0,hab,0,0,0,46,46,5,3905,424,25.392745105952176,85.93254573315114,0
Bihar,Patna,Naubatpur,203,3,1,hab,1,0,9,194,202,5,4226,424,25.48504044972478,84.95281649148484,0
Bihar,Patna,Paliganj,185,2,3,hab,3,0,15,170,182,5,4467,424,25.2945697302762,84.80448627743588,0
Bihar,Patna,Pandarak,163,0,1,hab,1,0,13,150,162,5,4505,424,25.43893464635222,85.7851689810338,0
Bihar,Patna,Patna Sadar,60,3,0,hab,0,0,0,60,60,5,4624,424,25.590953121511227,85.16637435459057,0
Bihar,Patna,Punpun,143,4,2,hab,2,0,12,131,141,5,4859,424,25.46336594983609,85.09806582588217,0
Bihar,Patna,Sampatchak,85,0,0,hab,0,0,0,85,85,5,5326,424,25.533965700907103,85.16220855606876,0
Bihar,Purnia,Amaur,405,7,2,hab,2,0,13,392,403,5,122,442,25.972553405163485,87.68948425769888,0
Bihar,Purnia,Baisa,236,2,2,hab,1,1,5,231,234,5,421,442,26.04739140063594,87.77407514931518,0
Bihar,Purnia,Baisi,180,4,3,hab,3,0,9,171,177,5,422,442,25.84529410906842,87.75953651550095,0
Bihar,Purnia,Banmankhi,410,2,1,hab,1,0,2,408,409,5,533,442,25.902703335707002,87.16272957488557,0
Bihar,Purnia,Barhara Kothi,191,1,1,hab,1,0,7,184,190,5,594,442,25.768824974081696,87.08915450981021,0
Bihar,Purnia,Bhawanipur,150,4,2,hab,2,0,28,122,148,5,834,442,25.620903769971356,87.13012576264202,0
Bihar,Purnia,Dagarua,232,7,1,hab,1,0,5,227,231,5,1396,442,25.802064165896887,87.64732893681844,0
Bihar,Purnia,Dhamdaha,300,1,2,hab,2,0,16,284,298,5,1545,442,25.744432610012996,87.22768319743889,0
Bihar,Purnia,Jalalgarh,170,4,2,hab,2,0,9,161,168,5,2383,442,25.952284783888516,87.52012271089262,0
Bihar,Purnia,Kasba,225,6,18,hab,16,2,55,170,207,5,2805,442,25.8803314607496,87.53541888137116,0
Bihar,Purnia,Kritya Nand Nagar,539,6,2,hab,2,0,18,521,537,5,3208,442,25.797951678525042,87.3812595893112,0
Bihar,Purnia,Purnia East,341,7,0,hab,0,0,0,341,341,5,4873,442,25.73646628627423,87.52890556249812,0
Bihar,Purnia,Rupauli,263,6,1,hab,1,0,4,259,262,5,5213,442,25.523302933421846,87.15477687563535,0
Bihar,Purnia,Sri Nagar,328,5,1,hab,1,0,10,318,327,5,5758,442,25.914810774366455,87.39804354533631,0
Bihar,Rohtas,Akhorhi Gola,55,0,12,hab,11,1,12,43,43,5,58,467,25.000885709632453,84.19486589981341,0
Bihar,Rohtas,Bikramganj,82,0,0,hab,0,0,0,82,82,5,937,467,25.22048700224121,84.24881886719709,0
Bihar,Rohtas,Chenari,113,0,5,hab,5,0,9,104,108,5,1227,467,24.8804319919445,83.81074018899841,0
Bihar,Rohtas,Dawath,64,0,1,hab,1,0,1,63,63,5,1472,467,25.324301154266628,84.23198672601131,0
Bihar,Rohtas,Dehri,58,0,49,hab,45,4,44,14,9,5,1488,467,24.921216599922317,84.17727480729323,0
Bihar,Rohtas,Dinara,179,0,2,hab,2,0,2,177,177,5,1638,467,25.25527148121267,84.09791624323576,0
Bihar,Rohtas,Karakat,97,4,1,hab,0,1,0,97,96,5,2754,467,25.14631704292298,84.32999205396084,0
Bihar,Rohtas,Kargahar,199,0,3,hab,3,0,6,193,196,5,2774,467,25.10526295763296,83.93231141359942,0
Bihar,Rohtas,Kchas,137,3,0,hab,0,0,0,137,137,5,2873,467,25.2264601196364,83.91670733495195,0
Bihar,Rohtas,Nasri Ganj,52,0,1,hab,1,0,1,51,51,5,4215,467,25.0725333225487,84.34319565569002,0
Bihar,Rohtas,Nauhatta,64,0,7,hab,3,4,6,58,57,5,4231,467,24.597836711900563,83.77911793486632,0
Bihar,Rohtas,Nokha,80,0,1,hab,0,1,0,80,79,5,4336,467,25.08063103066319,84.0925451256549,0
Bihar,Rohtas,Rajpur,41,0,1,hab,1,0,3,38,40,5,4999,467,25.07806350414241,84.20669485950715,0
Bihar,Rohtas,Rohtas,34,0,11,hab,3,8,5,29,23,5,5185,467,24.682588166006955,83.93097581542168,0
Bihar,Rohtas,Sanjhauli,40,1,1,hab,1,0,1,39,39,5,5369,467,25.154088313668282,84.17788159975308,0
Bihar,Rohtas,Sasaram,143,1,12,hab,11,1,15,128,131,5,5429,467,24.919877413298572,84.02698491662657,0
Bihar,Rohtas,Sheo Sagar,151,1,11,hab,4,7,6,145,140,5,5554,467,24.901763515271227,83.90448152808098,0
Bihar,Rohtas,Suryapura,40,0,0,hab,0,0,0,40,40,5,5827,467,25.27724664781115,84.23590982284544,0
Bihar,Rohtas,Tilauthu,58,0,16,hab,16,0,33,25,42,5,6084,467,24.807268338274564,84.05333594109858,0
Bihar,Saharsa,Banma Itahari,84,2,2,hab,2,0,10,74,82,5,532,475,25.676280165326517,86.66409532477101,0
Bihar,Saharsa,Kahara,221,2,3,hab,3,0,29,192,218,5,2578,475,25.857886231448354,86.56532424193956,0
Bihar,Saharsa,Mahishi,371,2,1,hab,1,0,6,365,370,5,3534,475,25.8602871277994,86.42477340013643,0
Bihar,Saharsa,Nauhatta,264,0,1,hab,1,0,1,263,263,5,4232,475,25.992985240262186,86.45146321624458,0
Bihar,Saharsa,Patarghat,148,1,1,hab,1,0,6,142,147,5,4598,475,25.813053667949415,86.7982516430239,0
Bihar,Saharsa,Salkhua,145,1,1,hab,1,0,10,135,144,5,5304,475,25.66721284361035,86.54777370116705,0
Bihar,Saharsa,Satarkateya,240,0,1,hab,1,0,12,228,239,5,5433,475,25.95764888013723,86.5742164173202,0
Bihar,Saharsa,Saurbazar,203,0,1,hab,1,0,5,198,202,5,5449,475,25.83460854861279,86.67686265619236,0
Bihar,Saharsa,Simri Bakhtiarpur,348,3,1,hab,1,0,16,332,347,5,5644,475,25.75433744278845,86.53618172804924,0
Bihar,Saharsa,Sonbarsa,280,1,3,hab,3,0,13,267,277,5,5725,475,25.71183554609088,86.77452868100116,0
Bihar,Samastipur,Bibhutipur,268,3,3,hab,3,0,23,245,265,5,899,479,25.701670872704007,85.94959394879572,0
Bihar,Samastipur,Bithan,100,0,1,hab,1,0,9,91,99,5,993,479,25.703774200525558,86.30131594916698,0
Bihar,Samastipur,Dalsingh Sarai,230,7,0,hab,0,0,0,230,230,5,1406,479,25.670779839218973,85.82617256679052,0
Bihar,Samastipur,Hasanpur,180,1,1,hab,1,0,4,176,179,5,2175,479,25.733927665597783,86.18555351667423,0
Bihar,Samastipur,Kalyanpur,259,5,1,hab,1,0,1,258,258,5,2665,479,25.986516507885778,85.77197288472081,0
Bihar,Samastipur,Khanpur,177,3,1,hab,1,0,6,171,176,5,2961,479,25.852776534129077,85.94375917618328,0
Bihar,Samastipur,Mohanpur,54,0,3,hab,3,0,19,35,51,5,3888,479,25.529077625307448,85.60167893067307,0
Bihar,Samastipur,Mohiuddinnagar,129,2,1,hab,1,0,4,125,128,5,3897,479,25.57167755754364,85.69265522410855,0
Bihar,Samastipur,Morwa,176,2,1,hab,1,0,9,167,175,5,3932,479,25.744211163656125,85.64019411587074,0
Bihar,Samastipur,Patori,179,1,0,hab,0,0,0,179,179,5,4627,479,25.62610720779429,85.60183029259123,0
Bihar,Samastipur,Pusa,101,1,2,hab,2,0,7,94,99,5,4881,479,25.93619815183692,85.67024071207433,0
Bihar,Samastipur,Rosera,119,2,1,hab,1,0,1,118,118,5,5199,479,25.7825895372564,86.04442822156763,0
Bihar,Samastipur,Samastipur,223,4,0,hab,0,0,0,223,223,5,5318,479,25.86798351975727,85.77187819010359,0
Bihar,Samastipur,Sarairanjan,283,2,1,hab,1,0,8,275,282,5,5399,479,25.743076911303316,85.7166947666641,0
Bihar,Samastipur,Shivaji Nagar,149,2,1,hab,1,0,3,146,148,5,5579,479,25.88120464162925,86.04013632470415,0
Bihar,Samastipur,Singhia,123,3,1,hab,1,0,3,120,122,5,5657,479,25.839645605685497,86.17621723150675,0
Bihar,Samastipur,Tajpur,146,0,1,hab,1,0,15,131,145,5,5856,479,25.855157943289708,85.65869979723041,0
Bihar,Samastipur,Ujiarpur,203,9,1,hab,1,0,3,200,202,5,6189,479,25.767836561926114,85.83260789107646,0
Bihar,Samastipur,Vidya Pati Nagar,111,0,1,hab,1,0,12,99,110,5,6353,479,25.61820186455908,85.77367859299136,0
Bihar,Samastipur,Warisnagar,182,8,1,hab,1,0,18,164,181,5,6422,479,25.920980996094276,85.87367726342644,0
Bihar,Sheikhpura,Ariari,67,0,1,hab,1,0,1,66,66,5,235,495,25.054092876484997,85.82005087791767,0
Bihar,Sheikhpura,Barbigha,54,0,0,hab,0,0,0,54,54,5,578,495,25.211608239812655,85.7511390499333,0
Bihar,Sheikhpura,Chewara,50,0,1,hab,1,0,1,49,49,5,1247,495,25.049828070136936,85.92064287336166,0
Bihar,Sheikhpura,Ghat Kusumbha,28,2,1,hab,1,0,1,27,27,5,1925,495,25.204027507192507,85.92210312297675,0
Bihar,Sheikhpura,Shekhopur Sarai,41,0,1,hab,1,0,2,39,40,5,5549,495,25.130774846229357,85.69512124232692,0
Bihar,Sheikhpura,Shekhpura,81,0,0,hab,0,0,0,81,81,5,5550,495,25.147211408797332,85.85004419621724,0
Bihar,Sheohar,Dumri Katsari,64,1,2,hab,2,0,5,59,62,5,1706,496,26.466385808119693,85.23353484611738,0
Bihar,Sheohar,Piprahi,47,2,1,hab,1,0,5,42,46,5,4767,496,26.554621391850002,85.32527695367648,0
Bihar,Sheohar,Purnahia,50,0,1,hab,1,0,6,44,49,5,4872,496,26.619024262059273,85.32085370762863,0
Bihar,Sheohar,Sheohar,93,0,0,hab,0,0,0,93,93,5,5557,496,26.51677113989108,85.28442277054612,0
Bihar,Sheohar,Tariyani,157,0,1,hab,1,0,5,152,156,5,5926,496,26.409802879397425,85.32332629840299,0
Bihar,Sitamarhi,Bajpatti,119,1,1,hab,1,0,3,116,118,5,428,512,26.543277502021503,85.63540129806154,0
Bihar,Sitamarhi,Bargania,43,0,3,hab,3,0,4,39,40,5,582,512,26.70774454408004,85.28525395696772,0
Bihar,Sitamarhi,Bathnaha,142,0,1,hab,1,0,5,137,141,5,665,512,26.68081211129677,85.53128991112656,0
Bihar,Sitamarhi,Belsand,61,1,2,hab,2,0,3,58,59,5,711,512,26.432540321024337,85.40411568465979,0
Bihar,Sitamarhi,Bokhra,22,1,2,hab,1,1,1,21,20,5,1013,512,26.3540636850163,85.66405535482006,0
Bihar,Sitamarhi,Choraut,42,1,3,hab,3,0,7,35,39,5,1351,512,26.534946738161544,85.77745727026696,0
Bihar,Sitamarhi,Dumra,155,1,0,hab,0,0,0,155,155,5,1702,512,26.553738848822157,85.51116105395577,0
Bihar,Sitamarhi,Major Ganj,52,0,28,hab,27,1,35,17,24,5,3567,512,26.74706180047427,85.41016671935282,0
Bihar,Sitamarhi,Nanpur,93,2,1,hab,1,0,3,90,92,5,4159,512,26.42751945621812,85.63673854479627,0
Bihar,Sitamarhi,Parihar,121,0,7,hab,7,0,10,111,114,5,4566,512,26.742518597417103,85.67369158091505,0
Bihar,Sitamarhi,Parsauni,38,1,1,hab,1,0,3,35,37,5,4574,512,26.509365156557145,85.41413734536971,0
Bihar,Sitamarhi,Pupari,84,1,0,hab,0,0,0,84,84,5,4860,512,26.491076474862346,85.71425065301116,0
Bihar,Sitamarhi,Riga,90,0,1,hab,1,0,2,88,89,5,5167,512,26.619978714106125,85.42814970180262,0
Bihar,Sitamarhi,Runnisaidpur,158,1,2,hab,2,0,3,155,156,5,5209,512,26.39770932490444,85.47936197809365,0
Bihar,Sitamarhi,Sonbarsa,129,1,12,hab,12,0,11,118,117,5,5726,512,26.79158655488736,85.56596466323326,0
Bihar,Sitamarhi,Suppi,62,0,2,hab,2,0,7,55,60,5,5812,512,26.683006990575308,85.35823939035852,0
Bihar,Sitamarhi,Sursand,95,1,1,hab,0,1,0,95,94,5,5823,512,26.61596745598155,85.7043031895114,0
Bihar,Siwan,Andar,180,23,2,hab,2,0,18,162,178,5,185,515,26.083489120148755,84.23220560214989,0
Bihar,Siwan,Barharia,229,16,8,hab,8,0,12,217,221,5,595,515,26.30512243701153,84.45869300263979,0
Bihar,Siwan,Basantpur,95,4,1,hab,1,0,5,90,94,5,634,515,26.188722474932042,84.65956894496428,0
Bihar,Siwan,Bhagwanpur Hat,155,14,1,hab,1,0,6,149,154,5,772,515,26.125842762329462,84.65343796460667,0
Bihar,Siwan,Darauli,289,10,1,hab,1,0,2,287,288,5,1443,515,26.11788969657338,84.13985395376129,0
Bihar,Siwan,Daraundha,132,5,1,hab,1,0,6,126,131,5,1444,515,26.08365224285361,84.48638182279288,0
Bihar,Siwan,Goraiyakothi,166,2,1,hab,1,0,2,164,165,5,2012,515,26.23892952540854,84.56650569971026,0
Bihar,Siwan,Guthani,263,86,1,hab,1,0,3,260,262,5,2090,515,26.18589963802818,84.066908324603,0
Bihar,Siwan,Hasanpura,112,9,0,hab,0,0,0,112,112,5,2176,515,26.085886434657457,84.3792101247746,0
Bihar,Siwan,Hussainganj,97,15,1,hab,1,0,4,93,96,5,2265,515,26.166745549391237,84.34161550390598,0
Bihar,Siwan,Lakri Nabiganj,99,1,1,hab,1,0,2,97,98,5,3352,515,26.234327464333763,84.68290339215564,0
Bihar,Siwan,Maharajganj,154,7,0,hab,0,0,0,154,154,5,3520,515,26.131743703058643,84.52574853373181,0
Bihar,Siwan,Mairwa,140,13,0,hab,0,0,0,140,140,5,3557,515,26.238441438613226,84.17503579927993,0
Bihar,Siwan,Nautan,179,18,1,hab,1,0,10,169,178,5,4234,515,26.311892944141043,84.21892436776888,0
Bihar,Siwan,Panchrukhi,171,14,1,hab,1,0,7,164,170,5,4500,515,26.206684812094192,84.42250099939326,0
Bihar,Siwan,Raghunathpur,166,10,1,hab,1,0,7,159,165,5,4919,515,26.01336893487831,84.28544583332364,0
Bihar,Siwan,Siswan,149,1,1,hab,1,0,6,143,148,5,5689,515,25.97557265306953,84.39576778894411,0
Bihar,Siwan,Siwan,235,2,0,hab,0,0,0,235,235,5,5699,515,26.26230176175689,84.32748750012351,0
Bihar,Siwan,Ziradei,275,47,1,hab,1,0,3,272,274,5,6485,515,26.190329133489207,84.24598715580166,0
Bihar,Supaul,Basantpur,416,1,22,hab,22,0,101,315,394,5,633,532,26.459665198548198,86.97291742822075,0
Bihar,Supaul,Chhatapur,300,2,1,hab,1,0,13,287,299,5,1256,532,26.251143609144336,87.03162656921752,0
Bihar,Supaul,Kishanpur,187,8,1,hab,1,0,9,178,186,5,3051,532,26.226169863715473,86.66609573581181,0
Bihar,Supaul,Marauna,171,0,1,hab,1,0,4,167,170,5,3721,532,26.221125654747322,86.52252239082779,0
Bihar,Supaul,Nirmalli,185,0,0,hab,0,0,0,185,185,5,4315,532,26.374895993251624,86.70926095014549,0
Bihar,Supaul,Pipra,168,1,1,hab,1,0,2,166,167,5,4765,532,26.157802562477947,86.74941092257744,0
Bihar,Supaul,Pratapganj,149,2,1,hab,1,0,7,142,148,5,4825,532,26.299429621583236,86.9414221675146,0
Bihar,Supaul,Raghopur,428,9,2,hab,2,0,37,391,426,5,4914,532,26.320872016542125,86.87293685650585,0
Bihar,Supaul,Saraigarh Bhaptiahi,168,3,1,hab,1,0,2,166,167,5,5395,532,26.32821609116215,86.75674572806862,0
Bihar,Supaul,Supaul,366,1,1,hab,1,0,11,355,365,5,5811,532,26.082052276161992,86.58386336126819,0
Bihar,Supaul,Triveniganj,237,0,0,hab,0,0,0,237,237,5,6139,532,26.139927595814246,86.93754726760905,0
Bihar,Vaishali,Bhagwanpur,253,7,0,hab,0,0,0,253,253,5,770,575,25.843883066062865,85.28605695664545,0
Bihar,Vaishali,Bidupur,108,1,2,hab,2,0,15,93,106,5,912,575,25.642691227507235,85.34563510330473,0
Bihar,Vaishali,Chehrakala,127,1,1,hab,1,0,9,118,126,5,1221,575,25.89441852691186,85.41979460611681,0
Bihar,Vaishali,Desari,72,4,1,hab,1,0,8,64,71,5,1517,575,25.638769687079893,85.41328640020343,0
Bihar,Vaishali,Goroul,192,2,1,hab,1,0,5,187,191,5,2017,575,25.885161369814824,85.3389653532828,0
Bihar,Vaishali,Hajipur,202,5,2,hab,2,0,7,195,200,5,2106,575,25.722444868627175,85.24387383149173,0
Bihar,Vaishali,Jandaha,315,5,1,hab,1,0,9,306,314,5,2436,575,25.73258860234605,85.50506017886265,0
Bihar,Vaishali,Lalganj,294,4,1,hab,1,0,6,288,293,5,3362,575,25.857359494485745,85.1947525711529,0
Bihar,Vaishali,Mahnar,134,3,0,hab,0,0,0,134,134,5,3536,575,25.62435633348514,85.52224477105693,0
Bihar,Vaishali,Mahua,228,4,1,hab,1,0,5,223,227,5,3543,575,25.803415594955133,85.41356918580158,0
Bihar,Vaishali,Patepur,379,1,2,hab,2,0,20,359,377,5,4602,575,25.846539052298187,85.5468401962345,0
Bihar,Vaishali,Paterhi Belsar,109,0,1,hab,1,0,9,100,108,5,4604,575,25.972126253785405,85.24384925840889,0
Bihar,Vaishali,Raghopur,77,1,1,hab,1,0,3,74,76,5,4915,575,25.568698229767122,85.34423472551646,0
Bihar,Vaishali,Rajapakar,162,1,1,hab,1,0,8,154,161,5,4965,575,25.73908410435436,85.34295228856901,0
Bihar,Vaishali,Sahdai Bujurg,84,1,1,hab,1,0,6,78,83,5,5257,575,25.640359569192036,85.4638436303822,0
Bihar,Vaishali,Vaishali,123,1,2,hab,2,0,8,115,121,5,6262,575,25.95060028797656,85.14944153950263,0
Bihar,West Champaran,Bairia,257,4,3,hab,3,0,23,234,254,5,419,589,26.7492796346634,84.4074595076401,0
Bihar,West Champaran,Bettiah,44,2,0,hab,0,0,0,44,44,5,737,589,26.790466313307785,84.55344753285844,0
Bihar,West Champaran,Bgaha,240,0,7,hab,4,3,8,232,233,5,741,589,27.068749723979078,84.21531100154004,0
Bihar,West Champaran,Bhitaha,81,11,0,hab,0,0,0,81,81,5,861,589,26.910132265021016,84.19229728519956,0
Bihar,West Champaran,Chanpatia,267,3,1,hab,1,0,1,266,266,5,1181,589,26.89930825444652,84.51503407530447,0
Bihar,West Champaran,Gaunaha,275,6,2,hab,2,0,5,270,273,5,1891,589,27.27823275912472,84.47771384192875,0
Bihar,West Champaran,Lauriya,324,1,1,hab,1,0,9,315,323,5,3393,589,27.0038668043351,84.42288811967843,0
Bihar,West Champaran,Madhubani,93,8,1,hab,0,1,0,93,92,5,3486,589,26.960880536039003,84.12280541465607,0
Bihar,West Champaran,Mainatanr,169,1,3,hab,3,0,7,162,166,5,3552,589,27.16131096195548,84.62658104615555,0
Bihar,West Champaran,Manjhaulia,242,1,1,hab,1,0,6,236,241,5,3688,589,26.794035132414095,84.64593147289499,0
Bihar,West Champaran,Narkatiaganj,567,14,0,hab,0,0,0,567,567,5,4189,589,27.101919654340463,84.48217896882443,0
Bihar,West Champaran,Nautan,241,3,1,hab,1,0,7,234,240,5,4235,589,26.687237025712,84.50594706823037,0
Bihar,West Champaran,Piparasi,17,1,23,osm,9,14,7,10,-6,5,4760,589,27.07572445390559,84.03886681965238,0
Bihar,West Champaran,Ramnagar,323,0,3,hab,2,1,9,314,320,5,5049,589,27.309784450768948,84.24659501892795,0
Bihar,West Champaran,Sidhaw,273,7,9,hab,2,7,10,263,264,5,5605,589,27.29284841694802,84.04356069482745,0
Bihar,West Champaran,Sikta,146,1,1,hab,1,0,4,142,145,5,5627,589,26.974225868575306,84.65849695219295,0
Bihar,West Champaran,Thakrahan,27,1,1,hab,1,0,2,25,26,5,5970,589,26.81222575038694,84.29023112968552,0
Bihar,West Champaran,Yogapatti,275,10,1,hab,1,0,3,272,274,5,6474,589,26.899375999364963,84.3536054512548,0
Chhattisgarh,Balod,Balod,102,0,101,hab,97,4,101,1,1,7,6990,622,20.712002361701213,81.23543748011089,0
Chhattisgarh,Balod,Dondi,172,0,191,osm,180,11,168,4,-19,7,6991,622,20.535179845233962,81.12779391232796,0
Chhattisgarh,Balod,Dondi Lohara,249,0,247,hab,236,11,240,9,2,7,6992,622,20.8119984441393,81.02356713554816,0
Chhattisgarh,Balod,Gunderdahi,166,1,163,hab,160,3,161,5,3,7,6993,622,20.932338451268823,81.28302025937508,0
Chhattisgarh,Balod,Gurur,129,1,120,hab,120,0,123,6,9,7,6994,622,20.686246940645496,81.40883161199547,0
Chhattisgarh,Balodabazar,Balodabazar,153,0,160,osm,155,5,150,3,-7,7,6995,623,21.668474450717607,82.23741384920531,0
Chhattisgarh,Balodabazar,Bhatapara,106,0,109,osm,91,18,95,11,-3,7,6996,623,21.769881560003522,82.02861689701187,0
Chhattisgarh,Balodabazar,Bilaigarh,219,0,247,osm,225,22,210,9,-28,7,6997,623,21.618716744377423,82.79564779536537,0
Chhattisgarh,Balodabazar,Kasdol,217,0,249,osm,216,33,209,8,-32,7,6998,623,21.48461772509817,82.4824655175622,0
Chhattisgarh,Balodabazar,Pallari,134,0,134,hab,133,1,130,4,0,7,6999,623,21.507057768279125,82.15041193915714,0
Chhattisgarh,Balodabazar,Simga,130,0,127,hab,126,1,128,2,3,7,7000,623,21.64623257475398,81.8639925137721,0
Chhattisgarh,Balrampur,Balrampur,171,0,17,hab,16,1,24,147,154,7,7009,625,23.581101487182462,83.5360748935253,0
Chhattisgarh,Balrampur,Kusmi,176,0,100,hab,86,14,88,88,76,7,7006,625,23.399719046382028,83.90546424035104,0
Chhattisgarh,Balrampur,Rajpur,123,1,71,hab,54,17,61,62,52,7,7008,625,23.350243363291057,83.38080361817083,0
Chhattisgarh,Balrampur,Ramchandarpur,227,0,39,hab,31,8,54,173,188,7,7010,625,23.88196163111113,83.462633428345,0
Chhattisgarh,Balrampur,Shankargarh,118,0,94,hab,85,9,85,33,24,7,7007,625,23.32220422513044,83.65405335151792,0
Chhattisgarh,Balrampur,Wadrafnagar,210,0,30,hab,27,3,33,177,180,7,7011,625,23.783005458733427,83.13010841834645,0
Chhattisgarh,Bastar,Bakawand,487,2,134,hab,122,12,336,151,353,7,430,58,19.337326081976844,82.05470825111729,0
Chhattisgarh,Bastar,Bastanar,142,3,54,hab,38,16,51,91,88,7,655,58,18.96272988188308,81.59815512813154,0
Chhattisgarh,Bastar,Bastar,515,2,189,hab,145,44,404,111,326,7,656,58,19.298599083169773,81.83894014747634,0
Chhattisgarh,Bastar,Darbha,147,1,154,osm,98,56,107,40,-7,7,1445,58,18.824592790759628,81.86682098130474,0
Chhattisgarh,Bastar,Jagdalpur,379,5,91,hab,84,7,237,142,288,7,2338,58,18.98147952153441,82.091460977917,0
Chhattisgarh,Bastar,Lohandiguda,156,0,86,hab,70,16,88,68,70,7,3426,58,19.157907007109866,81.60382223395669,0
Chhattisgarh,Bastar,Tokapal,227,1,68,hab,60,8,145,82,159,7,6125,58,19.060506637361943,81.8526858704747,0
Chhattisgarh,Bemetra,Bemetara,189,0,158,hab,154,4,180,9,31,7,6986,621,21.78071544060823,81.56691193944437,0
Chhattisgarh,Bemetra,Berla,137,0,134,hab,125,9,127,10,3,7,6987,621,21.527112759121085,81.52112753709365,0
Chhattisgarh,Bemetra,Nawagarh,188,0,148,hab,145,3,176,12,40,7,6988,621,21.8781354782557,81.71779978116184,0
Chhattisgarh,Bemetra,Saja,189,0,172,hab,166,6,180,9,17,7,6989,621,21.68317548317528,81.31763469109889,0
Chhattisgarh,Bijapur,Bhairamgarh,228,2,8,hab,5,3,8,220,220,7,781,79,19.115840636498607,80.95073511223171,0
Chhattisgarh,Bijapur,Bhopalpatnam,162,0,4,hab,4,0,8,154,158,7,881,79,18.9527260707787,80.45524880689531,0
Chhattisgarh,Bijapur,Bijapur,170,0,5,hab,4,1,7,163,165,7,925,79,18.803800627307382,80.88943450431816,0
Chhattisgarh,Bijapur,Usoor,156,0,9,hab,7,2,7,149,147,7,6236,79,18.483266096748157,80.83677799914499,0
Chhattisgarh,Bilaspur,Bilha,250,0,188,hab,175,13,203,47,62,7,948,82,22.064960865017937,82.16765538478529,0
Chhattisgarh,Bilaspur,Kota,251,0,249,hab,210,39,225,26,2,7,3150,82,22.416469890097975,82.02709679900232,0
Chhattisgarh,Bilaspur,Masturi,190,0,191,osm,180,11,172,18,-1,7,3755,82,21.99464587335313,82.30941451479836,0
Chhattisgarh,Bilaspur,Takhatpur,226,0,197,hab,180,17,193,33,29,7,5858,82,22.148386792476757,81.97066886156885,0
Chhattisgarh,Dantewada,Dantewada,99,2,3,hab,3,0,4,95,96,7,1437,131,18.81351334539848,81.34413091281294,0
Chhattisgarh,Dantewada,Geedam,140,0,16,hab,12,4,14,126,124,7,1902,131,19.04991633208676,81.34230299988486,0
Chhattisgarh,Dantewada,Katekalyan,73,1,17,hab,11,6,15,58,56,7,2826,131,18.728429410891877,81.58870578324701,0
Chhattisgarh,Dantewada,Kuakonda,103,1,7,hab,2,5,2,101,96,7,3213,131,18.590306464811867,81.3327874006957,0
Chhattisgarh,Dhamtari,Dhamtari,164,0,128,hab,124,4,145,19,36,7,1550,145,20.67789446396525,81.57383562604363,0
Chhattisgarh,Dhamtari,Kurud,134,3,90,hab,87,3,89,45,44,7,3294,145,20.894124264010618,81.68286718005388,0
Chhattisgarh,Dhamtari,Magarlod,128,4,116,hab,109,7,116,12,12,7,3505,145,20.705755735883585,81.86136829925383,0
Chhattisgarh,Dhamtari,Nagri,371,3,99,hab,85,14,110,261,272,7,4080,145,20.363794999999495,81.90482790191417,0
Chhattisgarh,Durg,Dhamdha,172,0,164,hab,147,17,154,18,8,7,1546,163,21.389345498124037,81.34802204619092,0
Chhattisgarh,Durg,Durg,81,0,90,osm,75,15,72,9,-9,7,1713,163,21.17747273482322,81.29640933249114,0
Chhattisgarh,Durg,Patan,147,1,162,osm,148,14,142,5,-15,7,4595,163,21.061824753967983,81.49610761957526,0
Chhattisgarh,Gariaband,Chhura,157,0,186,osm,161,25,146,11,-29,7,7001,624,20.803053232215667,82.18460343714631,0
Chhattisgarh,Gariaband,Deobhog,142,0,139,hab,130,9,131,11,3,7,7002,624,19.903778713210198,82.63227151435578,0
Chhattisgarh,Gariaband,Gariaband,174,2,171,hab,142,29,150,24,3,7,7003,624,20.532792394170055,82.19321232664879,0
Chhattisgarh,Gariaband,Mainpur,189,0,266,osm,207,59,159,30,-77,7,7004,624,20.113697613627284,82.30157497560211,0
Chhattisgarh,Gariaband,Rajim,120,0,109,hab,104,5,113,7,11,7,7005,624,20.946211963933717,82.0028459614325,0
Chhattisgarh,Gaurella Pendra Marwahi,Gourella,155,0,190,osm,135,55,129,26,-35,7,8031,744,22.686312644016798,81.92940829956164,0
Chhattisgarh,Gaurella Pendra Marwahi,Marawahi,219,0,255,osm,199,56,194,25,-36,7,8033,744,22.953042646118867,82.03795825906602,0
Chhattisgarh,Gaurella Pendra Marwahi,Pendra,92,0,100,osm,80,20,78,14,-8,7,8032,744,22.75251099326535,82.06643609831264,0
Chhattisgarh,Jangir-Champa,Akaltara,85,0,85,hab,80,5,82,3,0,7,53,250,22.02382914164671,82.41897731597771,0
Chhattisgarh,Jangir-Champa,Baloda,107,0,135,osm,120,15,105,2,-28,7,472,250,22.13262665647533,82.57747091874627,0
Chhattisgarh,Jangir-Champa,Bamhnidih,89,0,86,hab,78,8,84,5,3,7,484,250,21.926162076407934,82.74915662258148,0
Chhattisgarh,Jangir-Champa,Dabhara,150,0,165,osm,157,8,147,3,-15,7,1381,250,21.801531483460753,83.14057203965835,0
Chhattisgarh,Jangir-Champa,Jaijaipur,108,0,137,osm,120,17,99,9,-29,7,2353,250,21.839408173044163,82.86412182213962,0
Chhattisgarh,Jangir-Champa,Malkharada,109,0,130,osm,119,11,105,4,-21,7,3599,250,21.875296148655107,82.99886786963577,0
Chhattisgarh,Jangir-Champa,Nawagarh,109,0,123,osm,112,11,106,3,-14,7,4249,250,21.884754813688172,82.61675127874628,0
Chhattisgarh,Jangir-Champa,Pamgarh,106,0,99,hab,91,8,99,7,7,7,4486,250,21.838169894920405,82.45117501014059,0
Chhattisgarh,Jangir-Champa,Sakti,134,0,123,hab,117,6,124,10,11,7,5293,250,22.059875070614517,82.88883392199858,0
Chhattisgarh,Jashpur,Bagicha,438,0,362,hab,304,58,359,79,76,7,386,251,23.011363432395076,83.71478973854039,0
Chhattisgarh,Jashpur,Duldula,168,0,160,hab,141,19,157,11,8,7,1691,251,22.70671670541415,84.10548197461934,0
Chhattisgarh,Jashpur,Farsabahar,273,1,465,osm,392,73,271,2,-192,7,1765,251,22.451369767215006,83.89188475540688,0
Chhattisgarh,Jashpur,Jashpur,174,0,173,hab,147,26,157,17,1,7,2451,251,22.887837203896456,84.224832026163,0
Chhattisgarh,Jashpur,Kansabel,222,0,212,hab,189,23,207,15,10,7,2735,251,22.65404861442626,83.79289701832107,0
Chhattisgarh,Jashpur,Kunkuri,228,0,192,hab,178,14,213,15,36,7,3267,251,22.784117326932734,83.9255745038184,0
Chhattisgarh,Jashpur,Manora,159,1,210,osm,164,46,140,19,-51,7,3700,251,23.015857672681914,84.00046266604694,0
Chhattisgarh,Jashpur,Pathalgaon,267,0,460,osm,386,74,256,11,-193,7,4606,251,22.547027065831717,83.60805387809998,0
Chhattisgarh,Kanker,Antagarh,294,0,0,hab,0,0,0,294,294,7,209,269,19.959874876554732,81.1963012326737,0
Chhattisgarh,Kanker,Bhanupratappur,117,0,10,hab,7,3,10,107,107,7,800,269,20.27658613180453,81.14433312855466,0
Chhattisgarh,Kanker,Charama,127,0,71,hab,66,5,67,60,56,7,1185,269,20.444138524346265,81.37990793673062,0
Chhattisgarh,Kanker,Durgukondal,148,0,20,hab,16,4,17,131,128,7,1717,269,20.25490608764132,80.8840515645869,0
Chhattisgarh,Kanker,Kanker,132,0,14,hab,14,0,14,118,118,7,2726,269,20.25601324903872,81.42234386657533,0
Chhattisgarh,Kanker,Koelibeda,381,381,51,osm,0,51,0,381,330,7,3076,269,20.32873524910823,81.655631906726,0
Chhattisgarh,Kanker,Narharpur,148,148,7,osm,0,7,0,148,141,7,4184,269,19.964366098635523,80.74959643326432,0
Chhattisgarh,Kawardha,Bodla,328,0,342,osm,293,49,280,48,-14,7,1004,288,22.104751038667544,81.0986545840622,0
Chhattisgarh,Kawardha,Kawardha,188,2,155,hab,153,2,172,16,33,7,2869,288,21.9851206036048,81.32770111869931,0
Chhattisgarh,Kawardha,Pandariya,333,1,308,hab,273,35,293,40,25,7,4507,288,22.28688441936851,81.4058159039846,0
Chhattisgarh,Kawardha,Sahaspur/Lohara,189,0,167,hab,164,3,182,7,22,7,5254,288,21.816897049563924,81.16989118985767,0
Chhattisgarh,Kondagaon,Baderajpur,122,1,1,hab,1,0,1,121,121,7,7019,627,20.014300152187836,81.77324197935015,0
Chhattisgarh,Kondagaon,Keshkal,130,0,1,hab,1,0,1,129,129,7,7020,627,20.03771672055064,81.52599429629993,0
Chhattisgarh,Kondagaon,Kondagaon,288,2,13,hab,6,7,14,274,275,7,7024,627,19.49065989515875,81.63127710438151,0
Chhattisgarh,Kondagaon,Makdi,242,0,5,hab,3,2,7,235,237,7,7025,627,19.728017432519984,81.8914967450677,0
Chhattisgarh,Kondagaon,Pharasgaon,157,0,2,hab,2,0,5,152,155,7,7021,627,19.808466147211,81.53096609489981,0
Chhattisgarh,Korba,Kartala,224,0,161,hab,153,8,186,38,63,7,2796,310,22.206638421313045,82.84580607389069,0
Chhattisgarh,Korba,Katghora,119,0,73,hab,48,25,63,56,46,7,2827,310,22.3901548377712,82.60409596526937,0
Chhattisgarh,Korba,Korba,182,1,126,hab,103,23,104,78,56,7,3135,310,22.4934234204652,82.87158772034682,0
Chhattisgarh,Korba,Pali,228,0,134,hab,108,26,120,108,94,7,4464,310,22.44772110052738,82.34227410010311,0
Chhattisgarh,Korba,Podiuproda,498,2,101,hab,93,8,140,358,397,7,4784,310,22.7600464145954,82.45488610584331,0
Chhattisgarh,Koria,Baikunthpur,178,0,214,osm,182,32,156,22,-36,7,415,311,23.26781246198116,82.56705711660375,0
Chhattisgarh,Koria,Bharatpur,183,0,238,osm,191,47,153,30,-55,7,805,311,23.686503328223292,81.95327957820376,0
Chhattisgarh,Koria,Khadgawan,102,0,182,osm,96,86,63,39,-80,7,2907,311,23.076306513832094,82.38009842900573,0
Chhattisgarh,Koria,Manedragarh,139,0,135,hab,100,35,93,46,4,7,3659,311,23.366457240590123,82.20520372890826,0
Chhattisgarh,Koria,Sonhat,105,0,94,hab,76,18,70,35,11,7,5735,311,23.564362244114722,82.45564075586675,0
Chhattisgarh,Mahasamund,Bagbahara,234,0,272,osm,233,39,227,7,-38,7,373,346,21.008323956816877,82.3836264879667,0
Chhattisgarh,Mahasamund,Basna,217,1,255,osm,234,21,209,8,-38,7,647,346,21.34663568236111,82.86742950964765,0
Chhattisgarh,Mahasamund,Mahasamund,189,0,198,osm,181,17,175,14,-9,7,3523,346,21.19727674613559,82.20107549406468,0
Chhattisgarh,Mahasamund,Pithora,340,1,284,hab,252,32,305,35,56,7,4778,346,21.25802672437968,82.62831434736631,0
Chhattisgarh,Mahasamund,Saraipali,234,0,268,osm,250,18,225,9,-34,7,5398,346,21.281380845996868,83.0846739907653,0
Chhattisgarh,Mungeli,Lormi,270,0,217,hab,198,19,249,21,53,7,7026,628,22.38615196101577,81.70052503045586,0
Chhattisgarh,Mungeli,Mungeli,270,0,185,hab,182,3,246,24,85,7,7022,628,22.075389002425055,81.67617112787191,0
Chhattisgarh,Mungeli,Pathariya,162,1,149,hab,146,3,157,5,13,7,7023,628,21.965369542826455,81.8883637066689,0
Chhattisgarh,Narayanpur,Narayanpur,393,1,3,hab,3,0,13,380,390,7,4179,390,19.56466317727147,81.32587757363791,0
Chhattisgarh,Narayanpur,Orchha,205,2,3,hab,3,0,8,197,202,7,4392,390,19.58347684201048,80.98298165905949,0
Chhattisgarh,Raigarh,Baramkela,229,1,256,osm,252,4,223,6,-27,7,565,447,21.534310911690365,83.31203031061486,0
Chhattisgarh,Raigarh,Dharamjaigarh,456,456,4,osm,0,4,0,456,452,7,1572,447,22.832125980561898,82.92990055216758,0
Chhattisgarh,Raigarh,Gharghoda,113,0,138,osm,124,14,105,8,-25,7,1921,447,22.227194930829853,83.32390167219789,0
Chhattisgarh,Raigarh,Kharsia,158,0,165,osm,156,9,146,12,-7,7,2980,447,22.040311400565226,83.10960617168287,0
Chhattisgarh,Raigarh,Lailunga,232,0,288,osm,246,42,223,9,-56,7,3333,447,22.351913319636363,83.58271319553907,0
Chhattisgarh,Raigarh,Pussore,158,0,184,osm,178,6,151,7,-26,7,4885,447,21.77746795219394,83.3678385277386,0
Chhattisgarh,Raigarh,Raigarh,144,0,142,hab,134,8,107,37,2,7,4936,447,21.924057041437965,83.40397701749185,0
Chhattisgarh,Raigarh,Sarangarh,273,0,299,osm,292,7,263,10,-26,7,5404,447,21.572596722342997,83.09826950513764,0
Chhattisgarh,Raigarh,Tamnar,139,2,170,osm,161,9,131,8,-31,7,5889,447,22.119296354553715,83.4555546768623,0
Chhattisgarh,Raipur,Abhanpur,106,0,100,hab,95,5,98,8,6,7,4,448,21.064565925850633,81.77048268874229,0
Chhattisgarh,Raipur,Arang,167,1,165,hab,161,4,157,10,2,7,221,448,21.260096423733835,81.93926106425108,0
Chhattisgarh,Raipur,Dharsiwa,121,0,78,hab,74,4,70,51,43,7,1596,448,21.31231721646601,81.67651358018719,0
Chhattisgarh,Raipur,Tilda,134,0,133,hab,128,5,122,12,1,7,6085,448,21.47261803581418,81.84223794506572,0
Chhattisgarh,Rajnandgaon,Chhuikhadan,226,226,173,osm,0,173,0,226,53,7,1269,452,20.76300065760304,80.69011976587267,0
Chhattisgarh,Rajnandgaon,Chhuria,219,219,215,osm,0,215,0,219,4,7,1271,452,21.631677262312945,80.93575063575062,0
Chhattisgarh,Rajnandgaon,Chowki,192,192,236,osm,5,231,4,188,-44,7,1359,452,20.942063345990817,80.69276250188304,0
Chhattisgarh,Rajnandgaon,Dongargarh,194,1,172,hab,160,12,164,30,22,7,1664,452,21.187179840882475,80.72759075881356,0
Chhattisgarh,Rajnandgaon,Dongergaon,107,1,102,hab,95,7,102,5,5,7,1665,452,21.02699839466935,80.8740837663243,0
Chhattisgarh,Rajnandgaon,Khairagarh,222,1,197,hab,187,10,201,21,25,7,2917,452,21.394446538129607,80.94207862364536,0
Chhattisgarh,Rajnandgaon,Manpur,169,0,268,osm,189,79,153,16,-99,7,3701,452,20.34134395403681,80.69530340275729,0
Chhattisgarh,Rajnandgaon,Mohla,300,0,233,hab,227,6,286,14,67,7,3899,452,20.588140754427023,80.75555279038886,0
Chhattisgarh,Rajnandgaon,Rajnandgaon,162,0,165,osm,154,11,151,11,-3,7,4993,452,21.18080365622551,81.0818286106457,0
Chhattisgarh,Sukma,Chhindgarh,191,1,148,hab,113,35,149,42,43,7,6982,620,18.605395540178705,81.7507631621048,0
Chhattisgarh,Sukma,Konta,331,0,379,osm,244,135,216,115,-48,7,7018,620,18.14947427460852,81.22835000149772,0
Chhattisgarh,Sukma,Sukma,149,1,205,osm,152,53,135,14,-56,7,6983,620,18.435511346316,81.56167686968887,0
Chhattisgarh,Surajpur,Bhaiyathan,153,2,122,hab,114,8,120,33,31,7,7016,626,23.355017489739645,82.89556876297732,0
Chhattisgarh,Surajpur,Odagi,201,5,5,hab,4,1,4,197,196,7,7015,626,23.61739561047402,82.7723644758155,0
Chhattisgarh,Surajpur,Pratappur,179,6,86,hab,73,13,73,106,93,7,7017,626,23.54357303148931,83.10794645299211,0
Chhattisgarh,Surajpur,Premnagar,84,0,57,hab,50,7,47,37,27,7,7013,626,22.94753840306449,82.70673544191311,0
Chhattisgarh,Surajpur,Ramanujnagar,101,0,93,hab,72,21,50,51,8,7,7014,626,23.138524468420524,82.73313578302137,0
Chhattisgarh,Surajpur,Surajpur,142,0,166,osm,123,43,103,39,-24,7,7012,626,23.201694192963636,82.99702106530023,0
Chhattisgarh,Surguja,Ambikapur,205,4,24,hab,24,0,30,175,181,7,140,535,23.058789124369124,83.20492166135985,0
Chhattisgarh,Surguja,Batauli,97,0,1,hab,1,0,3,94,96,7,661,535,22.951978257613373,83.44935493717836,0
Chhattisgarh,Surguja,Lakhanpur,176,3,3,hab,3,0,5,171,173,7,3339,535,22.940104226377986,83.06482913281874,0
Chhattisgarh,Surguja,Lundra,157,0,44,hab,38,6,45,112,113,7,3446,535,23.137835300951124,83.4073858287076,0
Chhattisgarh,Surguja,Mainpat,135,1,7,hab,5,2,9,126,128,7,3553,535,22.816491686829433,83.32995565353345,0
Chhattisgarh,Surguja,Sitapur,132,0,23,hab,19,4,20,112,109,7,5693,535,22.760460314302527,83.55542870918607,0
Chhattisgarh,Surguja,Udaipur,143,143,433,osm,0,433,0,143,-290,7,6169,535,22.465428781439417,83.23071461318776,0
Gujarat,Ahmedabad,Ahmedabad (City),5,0,2,hab,0,2,0,5,3,12,39,3,23.022917026025638,72.58198251931033,0
Gujarat,Ahmedabad,Bavla,54,2,2,hab,2,0,2,52,52,12,669,3,22.74022204528585,72.22329539515366,0
Gujarat,Ahmedabad,Dascroi,139,3,11,hab,8,3,9,130,128,12,1456,3,22.96955398859262,72.62748381464328,0
Gujarat,Ahmedabad,Detroj,74,0,41,hab,40,1,50,24,33,12,1520,3,23.346234851902206,72.16809109201637,0
Gujarat,Ahmedabad,Dhandhuka,76,0,33,hab,32,1,33,43,43,12,1555,3,22.274717640320674,72.14830955486602,0
Gujarat,Ahmedabad,Dholka,87,0,2,hab,2,0,3,84,85,12,1612,3,22.611652963745147,72.36347934051422,0
Gujarat,Ahmedabad,Mandal,49,0,27,hab,27,0,29,20,22,12,3634,3,23.347102624659993,71.99658501183168,0
Gujarat,Ahmedabad,Sanand,105,1,5,hab,5,0,5,100,100,12,5334,3,22.95886732146791,72.29329409206522,0
Gujarat,Ahmedabad,Viramgam,92,1,15,hab,15,0,17,75,77,12,6375,3,23.054612839567064,72.06393332766453,0
Gujarat,Amreli,Amreli,76,1,22,hab,22,0,22,54,54,12,161,17,21.592891553000722,71.1721435934464,0
Gujarat,Amreli,Babara,58,0,1,hab,1,0,1,57,57,12,339,17,21.880899726932952,71.25246646138426,0
Gujarat,Amreli,Bagasara,31,0,18,hab,18,0,19,12,13,12,372,17,21.501035643476797,70.94636457286066,0
Gujarat,Amreli,Dhari,89,0,10,hab,10,0,10,79,79,12,1582,17,21.296707542382077,71.05095189757681,0
Gujarat,Amreli,Jafrabad,46,1,0,hab,0,0,0,46,46,12,2329,17,20.905762364144813,71.31527282464587,0
Gujarat,Amreli,Khambha,60,0,1,hab,1,0,1,59,59,12,2936,17,21.10008689385764,71.21914444287862,0
Gujarat,Amreli,Kunkavav,45,2,3,hab,3,0,3,42,42,12,3266,17,21.686254029931156,70.96431598643147,0
Gujarat,Amreli,Lathi,53,0,8,hab,7,1,7,46,45,12,3387,17,21.706538456926037,71.43889916337321,0
Gujarat,Amreli,Liliya,38,2,15,hab,15,0,16,22,23,12,3410,17,21.538755370882438,71.4112419463797,0
Gujarat,Amreli,Rajula,81,2,1,hab,1,0,1,80,80,12,5006,17,21.043708864269963,71.49432028907812,0
Gujarat,Amreli,Savarkundla,93,0,1,hab,0,1,0,93,92,12,5454,17,21.30797060828938,71.4081360737901,1
Gujarat,Anand,Anand,174,5,29,hab,28,1,44,130,145,12,171,19,22.550491536520322,73.00817497220511,0
Gujarat,Anand,Anklav,132,4,16,hab,16,0,37,95,116,12,199,19,22.36081576564955,73.00994056174495,0
Gujarat,Anand,Borsad,274,4,16,hab,16,0,36,238,258,12,1041,19,22.366174053725604,72.87433895033547,0
Gujarat,Anand,Khambhat,133,1,1,hab,1,0,3,130,132,12,2938,19,22.30736985757142,72.53821770747474,0
Gujarat,Anand,Petlad,163,2,1,hab,1,0,1,162,162,12,4720,19,22.497705954451877,72.7942005679547,0
Gujarat,Anand,Sojitra,70,2,0,hab,0,0,0,70,70,12,5714,19,22.561115522920417,72.7250513971548,0
Gujarat,Anand,Tarpur,64,0,0,hab,0,0,0,64,64,12,5930,19,22.49254692377014,72.54471121861259,0
Gujarat,Anand,Umreth,91,6,4,hab,4,0,5,86,87,12,6209,19,22.656216575970728,73.10229788561867,0
Gujarat,Arvalli,Bayad,271,3,1,hab,1,0,1,270,270,12,7709,686,23.197540844184623,73.20689847272509,0
Gujarat,Arvalli,Bhiloda,360,2,1,hab,1,0,4,356,359,12,7710,686,23.733690537560822,73.29646892516459,0
Gujarat,Arvalli,Dhansura,185,6,1,hab,1,0,2,183,184,12,7711,686,23.345006898570617,73.19869727551131,0
Gujarat,Arvalli,Malpur,209,1,0,hab,0,0,0,209,209,12,7712,686,23.35870466642457,73.44801064349731,0
Gujarat,Arvalli,Meghraj,258,1,0,hab,0,0,0,258,258,12,7713,686,23.534973451017972,73.538153768303,0
Gujarat,Arvalli,Modasa,255,2,1,hab,1,0,1,254,254,12,7714,686,23.50332402747637,73.30619831262864,0
Gujarat,Banaskantha,Amirgadh,116,4,1,hab,1,0,1,115,115,12,149,43,24.356268939118145,72.5930342533032,0
Gujarat,Banaskantha,Bhabhar,73,1,0,hab,0,0,0,73,73,12,743,43,24.082614786772748,71.58926254711844,0
Gujarat,Banaskantha,Danta,211,2,2,hab,1,1,2,209,209,12,1433,43,24.208257021776635,72.84266328759145,0
Gujarat,Banaskantha,Dantiwada,89,1,4,hab,4,0,5,84,85,12,1438,43,24.407706221109304,72.34264836601159,0
Gujarat,Banaskantha,Deesa,196,8,5,hab,5,0,6,190,191,12,1480,43,24.295618247148827,72.07016779747424,0
Gujarat,Banaskantha,Deodar,125,17,1,hab,1,0,2,123,124,12,1496,43,24.177066246699248,71.77377232968223,0
Gujarat,Banaskantha,Dhanera,119,5,0,hab,0,0,0,119,119,12,1556,43,24.569104125336118,72.07507568056086,0
Gujarat,Banaskantha,Kankrej,181,0,2,hab,2,0,6,175,179,12,2728,43,23.996031090622562,71.85714362768834,0
Gujarat,Banaskantha,Palanpur,172,7,12,hab,11,1,14,158,160,12,4452,43,24.19004883047945,72.41169646064921,0
Gujarat,Banaskantha,Tharad,146,0,4,hab,4,0,4,142,142,12,5995,43,24.48522110015717,71.71068008048536,0
Gujarat,Banaskantha,Vadgam,155,2,12,hab,12,0,20,135,143,12,6255,43,24.054510917546057,72.52040600518824,0
Gujarat,Banaskantha,Wav,146,0,4,hab,4,0,6,140,142,12,6430,43,24.315115421785816,71.43238670387807,0
Gujarat,Bharuch,Amod,56,0,1,hab,1,0,1,55,55,12,156,70,21.956253083644196,72.89883913916282,0
Gujarat,Bharuch,Ankleshwar,58,2,3,hab,3,0,3,55,55,12,200,70,21.59838054500683,72.97692736682889,0
Gujarat,Bharuch,Bharuch,92,1,0,hab,0,0,0,92,92,12,814,70,21.774503446922097,72.97960399870334,0
Gujarat,Bharuch,Hansot,50,0,9,hab,9,0,9,41,41,12,2127,70,21.494393657557666,72.7329187621002,0
Gujarat,Bharuch,Jambusar,110,0,3,hab,3,0,3,107,107,12,2416,70,22.07776550522483,72.64999865820963,0
Gujarat,Bharuch,Jhagadia,208,1,5,hab,5,0,10,198,203,12,2486,70,21.728107148520436,73.26382042461978,0
Gujarat,Bharuch,Valia,152,0,3,hab,2,1,2,150,149,12,6269,70,21.566839540278103,73.2733364373371,0
Gujarat,Bharuch,Wagra,70,0,1,hab,1,0,1,69,69,12,6406,70,21.70947736726915,72.64624765129889,0
Gujarat,Bhavnagar,Bhavnagar,75,1,6,hab,5,1,8,67,69,12,829,71,21.831231278267403,72.23263524775948,0
Gujarat,Bhavnagar,Gariyadhar,53,0,0,hab,0,0,0,53,53,12,1881,71,21.537746241169444,71.61428096593795,0
Gujarat,Bhavnagar,Ghogha,118,4,0,hab,0,0,0,118,118,12,1941,71,21.60731995466253,72.23899052453862,0
Gujarat,Bhavnagar,Mahuva,160,0,6,hab,6,0,9,151,154,12,3547,71,21.20386098977933,71.7528019728871,1
Gujarat,Bhavnagar,Palitana,100,0,0,hab,0,0,0,100,100,12,4469,71,21.503674872829716,71.79323625355323,1
Gujarat,Bhavnagar,Sihor,88,2,1,hab,1,0,2,86,87,12,5617,71,21.671052019970578,71.89818773665853,0
Gujarat,Bhavnagar,Talaja,126,0,3,hab,2,1,2,124,123,12,5861,71,21.351837958835343,72.03755686429353,0
Gujarat,Bhavnagar,Umarala,45,1,2,hab,1,1,1,44,43,12,6199,71,21.823141168326767,71.73635362998348,0
Gujarat,Bhavnagar,Vallbhipur,60,0,0,hab,0,0,0,60,60,12,6272,71,21.958020171389563,71.88997428327754,0
Gujarat,Botad,Barwala,30,0,7,hab,7,0,7,23,23,12,7685,680,22.175121407493148,71.95977062297159,0
Gujarat,Botad,Botad,57,0,6,hab,6,0,5,52,51,12,7684,680,22.170112802526234,71.64002086409477,0
Gujarat,Botad,Gadhada,78,1,8,hab,8,0,6,72,70,12,7686,680,21.94036049322523,71.5750012809964,0
Gujarat,Botad,Ranpur,35,0,2,hab,2,0,3,32,33,12,7687,680,22.291519049909166,71.74187533715342,0
Gujarat,Chhotaudepur,Chhotaudepur,179,2,0,hab,0,0,0,179,179,12,7679,685,22.39584185846792,74.02627827822795,0
Gujarat,Chhotaudepur,Jetpur Pavi,227,0,4,hab,3,1,5,222,223,12,7680,685,22.31448903599667,73.84129482763088,1
Gujarat,Chhotaudepur,Kawant,158,2,1,hab,1,0,1,157,157,12,7681,685,22.08692314926109,74.0348577340439,0
Gujarat,Chhotaudepur,Naswadi,246,2,2,hab,2,0,8,238,244,12,7682,685,22.00305571745931,73.84738772033091,0
Gujarat,Chhotaudepur,Sankheda,275,2,2,hab,2,0,2,273,273,12,7683,685,22.195328263741484,73.63313213012128,0
Gujarat,Dahod,Dahod,588,8,1,hab,1,0,5,583,587,12,1400,125,22.84185369903305,74.30619871000376,0
Gujarat,Dahod,Devgadhbaria,378,14,2,hab,1,1,3,375,376,12,1531,125,22.67073457068506,73.90951484259394,0
Gujarat,Dahod,Dhanpur,188,1,1,hab,1,0,6,182,187,12,1563,125,22.644117252610062,74.11114499385869,0
Gujarat,Dahod,Fatepura,363,5,1,hab,1,0,6,357,362,12,1778,125,23.20421024101872,74.05120508939638,0
Gujarat,Dahod,Garabada,262,0,1,hab,1,0,5,257,261,12,1867,125,22.707192956826646,74.27301559360026,0
Gujarat,Dahod,Jhalod,649,2,7,hab,7,0,16,633,642,12,2491,125,23.038440255734216,74.16029638495313,0
Gujarat,Dahod,Limkheda,336,3,2,hab,2,0,7,329,334,12,3412,125,22.880173968328204,74.01322183388432,0
Gujarat,Dangs,Dangs,376,19,3,hab,3,0,6,370,373,12,1426,130,20.80352629992326,73.70808198588738,0
Gujarat,Devbhumi Dwarka,Bhanwad,90,0,1,hab,1,0,1,89,89,12,7688,681,21.94529996755253,69.77896598058177,0
Gujarat,Devbhumi Dwarka,Kalyanpur,81,0,17,hab,16,1,15,66,64,12,7689,681,22.064005262128436,69.35678823313445,0
Gujarat,Devbhumi Dwarka,Khambhalia,104,1,9,hab,9,0,9,95,95,12,7690,681,22.214554013218397,69.61165495512182,0
Gujarat,Devbhumi Dwarka,Okhamandal     Dwarka,45,0,2,hab,2,0,2,43,43,12,7691,681,22.269966278196577,69.07059138864413,0
Gujarat,Gandhinagar,Dehgam,210,1,1,hab,1,0,1,209,209,12,1485,189,23.16716989832756,72.8759127298324,0
Gujarat,Gandhinagar,Gandhinagar,139,1,11,hab,11,0,18,121,128,12,1835,189,23.226910365606823,72.67086608559093,0
Gujarat,Gandhinagar,Kalol,98,0,8,hab,7,1,7,91,90,12,2651,189,23.24897201878255,72.50663098116037,0
Gujarat,Gandhinagar,Mansa,106,12,8,hab,8,0,9,97,98,12,3705,189,23.464180177518028,72.68815858015749,0
Gujarat,Gir Somnath,Kodinar,67,0,1,hab,1,0,1,66,66,12,7693,682,20.840140196997332,70.76985525927931,0
Gujarat,Gir Somnath,Sutrapada,51,0,2,hab,2,0,2,49,49,12,7694,682,20.86653402371863,70.57862568199656,0
Gujarat,Gir Somnath,Talala,53,2,5,hab,4,1,4,49,48,12,7695,682,21.0546836081002,70.58251096033806,0
Gujarat,Gir Somnath,Una,140,4,5,hab,5,0,5,135,135,12,7696,682,20.864608531217836,71.01906632717065,0
Gujarat,Gir Somnath,Veraval,58,1,0,hab,0,0,0,58,58,12,7697,682,20.960555209425742,70.41699562070585,0
Gujarat,Jamnagar,Dhrol,53,1,10,hab,10,0,9,44,43,12,1618,247,22.54193084757108,70.4575474809695,0
Gujarat,Jamnagar,Jamjodhpur,119,2,2,hab,1,1,1,118,117,12,2418,247,21.947158354257045,70.04573590091162,0
Gujarat,Jamnagar,Jamnagar,125,1,15,hab,12,3,16,109,110,12,2423,247,22.43320659540204,70.12727012739745,0
Gujarat,Jamnagar,Jodiya,65,0,23,hab,22,1,19,46,42,12,2519,247,22.74673596367858,70.4279954947936,0
Gujarat,Jamnagar,Kalavad,114,1,6,hab,6,0,7,107,108,12,2620,247,22.178499201899616,70.37241793720489,0
Gujarat,Jamnagar,Lalpur,92,0,6,hab,6,0,6,86,86,12,3366,247,22.231678365835176,69.9374683225747,0
Gujarat,Junagadh,Bhesan,44,0,2,hab,2,0,2,42,42,12,844,262,21.570026165090063,70.72620375172882,0
Gujarat,Junagadh,Junagadh,74,0,3,hab,3,0,5,69,71,12,2540,262,21.515069556596625,70.50857209030545,0
Gujarat,Junagadh,Keshod,60,0,16,hab,16,0,17,43,44,12,2895,262,21.304987571690297,70.2289389324081,0
Gujarat,Junagadh,Malia,67,0,0,hab,0,0,0,67,67,12,3592,262,21.11260374929415,70.34008187476434,0
Gujarat,Junagadh,Manavadar,58,0,9,hab,8,1,8,50,49,12,3626,262,21.52381239666593,70.12221172426447,0
Gujarat,Junagadh,Mangrol,74,0,8,hab,6,2,7,67,66,12,3671,262,21.23323749840352,70.0960780254285,0
Gujarat,Junagadh,Mendarda,51,0,4,hab,4,0,4,47,47,12,3838,262,21.29594088854377,70.46065440403727,0
Gujarat,Junagadh,Vanthali,55,0,3,hab,3,0,3,52,52,12,6284,262,21.46598633069952,70.32860405193206,0
Gujarat,Junagadh,Visavadar,88,1,4,hab,4,0,4,84,84,12,6380,262,21.36996271289927,70.7463115201532,0
Gujarat,Kheda,Kapadwanj,302,2,2,hab,2,0,3,299,300,12,2741,295,23.050066139336714,73.10394450182936,0
Gujarat,Kheda,Kathlal,220,5,5,hab,5,0,14,206,215,12,2831,295,22.944416051880058,73.00517513521571,0
Gujarat,Kheda,Kheda,70,0,0,hab,0,0,0,70,70,12,2991,295,22.77765044658014,72.62013488191869,0
Gujarat,Kheda,Mahemdavad,196,5,1,hab,1,0,2,194,195,12,3525,295,22.854678593769968,72.80509498847277,0
Gujarat,Kheda,Mahudha,106,8,1,hab,1,0,1,105,105,12,3545,295,22.812744482524238,72.9893945816553,0
Gujarat,Kheda,Matar,98,1,3,hab,3,0,7,91,95,12,3756,295,22.63105621483334,72.63879341953523,0
Gujarat,Kheda,Nadiad,193,4,2,hab,1,1,1,192,191,12,4049,295,22.690995038171245,72.87950220209535,0
Gujarat,Kheda,Thasra,236,1,1,hab,0,1,0,236,235,12,5999,295,22.814894397914408,73.22105949061816,0
Gujarat,Kutch,Abadasa,173,9,205,osm,148,57,147,26,-32,12,3,323,23.23893775412016,68.92418930189675,0
Gujarat,Kutch,Anjar,87,0,74,hab,61,13,73,14,13,12,197,323,23.145754784124332,70.02191524224796,0
Gujarat,Kutch,Bhachau,88,1,78,hab,48,30,47,41,10,12,747,323,23.43866008680463,70.41359523934267,0
Gujarat,Kutch,Bhuj,189,1,298,osm,181,117,149,40,-109,12,889,323,23.495640576202675,69.68335347607292,0
Gujarat,Kutch,Gandhidham,13,0,12,hab,6,6,7,6,1,12,1834,323,22.921544265707936,70.1195893867677,0
Gujarat,Kutch,Lakhpat,110,0,112,osm,76,36,80,30,-2,12,3348,323,23.621374945619483,68.79395304844095,0
Gujarat,Kutch,Mandvi,99,1,121,osm,93,28,95,4,-22,12,3657,323,22.974437458657388,69.31777959868505,0
Gujarat,Kutch,Mundra,65,0,74,osm,59,15,59,6,-9,12,3991,323,22.92212748808661,69.70807788974899,0
Gujarat,Kutch,Nakhatrana,140,2,144,osm,115,29,120,20,-4,12,4100,323,23.418642662237428,69.26368123139085,0
Gujarat,Kutch,Rapar,207,1,152,hab,122,30,116,91,55,12,5105,323,23.60968156758433,70.75375830205667,0
Gujarat,Mahisagar,Balasinor,167,0,0,hab,0,0,0,167,167,12,7698,683,23.016586495053797,73.34667240783149,0
Gujarat,Mahisagar,Kadana,306,4,1,hab,1,0,2,304,305,12,7699,683,23.31551416118844,73.79143030513501,0
Gujarat,Mahisagar,Khanpur,172,1,1,hab,1,0,2,170,171,12,7700,683,23.319144228626925,73.63081472468014,0
Gujarat,Mahisagar,Lunawada,461,3,3,hab,3,0,9,452,458,12,7701,683,23.108773313156977,73.57482398452868,0
Gujarat,Mahisagar,Santrampur,311,3,1,hab,0,1,0,311,310,12,7702,683,23.18409761266025,73.87395143314295,0
Gujarat,Mahisagar,Virpur,155,6,0,hab,0,0,0,155,155,12,7703,683,23.211110168407526,73.45919667505535,0
Gujarat,Mehsana,Becharaji,68,3,36,hab,35,1,38,30,32,12,679,363,23.546676860014024,72.10680555841901,0
Gujarat,Mehsana,Kadi,136,16,50,hab,45,5,43,93,86,12,2568,363,23.24107283206081,72.31639585455365,0
Gujarat,Mehsana,Kheralu,113,2,5,hab,5,0,6,107,108,12,2999,363,23.90727178878198,72.6297154954383,0
Gujarat,Mehsana,Mehsana,194,0,119,hab,87,32,116,78,75,12,3822,363,23.516732383391034,72.38529544892171,0
Gujarat,Mehsana,Satlasana,88,1,1,hab,1,0,2,86,87,12,5441,363,24.00987244523669,72.75207756345038,0
Gujarat,Mehsana,Unjha,60,1,7,hab,7,0,9,51,53,12,6222,363,23.809994629661944,72.40038688204005,0
Gujarat,Mehsana,Vadnagar,102,3,0,hab,0,0,0,102,102,12,6257,363,23.804216548519353,72.67448364238366,0
Gujarat,Mehsana,Vijapur,118,12,16,hab,16,0,17,101,102,12,6355,363,23.628839773651144,72.72332091309121,0
Gujarat,Mehsana,Visnagar,89,1,24,hab,21,3,23,66,65,12,6384,363,23.684744129629483,72.52005169030296,0
Gujarat,Morbi,Halvad,83,1,27,hab,26,1,30,53,56,12,7704,684,22.996462706943976,71.14243767474225,0
Gujarat,Morbi,Maliya Miyana,51,0,15,hab,14,1,14,37,36,12,7705,684,23.048424615392467,70.75961228688695,0
Gujarat,Morbi,Morbi,97,1,32,hab,32,0,37,60,65,12,7706,684,22.873244666229017,70.82557619618582,0
Gujarat,Morbi,Tankara,54,2,30,hab,27,3,27,27,24,12,7707,684,22.59951006100488,70.72178120798051,0
Gujarat,Morbi,Wankaner,122,0,47,hab,44,3,52,70,75,12,7708,684,22.59205942192391,70.9781442821629,0
Gujarat,Narmada,Dediapada,216,0,0,hab,0,0,0,216,216,12,1477,391,21.640921759942294,73.64551698729453,0
Gujarat,Narmada,Nandod,196,1,3,hab,3,0,3,193,193,12,4148,391,21.856610188568713,73.59535742532212,0
Gujarat,Narmada,Sagbara,110,0,1,hab,1,0,1,109,109,12,5246,391,21.496869407131292,73.80123538628469,0
Gujarat,Narmada,Tilakwada,121,2,2,hab,2,0,7,114,119,12,6083,391,21.994747301670884,73.60734233927195,0
Gujarat,Navsari,Chikhli,288,2,3,hab,3,0,6,282,285,12,1281,394,20.734037182626665,73.14098460355662,0
Gujarat,Navsari,Gandevi,247,1,3,hab,3,0,26,221,244,12,1831,394,20.80389639697757,72.9706664541303,0
Gujarat,Navsari,Jalalpor,184,4,10,hab,9,1,22,162,174,12,2384,394,20.95436038985196,72.85870220544498,0
Gujarat,Navsari,Navsari,139,0,1,hab,0,1,0,139,138,12,4239,394,20.94387108210205,73.00758227068192,0
Gujarat,Navsari,Vansda,570,0,1,hab,1,0,7,563,569,12,6283,394,20.72948818566005,73.33657702760718,0
Gujarat,Panchmahals,Ghoghamba,341,0,1,hab,1,0,5,336,340,12,1942,415,22.601503876148342,73.71306034934344,0
Gujarat,Panchmahals,Godhra.,622,2,1,hab,1,0,3,619,621,12,1965,415,22.79309411806611,73.59007397613189,0
Gujarat,Panchmahals,Halol,238,0,2,hab,0,2,0,238,236,12,2117,415,22.456246550923602,73.53634423442577,0
Gujarat,Panchmahals,Jambughoda,108,3,1,hab,1,0,4,104,107,12,2415,415,22.37342242488603,73.69894391414533,0
Gujarat,Panchmahals,Kalol,181,1,0,hab,0,0,0,181,181,12,2652,415,22.644511426578585,73.51541831155545,0
Gujarat,Panchmahals,Morva (Hadaf),303,2,1,hab,1,0,4,299,302,12,3931,415,22.963373502818435,73.83479066682557,0
Gujarat,Panchmahals,Shahera.,343,3,1,hab,1,0,1,342,342,12,5508,415,22.945187923244916,73.6189379230569,0
Gujarat,Patan,Chanasma,74,1,14,hab,13,1,14,60,60,12,1141,421,23.678074923167316,72.13589655435952,0
Gujarat,Patan,Harij,60,0,18,hab,18,0,28,32,42,12,2149,421,23.751533693655936,71.91678000405291,0
Gujarat,Patan,Patan,194,1,72,hab,66,6,67,127,122,12,4593,421,23.90316161995934,72.12894992166152,0
Gujarat,Patan,Radhanpur,91,1,15,hab,12,3,13,78,76,12,4908,421,23.831723497260406,71.57946143546461,0
Gujarat,Patan,Sami,138,10,25,hab,25,0,33,105,113,12,5325,421,23.610557429238323,71.70148325690606,0
Gujarat,Patan,Santalpur,104,2,3,hab,3,0,6,98,101,12,5380,421,23.79937133598169,71.29262704990795,0
Gujarat,Patan,Sidhpur,77,0,3,hab,3,0,3,74,74,12,5608,421,23.954803370219423,72.32513488203453,0
Gujarat,Porbandar,Kutiyana,57,3,8,hab,8,0,11,46,49,12,3312,433,21.621964683011203,69.97220649988998,0
Gujarat,Porbandar,Porbandar,80,0,26,hab,23,3,23,57,54,12,4812,433,21.663693361898844,69.67264395753016,0
Gujarat,Porbandar,Ranavav,76,5,2,hab,2,0,3,73,74,12,5078,433,21.67601820982352,69.78559397161185,0
Gujarat,Rajkot,Dhoraji,31,0,0,hab,0,0,0,31,31,12,1615,451,21.702002379647606,70.38231499460437,0
Gujarat,Rajkot,Gondal,81,0,4,hab,3,1,4,77,77,12,1993,451,21.923579348452165,70.80950413012086,0
Gujarat,Rajkot,Jamkandorana,51,0,1,hab,1,0,1,50,50,12,2419,451,21.928335241698587,70.44476460172488,0
Gujarat,Rajkot,Jasdan,100,0,2,hab,2,0,2,98,98,12,2449,451,22.087350596479357,71.23678770683567,0
Gujarat,Rajkot,Jetpur,48,0,2,hab,2,0,2,46,46,12,2479,451,21.757838076713025,70.64791786757054,0
Gujarat,Rajkot,Kotda Sangani,42,0,3,hab,3,0,2,40,39,12,3158,451,22.05133255625849,70.84051688295835,0
Gujarat,Rajkot,Lodhika,41,2,1,hab,1,0,1,40,40,12,3423,451,22.196794534235416,70.65793588193777,0
Gujarat,Rajkot,Paddhari,86,0,8,hab,8,0,11,75,78,12,4414,451,22.404804213939382,70.59321390466357,0
Gujarat,Rajkot,Rajkot,86,1,15,hab,10,5,12,74,71,12,4985,451,22.274735209336903,70.9002400328896,0
Gujarat,Rajkot,Upleta,57,1,1,hab,0,1,0,57,56,12,6223,451,21.804514386139562,70.21907219013252,0
Gujarat,Sabarkantha,Himatnagar,233,1,6,hab,6,0,4,229,227,12,2213,472,23.61218224412302,73.00684742359432,0
Gujarat,Sabarkantha,Idar,213,1,1,hab,1,0,1,212,212,12,2279,472,23.811110083888604,72.98389852012012,0
Gujarat,Sabarkantha,Khedbrahma,198,4,2,hab,2,0,4,194,196,12,2992,472,24.205861136883378,73.05425379205373,0
Gujarat,Sabarkantha,Prantij,91,0,2,hab,1,1,1,90,89,12,4823,472,23.444305323043903,72.89039733039,0
Gujarat,Sabarkantha,Talod,150,2,7,hab,6,1,8,142,143,12,5877,472,23.36899582994103,73.01576772040612,0
Gujarat,Sabarkantha,Vadali,121,2,2,hab,2,0,2,119,119,12,6251,472,23.948749089338893,72.98943100189246,0
Gujarat,Sabarkantha,Vijaynagar,105,3,2,hab,2,0,6,99,103,12,6359,472,23.96993550902963,73.28607585529322,0
Gujarat,Surat,Bardoli,111,2,1,hab,1,0,1,110,110,12,581,533,21.135527447555017,73.16084778693158,0
Gujarat,Surat,Choryasi,75,0,4,hab,4,0,8,67,71,12,1353,533,21.15531543217478,72.79772246833873,0
Gujarat,Surat,Kamrej,120,0,6,hab,5,1,12,108,114,12,2687,533,21.258784401789235,73.00510475194652,0
Gujarat,Surat,Mahuwa,212,2,1,hab,1,0,3,209,211,12,3548,533,20.94655618666743,73.19015693800729,0
Gujarat,Surat,Mandvi,338,3,6,hab,6,0,11,327,332,12,3656,533,21.323308339592206,73.26182591143431,0
Gujarat,Surat,Mangrol,122,0,7,hab,6,1,5,117,115,12,3672,533,21.44363002023611,73.11592786780051,0
Gujarat,Surat,Olpad,152,0,7,hab,7,0,9,143,145,12,4384,533,21.346345440317013,72.75454463857427,0
Gujarat,Surat,Palsana,57,1,1,hab,0,1,0,57,56,12,4481,533,21.11517118725448,73.00454997175649,0
Gujarat,Surat,Umarpada,92,2,2,hab,2,0,4,88,90,12,6203,533,21.443166302010585,73.51438938867702,0
Gujarat,Surendranagar,Chotila,122,2,5,hab,4,1,4,118,117,12,1354,534,22.409556384613456,71.18025783598308,0
Gujarat,Surendranagar,Chuda,38,1,8,hab,8,0,7,31,30,12,1360,534,22.451788753529502,71.73829748048892,0
Gujarat,Surendranagar,Dasada     Patadi,95,1,43,hab,42,1,44,51,52,12,1455,534,23.250627831519832,71.78036873746017,0
Gujarat,Surendranagar,Dhrangadhra,66,0,23,hab,23,0,22,44,43,12,1617,534,22.975571875580183,71.47490164621334,0
Gujarat,Surendranagar,Lakhtar,43,0,13,hab,12,1,12,31,30,12,3349,534,22.88730087995884,71.8430199341295,0
Gujarat,Surendranagar,Limbdi,60,0,6,hab,6,0,6,54,54,12,3411,534,22.625409963780797,71.944878691051,0
Gujarat,Surendranagar,Muli,59,3,22,hab,19,3,20,39,37,12,3974,534,22.705965342828666,71.355259675278,0
Gujarat,Surendranagar,Sayla,85,0,3,hab,3,0,2,83,82,12,5458,534,22.43187361199141,71.42058032593582,0
Gujarat,Surendranagar,Wadhwan,45,0,5,hab,4,1,4,41,40,12,6400,534,22.696983596197988,71.63625554243227,0
Gujarat,Tapi,Nizar,207,0,13,hab,12,1,72,135,194,12,4331,537,21.494992968234538,74.11049075204554,0
Gujarat,Tapi,Songadh,230,1,1,hab,0,1,0,230,229,12,5732,537,21.1925239462659,73.6000007013611,0
Gujarat,Tapi,Uchchhal,183,5,3,hab,3,0,16,167,180,12,6163,537,21.28061119713464,73.78604980256432,0
Gujarat,Tapi,Valod,295,3,2,hab,2,0,27,268,293,12,6276,537,21.057681981787976,73.27329114836854,0
Gujarat,Tapi,Vyara,741,5,0,hab,0,0,0,741,741,12,6393,537,21.009731568180612,73.4013743620682,0
Gujarat,Vadodara,Dabhoi,153,0,6,hab,5,1,6,147,147,12,1383,574,22.119754439495072,73.38262599644446,0
Gujarat,Vadodara,Karjan,96,0,6,hab,6,0,6,90,90,12,2782,574,21.988618725918165,73.12754332761963,0
Gujarat,Vadodara,Padra,107,1,0,hab,0,0,0,107,107,12,4420,574,22.18731291710697,72.99291827698585,0
Gujarat,Vadodara,Savli,279,0,4,hab,4,0,8,271,275,12,5455,574,22.58563952600437,73.28145670571524,0
Gujarat,Vadodara,Sinor,43,0,1,hab,1,0,1,42,42,12,5663,574,21.976108204308066,73.33561063574005,0
Gujarat,Vadodara,Vadodara,127,0,3,hab,2,1,2,125,124,12,6258,574,22.283957908116108,73.17694205065982,0
Gujarat,Vadodara,Waghodia,179,0,3,hab,2,1,3,176,176,12,6404,574,22.344422639000438,73.39168854665255,0
Gujarat,Valsad,Dharampur,698,2,2,hab,0,2,0,698,696,12,1574,576,20.509539291166895,73.30226934629412,0
Gujarat,Valsad,Kaparada,897,3,2,hab,2,0,17,880,895,12,2742,576,20.297893214954893,73.22670608121284,0
Gujarat,Valsad,Pardi,534,4,3,hab,2,1,24,510,531,12,4563,576,20.425181987913913,72.97606122988978,0
Gujarat,Valsad,Umbergam,620,18,5,hab,5,0,63,557,615,12,6204,576,20.261544332471637,72.83757583621646,0
Gujarat,Valsad,Valsad,407,2,7,hab,7,0,29,378,400,12,6277,576,20.612563873810995,72.98973711529062,0
Haryana,Ambala,Ambala,109,1,58,hab,54,4,51,58,51,13,129,14,30.24725356681427,76.71881201060178,0
Haryana,Ambala,Ambala II,63,8,25,hab,25,0,28,35,38,13,7440,14,30.366676461627783,76.82901371019244,0
Haryana,Ambala,Barara,73,0,5,hab,5,0,7,66,68,13,569,14,30.22808958287583,77.05668816959202,0
Haryana,Ambala,Naraingarh,97,4,0,hab,0,0,0,97,97,13,4160,14,30.4355429462529,77.1228521310516,0
Haryana,Ambala,Saha,64,6,11,hab,10,1,10,54,53,13,7441,14,30.293562264514986,76.97119985201977,0
Haryana,Ambala,Shahzadpur,78,15,5,hab,5,0,6,72,73,13,5524,14,30.438284492544078,77.00608507578076,0
Haryana,Bhiwani,Bawani Khera,32,1,14,hab,12,2,12,20,18,13,671,74,28.95425040304352,76.00949250075796,0
Haryana,Bhiwani,Behal,33,2,3,hab,3,0,3,30,30,13,7442,74,28.634677486656404,75.68511084242662,0
Haryana,Bhiwani,Bhiwani,61,6,36,hab,33,3,36,25,25,13,867,74,28.818236048373613,76.14815451930465,0
Haryana,Bhiwani,Kairu,32,0,16,hab,15,1,17,15,16,13,2586,74,28.69384798855791,75.90870703128405,0
Haryana,Bhiwani,Loharu,46,1,8,hab,6,2,6,40,38,13,3429,74,28.519860318202383,75.80696645245906,0
Haryana,Bhiwani,Siwani,40,0,6,hab,6,0,7,33,34,13,5701,74,28.82955330946803,75.60061059009853,0
Haryana,Bhiwani,Tosham,45,5,9,hab,8,1,7,38,36,13,6132,74,28.823227769180377,75.8350510600407,0
Haryana,Charkhi Dadri,Badhra,70,1,23,hab,20,3,22,48,47,13,7156,643,28.522396998657527,75.98421260032688,0
Haryana,Charkhi Dadri,Dadri-I,49,0,36,hab,35,1,37,12,13,13,7157,643,28.65684328961128,76.32705510613927,0
Haryana,Charkhi Dadri,Dadri-II,54,5,39,hab,38,1,39,15,15,13,7158,643,28.558297763308165,76.17578309604984,0
Haryana,Faridabad,Ballabgarh,80,3,57,hab,45,12,25,55,23,13,466,177,28.282837747602194,77.39492387698681,0
Haryana,Faridabad,Faridabad,67,3,73,osm,40,33,24,43,-6,13,1761,177,28.40272263952713,77.31068699486379,0
Haryana,Fatehabad,Bhattu Kalan,23,3,2,hab,1,1,1,22,21,13,825,180,29.391595917767866,75.35894667272925,0
Haryana,Fatehabad,Bhuna,27,1,34,osm,26,8,25,2,-7,13,890,180,29.53169876788007,75.70622886282176,0
Haryana,Fatehabad,Fatehabad,47,8,23,hab,17,6,17,30,24,13,1767,180,29.519577932987033,75.46390101326294,0
Haryana,Fatehabad,Jakhal,26,8,1,hab,1,0,1,25,25,13,7443,180,29.75082830644346,75.75146413602153,0
Haryana,Fatehabad,Ratia,67,6,41,hab,32,9,32,35,26,13,5118,180,29.689691050641407,75.5230202650491,0
Haryana,Fatehabad,Tohana,52,1,41,hab,37,4,38,14,11,13,6124,180,29.66110173156457,75.84883997359982,0
Haryana,Gurgaon,Farukh Nagar,56,3,9,hab,8,1,8,48,47,13,1766,208,28.4267101475039,76.82628763574374,0
Haryana,Gurgaon,Gurgaon,70,11,12,hab,11,1,11,59,58,13,2081,208,28.44071223000512,76.99761674432656,0
Haryana,Gurgaon,Pataudi,80,1,40,hab,35,5,37,43,40,13,4601,208,28.307017947389173,76.78210481956972,0
Haryana,Gurgaon,Sohna,71,14,38,hab,30,8,23,48,33,13,5712,208,28.327398692504183,77.10307311967748,0
Haryana,Hisar,Adampur,25,0,12,hab,9,3,8,17,13,13,15,222,29.260077966291057,75.46723470523027,0
Haryana,Hisar,Agroha,23,4,15,hab,15,0,15,8,8,13,35,222,29.346623547403965,75.66271602178391,0
Haryana,Hisar,Barwala,41,0,31,hab,29,2,29,12,10,13,630,222,29.36364257558359,75.91848993626684,0
Haryana,Hisar,Hansi I,60,4,7,hab,7,0,7,53,53,13,2124,222,29.149446546442604,75.97331162159703,0
Haryana,Hisar,Hansi-II,23,3,0,hab,0,0,0,23,23,13,2125,222,29.118618545283045,76.21439742162039,0
Haryana,Hisar,Hisar I,49,3,6,hab,6,0,7,42,43,13,2230,222,29.0736946395783,75.78062159874094,0
Haryana,Hisar,Hisar-II,42,1,15,hab,11,4,11,31,27,13,2231,222,29.127929947981556,75.59105754665632,0
Haryana,Hisar,Narnaund,34,2,2,hab,2,0,4,30,32,13,4196,222,29.275244607277056,76.12724388728668,0
Haryana,Hisar,Uklana,28,3,21,hab,19,2,22,6,7,13,6193,222,29.485197470869576,75.87082470081248,0
Haryana,Jhajjar,Bahadurgarh,63,1,10,hab,9,1,10,53,53,13,397,254,28.69428180200535,76.83943987246997,0
Haryana,Jhajjar,Beri,34,0,6,hab,6,0,8,26,28,13,725,254,28.708580047279447,76.55418520540076,0
Haryana,Jhajjar,Jhajjar,86,2,2,hab,2,0,2,84,84,13,2488,254,28.55672288076418,76.68402167440952,0
Haryana,Jhajjar,Matenhail,43,0,18,hab,18,0,20,23,25,13,3758,254,28.53093663779755,76.42773131294146,0
Haryana,Jhajjar,Sahlawas,40,3,1,hab,1,0,1,39,39,13,5263,254,28.47968202414453,76.55134561146387,0
Haryana,Jind,Alewa,21,0,6,hab,6,0,6,15,15,13,82,259,29.487825238405403,76.3939341171712,0
Haryana,Jind,Jind,67,3,1,hab,1,0,1,66,66,13,2508,259,29.32714233342291,76.33871766953853,0
Haryana,Jind,Julana,39,1,3,hab,3,0,3,36,36,13,2537,259,29.1738283858843,76.3811643697312,0
Haryana,Jind,Narwana,60,0,47,hab,46,1,46,14,13,13,4212,259,29.658672410294724,76.0773769598425,0
Haryana,Jind,Pillukhera,24,0,8,hab,7,1,7,17,16,13,4753,259,29.32907309718241,76.52157658093671,0
Haryana,Jind,Safidon,46,1,3,hab,2,1,2,44,43,13,5239,259,29.409355846862947,76.61971946511625,0
Haryana,Jind,Uchana Kalan,48,1,14,hab,13,1,13,35,34,13,6162,259,29.48865875856253,76.18210992012754,0
Haryana,Kaithal,Guhla,106,19,38,hab,36,2,41,65,68,13,2057,264,30.055832897832996,76.33519850759562,0
Haryana,Kaithal,Kaithal,63,5,57,hab,45,12,41,22,6,13,2588,264,29.79526183719581,76.40903683306901,0
Haryana,Kaithal,Kalayat,31,2,16,hab,15,1,15,16,15,13,2621,264,29.674962716171446,76.2916333116514,0
Haryana,Kaithal,Pundri,52,5,10,hab,7,3,8,44,42,13,4855,264,29.779322284879644,76.61795533455174,0
Haryana,Kaithal,Rajound,28,1,6,hab,6,0,7,21,22,13,4994,264,29.60701540935997,76.46083373093316,0
Haryana,Kaithal,Siwan,37,1,37,osm,23,14,23,14,0,13,7444,264,29.914436261754854,76.33160911499841,0
Haryana,Karnal,Assandh,49,4,2,hab,1,1,1,48,47,13,273,281,29.54909616972155,76.67707633346772,0
Haryana,Karnal,Gharaunda,62,6,9,hab,7,2,6,56,53,13,1920,281,29.53525517123331,76.9951210771684,0
Haryana,Karnal,Indri,110,1,2,hab,2,0,2,108,108,13,2298,281,29.88352812880146,77.09395498820543,0
Haryana,Karnal,Karnal,86,5,70,hab,63,7,61,25,16,13,2790,281,29.70878220798858,77.03303580687445,0
Haryana,Karnal,Nilo Kheri,83,1,4,hab,4,0,4,79,79,13,4306,281,29.83401117354536,76.86328975267861,0
Haryana,Karnal,Nissing,50,1,7,hab,6,1,6,44,43,13,4320,281,29.6844919360825,76.8072901899735,0
Haryana,Kurukshetra,Babain,50,3,3,hab,3,0,4,46,47,13,338,320,30.08900247810776,76.99608614025595,0
Haryana,Kurukshetra,Ismailabad,62,9,3,hab,3,0,3,59,59,13,7445,320,30.115559620122927,76.70931013221775,0
Haryana,Kurukshetra,Ladwa,63,10,39,hab,37,2,38,25,24,13,3324,320,30.001687328648412,77.03538068643346,0
Haryana,Kurukshetra,Pehowa,63,1,1,hab,1,0,2,61,62,13,4685,320,29.99378597409328,76.56250879168863,0
Haryana,Kurukshetra,Shahbad,70,3,6,hab,5,1,5,65,64,13,5506,320,30.15039149059156,76.8670312483899,0
Haryana,Kurukshetra,Thanesar,112,8,60,hab,50,10,56,56,52,13,5991,320,29.98404718541594,76.82227854757691,0
Haryana,Mewat,Firozepur Jhirkha,84,4,6,hab,5,1,6,78,78,13,7162,645,27.777283668179926,76.99253350847856,0
Haryana,Mewat,Nagina,67,5,12,hab,11,1,13,54,55,13,7163,645,27.929415000064296,77.02473858171435,0
Haryana,Mewat,Nuh,107,3,11,hab,4,7,4,103,96,13,7164,645,28.113633168865846,77.07970736203707,0
Haryana,Mewat,Punhana,90,4,11,hab,10,1,12,78,79,13,7165,645,27.86894134650375,77.19972699643343,0
Haryana,Mewat,Taoru,79,1,9,hab,8,1,9,70,70,13,7166,645,28.244641783277604,76.96231240230932,0
Haryana,Mohindergarh,Ateli Nangal,53,2,44,hab,41,3,45,8,9,13,280,366,28.099393419347454,76.24849989837168,0
Haryana,Mohindergarh,Kanina,54,1,51,hab,47,4,46,8,3,13,2719,366,28.31903685514662,76.26329888188408,0
Haryana,Mohindergarh,Mohindergarh,60,5,52,hab,46,6,51,9,8,13,3896,366,28.300707796436036,76.12889461967889,0
Haryana,Mohindergarh,Nangal Chaudhary,68,1,45,hab,41,4,40,28,23,13,4152,366,27.913388970148386,76.12548531642757,0
Haryana,Mohindergarh,Narnaul,47,1,3,hab,2,1,3,44,44,13,4195,366,28.07358787358697,76.05176191094348,0
Haryana,Mohindergarh,Nizampur,21,0,0,hab,0,0,0,21,21,13,7446,366,27.933387064645025,76.00668127839005,0
Haryana,Mohindergarh,Satnali,25,0,24,hab,20,4,21,4,1,13,7447,366,28.354230370101206,76.00871298917184,0
Haryana,Mohindergarh,Sihma,41,6,35,hab,33,2,33,8,6,13,7448,366,28.150131048587326,76.17523969393484,0
Haryana,Palwal,Hassanpur,37,5,37,osm,25,12,22,15,0,13,7159,644,28.016434071873057,77.46813413064407,0
Haryana,Palwal,Hathin,84,6,42,hab,37,5,33,51,42,13,7160,644,28.02008803569808,77.23682712182706,0
Haryana,Palwal,Hodal,39,3,31,hab,27,4,28,11,8,13,7439,644,27.959843433733372,77.38178644836219,0
Haryana,Palwal,Palwal,71,18,30,hab,28,2,28,43,41,13,7161,644,28.143463341712007,77.3657029531077,0
Haryana,Palwal,Prithla,46,12,36,osm,30,6,18,28,10,13,7452,644,28.21287269668254,77.32471141302446,0
Haryana,Panchkula,Barwala,54,5,33,hab,27,6,31,23,21,13,629,414,30.643093360235667,76.95741333294193,0
Haryana,Panchkula,Morni,14,2,8,hab,3,5,2,12,6,13,3927,414,30.66738792064644,77.08367402355096,0
Haryana,Panchkula,Pinjore,132,8,14,hab,12,2,14,118,118,13,4759,414,30.801037683470277,76.89316444602743,0
Haryana,Panchkula,Raipur Rani,44,0,2,hab,1,1,1,43,42,13,4949,414,30.53411127323808,77.00823358890742,0
Haryana,Panipat,Bapauli,25,0,11,hab,8,3,6,19,14,13,550,416,29.29477452756059,77.08126984840959,0
Haryana,Panipat,Israna,31,0,2,hab,1,1,1,30,29,13,2316,416,29.282705872935505,76.82746280388659,0
Haryana,Panipat,Madlauda,36,0,18,hab,14,4,13,23,18,13,3493,416,29.396097103050906,76.81405724618662,0
Haryana,Panipat,Panipat,43,13,8,hab,7,1,8,35,35,13,4519,416,29.39276305953036,76.98063911975338,0
Haryana,Panipat,Samalkha,34,6,3,hab,3,0,3,31,31,13,5313,416,29.229243883403463,77.02677838705056,0
Haryana,Panipat,Sanoli Khurd,18,0,12,hab,10,2,11,7,6,13,7450,416,29.40440210823303,77.0962539357232,0
Haryana,Rewari,  Bawal,102,2,90,hab,85,5,91,11,12,13,1,464,28.081539177803883,76.59318108092184,0
Haryana,Rewari,Jatusana,70,5,17,hab,17,0,20,50,53,13,2463,464,28.32477457544319,76.5303599041116,0
Haryana,Rewari,Khol At Rewari,62,2,6,hab,6,0,7,55,56,13,3012,464,28.207237874319386,76.43109841972898,0
Haryana,Rewari,Nahar,47,0,20,hab,20,0,21,26,27,13,4087,464,28.396361297835227,76.44698446085083,0
Haryana,Rewari,Rewari,116,2,65,hab,60,5,75,41,51,13,5166,464,28.21264040573219,76.66845405973523,0
Haryana,Rohtak,Kalanaur,27,2,8,hab,8,0,10,17,19,13,2614,466,28.807978427887253,76.44952096737897,0
Haryana,Rohtak,Lakhan Majra,13,2,1,hab,1,0,1,12,12,13,3335,466,29.03252774595315,76.49564923170223,0
Haryana,Rohtak,Meham,25,0,4,hab,3,1,4,21,21,13,3814,466,28.96301080766859,76.34446245817833,0
Haryana,Rohtak,Rohtak,55,6,16,hab,16,0,17,38,39,13,5184,466,28.919309406743057,76.60845907820719,0
Haryana,Rohtak,Sampla,24,2,5,hab,4,1,5,19,19,13,5327,466,28.831486655314883,76.75007199266135,0
Haryana,Sirsa,Baragudha,49,6,3,hab,2,1,2,47,46,13,558,511,29.706106436939137,75.0602500408589,0
Haryana,Sirsa,Dabwali,51,1,4,hab,4,0,4,47,47,13,1386,511,29.82633732186468,74.68929361163853,0
Haryana,Sirsa,Ellenabad,38,2,17,hab,16,1,15,23,21,13,1740,511,29.44717068487581,74.72139427139146,0
Haryana,Sirsa,Nathusari Chopta,57,2,1,hab,1,0,1,56,56,13,4224,511,29.369821921968857,75.11560313375281,0
Haryana,Sirsa,Odhan,41,0,4,hab,4,0,4,37,37,13,4377,511,29.816583470950395,74.92701624050383,0
Haryana,Sirsa,Rania,50,10,11,hab,11,0,11,39,39,13,5090,511,29.589494650853712,74.76560029273804,0
Haryana,Sirsa,Sirsa,57,3,13,hab,12,1,13,44,44,13,5680,511,29.544845211287,75.07920556582347,0
Haryana,Sonepat,Ganaur,47,7,2,hab,0,2,0,47,45,13,1826,519,29.144652169815753,76.952064694106,0
Haryana,Sonepat,Gohana,34,0,4,hab,3,1,4,30,30,13,1974,519,29.083617353803618,76.74964251090054,0
Haryana,Sonepat,Kathura,17,3,2,hab,2,0,2,15,15,13,2835,519,29.127354090475595,76.56833876577568,0
Haryana,Sonepat,Kharkhauda,40,8,4,hab,4,0,4,36,36,13,2975,519,28.909188429581736,76.89476259764794,0
Haryana,Sonepat,Mudlana,29,2,7,hab,6,1,8,21,22,13,3954,519,29.21575726173509,76.67424275802072,0
Haryana,Sonepat,Murthal,46,4,7,hab,5,2,6,40,39,13,7451,519,29.056525848445357,77.11227193993884,0
Haryana,Sonepat,Rai,54,4,17,hab,15,2,16,38,37,13,4931,519,28.905253614883538,77.10086915026305,0
Haryana,Sonepat,Sonepat,56,7,14,hab,13,1,13,43,42,13,5730,519,29.022165491098324,76.93975692786535,0
Haryana,Yamuna Nagar,Bilaspur,131,25,4,hab,4,0,8,123,127,13,944,599,30.345072064099014,77.30167247381168,0
Haryana,Yamuna Nagar,Chhachhrauli,171,5,7,hab,3,4,4,167,164,13,1250,599,30.288505193041285,77.44055844891635,0
Haryana,Yamuna Nagar,Jagadhri,113,16,42,hab,37,5,44,69,71,13,2330,599,30.12157883614997,77.28769460741185,0
Haryana,Yamuna Nagar,Mustafabad,83,5,0,hab,0,0,0,83,83,13,4023,599,30.209926919202914,77.17141905524777,0
Haryana,Yamuna Nagar,Radaur,85,2,3,hab,3,0,2,83,82,13,4906,599,30.039868409363404,77.16862821074427,0
Haryana,Yamuna Nagar,Sadhaura,65,5,0,hab,0,0,0,65,65,13,5235,599,30.41004701890722,77.22642682798038,0
Himachal Pradesh,Bilaspur,Bilaspur Sadar,298,0,13,hab,13,0,39,259,285,14,945,83,31.31792964077244,76.81672949055914,0
Himachal Pradesh,Bilaspur,Gehrwin,330,0,4,hab,4,0,16,314,326,14,1904,83,31.375380769884615,76.62557396793376,0
Himachal Pradesh,Bilaspur,Ghumarwin,298,0,3,hab,3,0,6,292,295,14,1950,83,31.497259221220617,76.7068646838531,0
Himachal Pradesh,Bilaspur,Shri Naina Devi Jee,153,0,1,hab,1,0,3,150,152,14,8002,83,31.310921381599464,76.55113376786171,0
Himachal Pradesh,Chamba,Bharmour,238,0,312,osm,283,29,232,6,-74,14,811,99,32.416242038193836,76.5915621104468,0
Himachal Pradesh,Chamba,Bhattiyat,331,0,739,osm,586,153,197,134,-408,14,824,99,32.42501659387902,76.02900336918512,0
Himachal Pradesh,Chamba,Chamba,123,0,721,osm,554,167,123,0,-598,14,1131,99,32.62036087621212,76.14158060753411,0
Himachal Pradesh,Chamba,Mehla,179,0,854,osm,677,177,178,1,-675,14,3820,99,32.49498028583188,76.26054107476709,0
Himachal Pradesh,Chamba,Pangi,63,0,148,osm,132,16,61,2,-85,14,4516,99,33.013845560556945,76.52750684300747,0
Himachal Pradesh,Chamba,Salooni,228,0,536,osm,402,134,178,50,-308,14,5306,99,32.7613991898964,75.96117723574173,0
Himachal Pradesh,Chamba,Tissa,197,0,748,osm,562,186,191,6,-551,14,6114,99,32.823061311542816,76.22056809253145,0
Himachal Pradesh,Hamirpur,Bhoranj,229,0,3,hab,3,0,12,217,226,14,884,211,31.619097905687187,76.64981533905575,0
Himachal Pradesh,Hamirpur,Bijhri,342,0,2,hab,1,1,2,340,340,14,931,211,31.5318316035913,76.52875378223635,0
Himachal Pradesh,Hamirpur,Hamirpur,198,1,0,hab,0,0,0,198,198,14,2120,211,31.688237838852864,76.50294645772163,0
Himachal Pradesh,Hamirpur,Nadaun,448,0,1,hab,1,0,3,445,447,14,4046,211,31.701712914751145,76.40331190241169,0
Himachal Pradesh,Hamirpur,Tauni Devi,253,0,1,hab,1,0,2,251,252,14,5935,211,31.742008306096615,76.6058713452616,0
Himachal Pradesh,Hamirpur,Tihra Sujanpur,173,0,0,hab,0,0,0,173,173,14,6076,211,31.797287103437533,76.52812873894887,0
Himachal Pradesh,Kangra,Baijnath,186,0,185,hab,174,11,156,30,1,14,414,268,32.22138803022123,76.84559199673147,0
Himachal Pradesh,Kangra,Dehra Gopipur,507,0,6,hab,6,0,17,490,501,14,1487,268,31.904809078862055,76.27775216791042,0
Himachal Pradesh,Kangra,Dharamshala,85,0,118,osm,89,29,81,4,-33,14,8000,268,32.22585710219515,76.37451212656306,0
Himachal Pradesh,Kangra,Fatehpur,343,0,3,hab,3,0,9,334,340,14,1774,268,32.08203483194341,75.90178638985195,0
Himachal Pradesh,Kangra,Indora,175,0,5,hab,5,0,8,167,170,14,2295,268,32.16290279226017,75.7381868089669,0
Himachal Pradesh,Kangra,Kangra,243,0,104,hab,102,2,124,119,139,14,2714,268,32.06446745030115,76.25312145122551,0
Himachal Pradesh,Kangra,Lamba Gaon,216,0,11,hab,10,1,17,199,205,14,3368,268,31.91654638975152,76.54974078692038,0
Himachal Pradesh,Kangra,Nagrota Bagwan,249,0,176,hab,170,6,208,41,73,14,4082,268,32.060437062108605,76.36269469645319,0
Himachal Pradesh,Kangra,Nagrota Surian,188,0,25,hab,20,5,28,160,163,14,4083,268,32.13329735625533,76.07013827864219,0
Himachal Pradesh,Kangra,Nurpur,259,0,24,hab,13,11,19,240,235,14,4358,268,32.30332190831656,75.89905157360779,0
Himachal Pradesh,Kangra,Panchrukhi,147,0,148,osm,138,10,120,27,-1,14,4501,268,32.034183010346084,76.58880011700307,0
Himachal Pradesh,Kangra,Pragpur,267,0,13,hab,12,1,25,242,254,14,4821,268,31.85987765401636,76.11989515555263,0
Himachal Pradesh,Kangra,Rait,266,0,125,hab,100,25,137,129,141,14,4955,268,32.24345375069359,76.21792490714185,0
Himachal Pradesh,Kinnaur,Kalpa,71,0,113,osm,71,42,65,6,-42,14,2653,297,31.362519997031463,78.49164595439711,0
Himachal Pradesh,Kinnaur,Nichar,90,0,64,hab,53,11,58,32,26,14,4289,297,31.603225375695345,77.98392481085772,0
Himachal Pradesh,Kinnaur,Pooh,99,0,133,osm,90,43,80,19,-34,14,4807,297,31.714348704995952,78.50971454613278,0
Himachal Pradesh,Kullu,Anni,391,0,494,osm,486,8,391,0,-103,14,204,317,31.459563476399637,77.42352516320913,0
Himachal Pradesh,Kullu,Banjar,77,0,334,osm,197,137,74,3,-257,14,517,317,31.71779046442294,77.48595442553595,0
Himachal Pradesh,Kullu,Kullu,140,0,268,osm,143,125,91,49,-128,14,3239,317,31.969826525324795,77.43621923804999,0
Himachal Pradesh,Kullu,Naggar,184,0,229,osm,203,26,161,23,-45,14,4072,317,32.1923581148991,77.17841309975668,0
Himachal Pradesh,Kullu,Nirmand,163,0,445,osm,427,18,162,1,-282,14,4316,317,31.50461189952014,77.58523813692292,0
Himachal Pradesh,Lahul And Spiti,Lahaul,195,0,170,hab,145,25,150,45,25,14,3327,324,32.64568024362107,77.14601953982293,0
Himachal Pradesh,Lahul And Spiti,Spiti,97,0,68,hab,60,8,73,24,29,14,5756,324,32.327224687276825,78.05475647759044,0
Himachal Pradesh,Mandi,Balh,199,0,177,hab,170,7,189,10,22,14,450,353,31.593500673162573,76.91138901079965,0
Himachal Pradesh,Mandi,Chachiot,233,0,462,osm,419,43,226,7,-229,14,1096,353,31.53172227012071,77.0819178998753,0
Himachal Pradesh,Mandi,Chauntra,272,0,169,hab,162,7,168,104,103,14,1204,353,31.9438504773077,76.74828103054017,0
Himachal Pradesh,Mandi,Dharampur,241,0,80,hab,74,6,70,171,161,14,1573,353,31.79089687849096,76.71476384439293,0
Himachal Pradesh,Mandi,Drang,272,0,452,osm,429,23,263,9,-180,14,1676,353,31.92663477841529,76.90584031594825,0
Himachal Pradesh,Mandi,Gopalpur,343,1,162,hab,159,3,261,82,181,14,2007,353,31.63108651543821,76.77724036394221,0
Himachal Pradesh,Mandi,Karsog,536,0,948,osm,895,53,535,1,-412,14,2795,353,31.347005239123998,77.19737481296214,0
Himachal Pradesh,Mandi,Seraj,124,0,407,osm,328,79,121,3,-283,14,5491,353,31.53080439427594,77.21942487489221,0
Himachal Pradesh,Mandi,Sunder Nagar,247,0,503,osm,447,56,246,1,-256,14,5808,353,31.436053417607283,76.93274096380787,0
Himachal Pradesh,Shimla,Basantpur,231,0,374,osm,342,32,226,5,-143,14,635,497,31.214448188238567,77.18809863900297,0
Himachal Pradesh,Shimla,Chauhara,124,0,106,hab,89,17,71,53,18,14,1201,497,31.281023132597017,78.01112767525832,0
Himachal Pradesh,Shimla,Jubbal and Kothai,304,0,525,osm,482,43,300,4,-221,14,2533,497,31.10982459175986,77.6630933120462,0
Himachal Pradesh,Shimla,Mashobra,533,0,531,hab,499,32,511,22,2,14,3751,497,31.078700920141788,77.17434145866746,0
Himachal Pradesh,Shimla,Nankhari,79,0,209,osm,189,20,75,4,-130,14,7998,497,31.306429204618976,77.58534059451038,0
Himachal Pradesh,Shimla,Narkanda,171,0,335,osm,319,16,168,3,-164,14,4187,497,31.293005734156644,77.43378307357897,0
Himachal Pradesh,Shimla,Rampur,162,0,293,osm,248,45,118,44,-131,14,5061,497,31.487636276289802,77.75628028580833,0
Himachal Pradesh,Shimla,Rohru,166,0,263,osm,225,38,159,7,-97,14,5183,497,31.217888534723553,77.69314158125044,0
Himachal Pradesh,Shimla,Theog,397,0,757,osm,715,42,396,1,-360,14,6008,497,31.11296707059247,77.38486480326239,0
Himachal Pradesh,Sirmaur,Nahan,219,0,2,hab,2,0,2,217,217,14,4086,509,30.577638738989723,77.29976337639664,0
Himachal Pradesh,Sirmaur,Pachhad,262,0,36,hab,29,7,19,243,226,14,4406,509,30.76122482421261,77.19610285624992,0
Himachal Pradesh,Sirmaur,Paonta Sahib,212,0,372,osm,270,102,118,94,-160,14,4534,509,30.52616315322363,77.59803251769546,0
Himachal Pradesh,Sirmaur,Rajgarh,141,0,375,osm,310,65,130,11,-234,14,4980,509,30.890460295435997,77.3390369273417,0
Himachal Pradesh,Sirmaur,Sangrah,123,0,355,osm,241,114,75,48,-232,14,5357,509,30.725082931912404,77.46986337285254,0
Himachal Pradesh,Sirmaur,Shillai,56,0,332,osm,231,101,56,0,-276,14,5568,509,30.70867964215471,77.66213955336107,0
Himachal Pradesh,Solan,Dharampur,351,0,4,hab,3,1,9,342,347,14,1575,516,30.928535590273583,76.94843738631185,0
Himachal Pradesh,Solan,Kandaghat,271,0,115,hab,114,1,152,119,156,14,2699,516,30.995347533359137,77.1150263212809,0
Himachal Pradesh,Solan,Kunihar,544,0,176,hab,170,6,206,338,368,14,3265,516,31.200081435892663,76.93820084978242,0
Himachal Pradesh,Solan,Nalagarh,616,0,3,hab,2,1,9,607,613,14,4107,516,31.08148440912784,76.75058517634318,0
Himachal Pradesh,Solan,Solan,482,1,14,hab,14,0,64,418,468,14,5715,516,30.917501748921865,77.07434090487969,0
Himachal Pradesh,Una,Amb,198,0,12,hab,11,1,19,179,186,14,124,567,31.70988732829244,76.14398006216601,0
Himachal Pradesh,Una,Dhundla,301,0,8,hab,8,0,19,282,293,14,1620,567,31.571924914860716,76.3356339833744,0
Himachal Pradesh,Una,Gagret,94,0,3,hab,2,1,6,88,91,14,1803,567,31.706941610259726,76.04357987476088,0
Himachal Pradesh,Una,Haroli,82,0,5,hab,3,2,8,74,77,14,2160,567,31.423062825401058,76.20535864551317,0
Himachal Pradesh,Una,Una,106,0,10,hab,10,0,17,89,96,14,6214,567,31.47746231335475,76.28776991305638,0
Jammu And Kashmir,Anantnag,Achabal,55,0,11,hab,10,1,19,36,44,15,7,21,33.69927661913958,75.22310782319137,0
Jammu And Kashmir,Anantnag,Anantnag,36,0,2,hab,1,1,7,29,34,15,7767,21,33.72861232912117,75.15677378485638,0
Jammu And Kashmir,Anantnag,Bijibehara,54,0,5,hab,5,0,10,44,49,15,7768,21,33.809506628081714,75.10301847525054,0
Jammu And Kashmir,Anantnag,Breng,57,1,91,osm,37,54,47,10,-34,15,1050,21,33.51320106271096,75.39297797947354,0
Jammu And Kashmir,Anantnag,Chathergul,44,0,44,hab,27,17,36,8,0,15,7769,21,33.771781277176615,75.38327203631077,0
Jammu And Kashmir,Anantnag,Dachnipora,96,0,4,hab,4,0,13,83,92,15,1388,21,33.85813146298729,75.19807141084914,0
Jammu And Kashmir,Anantnag,Hiller Shahabad,33,0,1,hab,1,0,6,27,32,15,7770,21,33.55127450206596,75.190493701847,0
Jammu And Kashmir,Anantnag,Khovripora,82,1,53,hab,40,13,64,18,29,15,3016,21,33.80631248448529,75.28878218045678,0
Jammu And Kashmir,Anantnag,Larnoo,55,0,95,osm,44,51,52,3,-40,15,7771,21,33.6429458672171,75.43537922241161,0
Jammu And Kashmir,Anantnag,Qazigund,18,0,0,hab,0,0,0,18,18,15,4897,21,33.61350788895354,75.15696346227183,0
Jammu And Kashmir,Anantnag,Sagam,48,0,15,hab,15,0,28,20,33,15,7773,21,33.607924926752936,75.25527473104265,0
Jammu And Kashmir,Anantnag,Shahabad,47,0,4,hab,4,0,9,38,43,15,5500,21,33.623809526785436,75.1933659053814,0
Jammu And Kashmir,Anantnag,Shangus,40,0,22,hab,19,3,36,4,18,15,5537,21,33.69178319834917,75.30107431205239,0
Jammu And Kashmir,Anantnag,Verinag,52,0,58,osm,30,28,38,14,-6,15,7774,21,33.47230499812412,75.31780831889272,0
Jammu And Kashmir,Anantnag,Vessu,27,0,2,hab,2,0,6,21,25,15,7775,21,33.689596930695046,75.12181415672104,0
Jammu And Kashmir,Anantnag,unknown,12,2,1,hab,1,0,2,10,11,15,8041,21,33.74978793195005,75.10836953620655,0
Jammu And Kashmir,Anantnag,unknown,67,0,131,osm,54,77,60,7,-64,15,8034,21,34.08109578297989,75.34195077524329,0
Jammu And Kashmir,Bandipora,Aloosa,31,1,1,hab,1,0,4,27,30,15,7796,691,34.44099405091838,74.53640062043829,0
Jammu And Kashmir,Bandipora,Arin,16,0,38,osm,8,30,8,8,-22,15,7797,691,34.43548994492766,74.80958086683715,0
Jammu And Kashmir,Bandipora,Baktoor,10,0,13,osm,5,8,8,2,-3,15,7798,691,34.65010377405285,74.65898279037422,0
Jammu And Kashmir,Bandipora,Bandipora,43,0,10,hab,5,5,11,32,33,15,7799,691,34.393170791309984,74.67319935566917,0
Jammu And Kashmir,Bandipora,Bonkoot,15,0,9,hab,9,0,9,6,6,15,7800,691,34.51795063504208,74.65455413658154,0
Jammu And Kashmir,Bandipora,Ganstan,15,0,5,hab,5,0,13,2,10,15,7801,691,34.173942285123196,74.65659098652503,0
Jammu And Kashmir,Bandipora,Gurez,11,0,5,hab,5,0,5,6,6,15,7802,691,34.64352648277484,74.85029388357212,0
Jammu And Kashmir,Bandipora,Hajin,38,0,5,hab,5,0,11,27,33,15,7803,691,34.331604361297856,74.63132514790138,0
Jammu And Kashmir,Bandipora,Naidkhay,15,0,0,hab,0,0,0,15,15,15,7804,691,34.28556697884848,74.55466089212425,0
Jammu And Kashmir,Bandipora,Nowgam,9,0,1,hab,1,0,2,7,8,15,7805,691,34.208571866033445,74.60646168346703,0
Jammu And Kashmir,Bandipora,Sumbal,15,0,6,hab,5,1,6,9,9,15,7806,691,34.223344198112144,74.64018326552109,0
Jammu And Kashmir,Bandipora,Tulail,37,0,40,osm,31,9,26,11,-3,15,7807,691,34.528909370605085,75.13237353051197,0
Jammu And Kashmir,Baramula,Baramulla,36,0,0,hab,0,0,0,36,36,15,566,51,34.211328240302635,74.36156983077902,0
Jammu And Kashmir,Baramula,Bijhama,28,0,17,hab,12,5,15,13,11,15,7808,51,34.19897561041719,74.07207839562912,0
Jammu And Kashmir,Baramula,Boniyar,42,0,5,hab,4,1,8,34,37,15,1028,51,34.07778174038975,74.19811498868285,0
Jammu And Kashmir,Baramula,Chandil Wangam,14,0,1,hab,1,0,3,11,13,15,7809,51,34.02911932888245,74.4720999601396,0
Jammu And Kashmir,Baramula,Hardaboora,13,1,3,hab,3,0,2,11,10,15,7810,51,34.068458792619865,74.53688100507328,0
Jammu And Kashmir,Baramula,Kandi Rafiabad,23,0,1,hab,1,0,2,21,22,15,7811,51,34.2712647937516,74.19033897272803,0
Jammu And Kashmir,Baramula,Khaipora,20,3,2,hab,0,2,0,20,18,15,7812,51,34.10745842718243,74.4239771200255,0
Jammu And Kashmir,Baramula,Kunzer,37,0,1,hab,1,0,1,36,36,15,3272,51,34.09050933556409,74.49679967250943,0
Jammu And Kashmir,Baramula,Lalpora,18,0,2,hab,2,0,4,14,16,15,7813,51,34.11021269808442,74.53623661673058,0
Jammu And Kashmir,Baramula,Nadihal,16,0,0,hab,0,0,0,16,16,15,7814,51,34.252773104770455,74.36657707350167,0
Jammu And Kashmir,Baramula,Narwah,33,15,1,hab,1,0,2,31,32,15,7815,51,34.13403561238823,74.28997158742777,0
Jammu And Kashmir,Baramula,Noorkah,35,0,10,hab,7,3,16,19,25,15,7816,51,34.19452235575964,74.18695322427317,0
Jammu And Kashmir,Baramula,Paranpeela,58,0,13,hab,10,3,18,40,45,15,7817,51,34.08684987475724,73.99076800756916,0
Jammu And Kashmir,Baramula,Pattan,61,1,2,hab,2,0,1,60,59,15,4634,51,34.184648578060994,74.53382667219886,0
Jammu And Kashmir,Baramula,Rafiabad,38,1,2,hab,2,0,4,34,36,15,4910,51,34.30837030668637,74.36385687633692,0
Jammu And Kashmir,Baramula,Rohama,29,1,1,hab,0,1,0,29,28,15,5180,51,34.25917529423806,74.29023711889192,0
Jammu And Kashmir,Baramula,Sangrama,26,1,1,hab,1,0,2,24,25,15,7818,51,34.24098477279424,74.4784170104599,0
Jammu And Kashmir,Baramula,Sherabad Khore,18,0,2,hab,2,0,6,12,16,15,7819,51,34.11652310143688,74.58000991078437,0
Jammu And Kashmir,Baramula,Singhpora,37,0,5,hab,4,1,6,31,32,15,5658,51,34.14586150751338,74.62622809981445,0
Jammu And Kashmir,Baramula,Sopore,20,0,1,hab,1,0,1,19,19,15,5742,51,34.29031753340411,74.46406207858567,0
Jammu And Kashmir,Baramula,Tangmarg,59,12,27,hab,9,18,11,48,32,15,5902,51,33.99761672439347,74.3777413795528,0
Jammu And Kashmir,Baramula,Tujjar Sharief,25,0,9,hab,9,0,8,17,16,15,7820,51,34.38719261283737,74.39182591217663,0
Jammu And Kashmir,Baramula,Uri,41,0,3,hab,3,0,11,30,38,15,6230,51,34.030186959275504,74.07691279490355,0
Jammu And Kashmir,Baramula,Wagoora,75,1,5,hab,4,1,8,67,70,15,6405,51,34.1395267669762,74.4012542292531,0
Jammu And Kashmir,Baramula,Wailoo,8,0,0,hab,0,0,0,8,8,15,7821,51,34.12733401904299,74.4839910956021,0
Jammu And Kashmir,Baramula,Zainageer,26,1,3,hab,3,0,7,19,23,15,6478,51,34.371392520246914,74.47279332384936,0
Jammu And Kashmir,Budgam,B K Pora,44,1,3,hab,3,0,5,39,41,15,329,90,33.98763185404232,74.85671977460292,0
Jammu And Kashmir,Budgam,Beerwa,47,2,18,hab,16,2,24,23,29,15,682,90,34.02240687821927,74.5996546768893,0
Jammu And Kashmir,Budgam,Budgam,52,2,6,hab,6,0,11,41,46,15,1054,90,34.00974363841235,74.7452384411449,0
Jammu And Kashmir,Budgam,Chadoora,49,0,8,hab,8,0,19,30,41,15,1099,90,33.94732713697931,74.7898421054565,0
Jammu And Kashmir,Budgam,Charisharief,24,9,0,hab,0,0,0,24,24,15,7787,90,33.8781155600805,74.7946852915216,0
Jammu And Kashmir,Budgam,Khag,44,2,14,hab,5,9,12,32,30,15,2909,90,33.94535126843904,74.49592751494934,0
Jammu And Kashmir,Budgam,Khan Sahib,44,0,36,hab,11,25,17,27,8,15,2943,90,33.85641437354338,74.56095710918964,0
Jammu And Kashmir,Budgam,Nagam,28,2,5,hab,5,0,13,15,23,15,4057,90,33.89439641843289,74.76788976015848,0
Jammu And Kashmir,Budgam,Narbal,14,2,3,hab,3,0,5,9,11,15,4180,90,34.10021392674122,74.65823125099575,0
Jammu And Kashmir,Budgam,Pakherpora,21,0,20,hab,7,13,11,10,1,15,7788,90,33.78191677984192,74.62879396377356,0
Jammu And Kashmir,Budgam,Parnewa,37,1,2,hab,2,0,6,31,35,15,7789,90,33.964112955052435,74.70995248602692,0
Jammu And Kashmir,Budgam,Rathsun,11,0,3,hab,3,0,4,7,8,15,7790,90,34.05043528671454,74.60600138522541,0
Jammu And Kashmir,Budgam,S K Pora,17,1,8,hab,8,0,14,3,9,15,7791,90,34.08489130158099,74.60707749480571,0
Jammu And Kashmir,Budgam,Soibugh,36,0,4,hab,4,0,9,27,32,15,7792,90,34.06736846106208,74.6872039767068,0
Jammu And Kashmir,Budgam,Sukhnag Hard Panzoo,28,0,13,hab,12,1,22,6,15,15,7793,90,33.95337445022075,74.59268842752772,0
Jammu And Kashmir,Budgam,Surasyar,23,1,8,hab,8,0,10,13,15,15,7794,90,33.884345470962856,74.69205080277034,0
Jammu And Kashmir,Budgam,Waterhail,15,2,4,hab,4,0,8,7,11,15,7795,90,33.98710093296986,74.65471745869253,0
Jammu And Kashmir,Doda,Assar,70,9,63,osm,51,12,59,11,7,15,274,160,33.12094877275069,75.39173661415327,0
Jammu And Kashmir,Doda,Bhaderwah,90,1,158,osm,108,50,88,2,-68,15,751,160,32.96550354076009,75.7071208810236,0
Jammu And Kashmir,Doda,Bhagwa,54,14,70,osm,36,34,37,17,-16,15,767,160,33.258569727601135,75.5084835535395,0
Jammu And Kashmir,Doda,Bhalla,68,0,104,osm,91,13,68,0,-36,15,7822,160,33.04623013447634,75.59310916830906,0
Jammu And Kashmir,Doda,Changa,37,0,92,osm,38,54,37,0,-55,15,7823,160,32.95514464195703,75.91862047413294,0
Jammu And Kashmir,Doda,Chilli Pingal,18,0,35,osm,7,28,12,6,-17,15,7824,160,33.00837787712349,76.03716567132548,0
Jammu And Kashmir,Doda,Chiralla,45,0,41,hab,32,9,44,1,4,15,7825,160,33.0822293373475,75.72051627938914,0
Jammu And Kashmir,Doda,Dali Udhyanpur,39,0,37,hab,24,13,37,2,2,15,7826,160,33.24155509210188,75.58108559084232,0
Jammu And Kashmir,Doda,Doda,62,0,36,hab,33,3,48,14,26,15,1651,160,33.15510302132188,75.59798244882514,0
Jammu And Kashmir,Doda,Gandoh,32,0,47,osm,16,31,32,0,-15,15,784,160,33.02967262718647,75.84424122724045,0
Jammu And Kashmir,Doda,Gundana,56,12,48,osm,39,9,41,15,8,15,7827,160,33.19843234567092,75.68233722258782,0
Jammu And Kashmir,Doda,Jakyas,34,0,22,hab,17,5,34,0,12,15,7828,160,33.069501982539464,75.95525201706,0
Jammu And Kashmir,Doda,Kahara,46,0,41,hab,33,8,44,2,5,15,7829,160,33.09679882647359,75.85122781415907,0
Jammu And Kashmir,Doda,Kastigarh,38,0,85,osm,35,50,37,1,-47,15,7830,160,33.274150910216825,75.43831503903667,0
Jammu And Kashmir,Doda,Khellani,26,2,32,osm,25,7,25,1,-6,15,7831,160,33.10262601514546,75.50634857867321,0
Jammu And Kashmir,Doda,Marmat,41,0,69,osm,28,41,39,2,-28,15,7832,160,33.01847599246215,75.47832767968056,0
Jammu And Kashmir,Doda,Thathri,33,0,47,osm,39,8,32,1,-14,15,6000,160,33.12966020693661,75.74635052317443,0
Jammu And Kashmir,Ganderbal,Ganderbal,81,0,32,hab,32,0,71,10,49,15,7938,692,34.22426304267054,74.80481422889682,0
Jammu And Kashmir,Ganderbal,Gund,56,1,34,hab,10,24,37,19,22,15,7939,692,34.278355512673684,75.22432005325723,0
Jammu And Kashmir,Ganderbal,Kangan,95,0,112,osm,69,43,90,5,-17,15,7940,692,34.32378732174559,74.95466178286324,0
Jammu And Kashmir,Ganderbal,Lar,41,0,29,hab,28,1,39,2,12,15,7941,692,34.29056665100537,74.7767872060638,0
Jammu And Kashmir,Ganderbal,Safapora,13,0,2,hab,2,0,8,5,11,15,7942,692,34.25540512365849,74.67398277176781,0
Jammu And Kashmir,Ganderbal,Sherpathri,39,0,4,hab,4,0,9,30,35,15,7943,692,34.18114210039166,74.72843862425698,0
Jammu And Kashmir,Ganderbal,Wakoora,28,1,10,hab,10,0,23,5,18,15,7944,692,34.22912875841006,74.69405746851882,0
Jammu And Kashmir,Jammu,Akhnoor,56,0,0,hab,0,0,0,56,56,15,57,246,32.9179039663969,74.70240120685055,0
Jammu And Kashmir,Jammu,Arnia,41,1,0,hab,0,0,0,41,41,15,7857,246,32.51441200300646,74.81933780685326,0
Jammu And Kashmir,Jammu,Bhalwal,41,3,0,hab,0,0,0,41,41,15,787,246,32.84553466565285,74.80214783728671,0
Jammu And Kashmir,Jammu,Bhalwal Brahmana,44,5,0,hab,0,0,0,44,44,15,7858,246,32.87916740493314,74.61723418592301,0
Jammu And Kashmir,Jammu,Bishnah,71,0,0,hab,0,0,0,71,71,15,980,246,32.59215689095365,74.87933608296944,0
Jammu And Kashmir,Jammu,Chowki Choura,38,8,1,hab,1,0,2,36,37,15,7859,246,33.01941754664393,74.62088681546557,0
Jammu And Kashmir,Jammu,Dansal,78,0,1,hab,1,0,2,76,77,15,1432,246,32.83009793914051,75.00864779328369,0
Jammu And Kashmir,Jammu,Kharah Balli,40,8,1,hab,0,1,0,40,39,15,7860,246,32.95104594249004,74.47912833106157,0
Jammu And Kashmir,Jammu,Khour,59,0,1,hab,0,1,0,59,58,15,3015,246,32.83371112311722,74.5057717022163,0
Jammu And Kashmir,Jammu,Maira Mandrian,44,6,0,hab,0,0,0,44,44,15,7861,246,33.00239245283933,74.75354467589462,0
Jammu And Kashmir,Jammu,Mandal Phallain,56,1,0,hab,0,0,0,56,56,15,7862,246,32.68750138599172,74.77973577994089,0
Jammu And Kashmir,Jammu,Marh,114,4,1,hab,1,0,4,110,113,15,3727,246,32.75834074387439,74.75719291390784,0
Jammu And Kashmir,Jammu,Mathwar,23,2,0,hab,0,0,0,23,23,15,7863,246,32.938703236203274,74.8234856356345,0
Jammu And Kashmir,Jammu,Miran Sahib,39,2,0,hab,0,0,0,39,39,15,7864,246,32.60795552921629,74.80412631518799,0
Jammu And Kashmir,Jammu,Nagrota,24,6,1,hab,1,0,1,23,23,15,7865,246,32.796923552811485,74.93673014104719,0
Jammu And Kashmir,Jammu,Pragwal,24,1,3,hab,3,0,3,21,21,15,7866,246,32.77798416818891,74.5949451411329,0
Jammu And Kashmir,Jammu,R S Pura,73,4,1,hab,1,0,5,68,72,15,4901,246,32.60899410428066,74.740539826041,0
Jammu And Kashmir,Jammu,Samwan,13,5,0,hab,0,0,0,13,13,15,7867,246,32.91647825708604,74.45775733309753,0
Jammu And Kashmir,Jammu,Satwari,18,0,0,hab,0,0,0,18,18,15,5446,246,32.70862721337592,74.90350565962056,0
Jammu And Kashmir,Jammu,Suchetgarh,81,2,36,hab,3,33,7,74,45,15,7868,246,32.55859928071028,74.6860125934173,0
Jammu And Kashmir,Kathua,Baggan,57,0,1,hab,1,0,3,54,56,15,7878,284,32.6521600455561,75.68464264369263,0
Jammu And Kashmir,Kathua,Bani,93,6,168,osm,68,100,51,42,-75,15,512,284,32.769641032365186,75.8149458189077,0
Jammu And Kashmir,Kathua,Barnoti,125,0,0,hab,0,0,0,125,125,15,614,284,32.49162096096327,75.44383514405943,0
Jammu And Kashmir,Kathua,Basohli,89,4,0,hab,0,0,0,89,89,15,649,284,32.527632279322184,75.78196816531367,0
Jammu And Kashmir,Kathua,Bhoond,91,2,0,hab,0,0,0,91,91,15,7879,284,32.60255919564921,75.84186075486863,0
Jammu And Kashmir,Kathua,Billawar,90,3,1,hab,1,0,1,89,89,15,950,284,32.59650418385835,75.58243378181109,0
Jammu And Kashmir,Kathua,Dhar Mahanpur,70,9,0,hab,0,0,0,70,70,15,7880,284,32.59831693040474,75.73216728611023,0
Jammu And Kashmir,Kathua,Dinga Amb,25,0,0,hab,0,0,0,25,25,15,7881,284,32.54381304488053,75.34042768305481,0
Jammu And Kashmir,Kathua,Duggain,85,1,25,hab,18,7,8,77,60,15,7882,284,32.69871256067855,75.54091843603761,0
Jammu And Kashmir,Kathua,Duggan,72,1,22,hab,4,18,5,67,50,15,7883,284,32.71547612020814,75.74671695854018,0
Jammu And Kashmir,Kathua,Hiranagar,61,1,1,hab,1,0,1,60,60,15,2226,284,32.48157568780797,75.26337430018701,0
Jammu And Kashmir,Kathua,Kathua,58,3,0,hab,0,0,0,58,58,15,2833,284,32.42532889560256,75.52733474491268,0
Jammu And Kashmir,Kathua,Keerian Gangyal,66,15,7,hab,6,1,11,55,59,15,7884,284,32.3977961393874,75.60797097789799,0
Jammu And Kashmir,Kathua,Lohi Malhar,82,3,45,hab,23,22,12,70,37,15,3431,284,32.72341424703517,75.63971822518421,0
Jammu And Kashmir,Kathua,Mahanpur,115,7,3,hab,0,3,0,115,112,15,7885,284,32.51485405782906,75.65740577016811,0
Jammu And Kashmir,Kathua,Mandli,42,2,0,hab,0,0,0,42,42,15,7886,284,32.620632128739125,75.49654131613919,0
Jammu And Kashmir,Kathua,Marheen,107,0,2,hab,2,0,5,102,105,15,7887,284,32.404438014238615,75.31825927144817,0
Jammu And Kashmir,Kathua,Nagri,54,1,1,hab,1,0,4,50,53,15,7888,284,32.358413954598014,75.45807264020948,0
Jammu And Kashmir,Kathua,Nagrota Gujroo,121,4,1,hab,1,0,4,117,120,15,7889,284,32.624936631040086,75.39667258825187,0
Jammu And Kashmir,Kishtwar,Dachhan,16,3,49,osm,16,33,13,3,-33,15,7834,693,33.64359530991495,76.02033432105502,0
Jammu And Kashmir,Kishtwar,Drabshalla,33,1,118,osm,48,70,32,1,-85,15,7835,693,33.20813194696395,75.85099966216286,0
Jammu And Kashmir,Kishtwar,Inderwal,24,0,130,osm,50,80,24,0,-106,15,7836,693,33.491106694406206,75.5645999522582,0
Jammu And Kashmir,Kishtwar,Kishtwar,26,0,31,osm,23,8,25,1,-5,15,7837,693,33.32169558259485,75.7655859742433,0
Jammu And Kashmir,Kishtwar,Marwah,19,0,71,osm,31,40,19,0,-52,15,7838,693,33.74811661272186,75.7654142426001,0
Jammu And Kashmir,Kishtwar,Mughalmaidan,19,4,75,osm,24,51,16,3,-56,15,7839,693,33.40848417174699,75.64326213093742,0
Jammu And Kashmir,Kishtwar,Nagseni,37,0,77,osm,32,45,32,5,-40,15,7840,693,33.365126282919576,75.9358895118314,0
Jammu And Kashmir,Kishtwar,Paddar,41,0,127,osm,50,77,34,7,-86,15,7841,693,33.33943973044185,76.35383375454697,0
Jammu And Kashmir,Kishtwar,Palmar,19,0,35,osm,15,20,19,0,-16,15,7842,693,33.45358281872867,75.7370889803088,0
Jammu And Kashmir,Kishtwar,Thakraie,29,0,73,osm,22,51,29,0,-44,15,7843,693,33.30911904561446,75.6625875322854,0
Jammu And Kashmir,Kishtwar,Trigam,18,0,31,osm,21,10,18,0,-13,15,7844,693,33.263974410374956,75.80889515199875,0
Jammu And Kashmir,Kishtwar,Warwan,13,0,47,osm,20,27,13,0,-34,15,7845,693,33.95216380959329,75.60879367522456,0
Jammu And Kashmir,Kishtwar,unknown,22,1,52,osm,18,34,17,5,-30,15,8063,693,33.11543207246488,76.06789767804142,0
Jammu And Kashmir,Kulgam,Behibag,45,0,28,hab,28,0,34,11,17,15,7776,694,33.71766789133807,74.99373529904877,0
Jammu And Kashmir,Kulgam,D K Marg,37,0,23,hab,13,10,26,11,14,15,7779,694,33.530946441892716,75.00219217183479,0
Jammu And Kashmir,Kulgam,Damhal Hanji Pora,59,3,63,osm,39,24,56,3,-4,15,7778,694,33.552529132232685,74.89860065190823,0
Jammu And Kashmir,Kulgam,Devsar,68,0,5,hab,5,0,16,52,63,15,7777,694,33.626464802089494,75.09387707376845,0
Jammu And Kashmir,Kulgam,Frisal,27,3,0,hab,0,0,0,27,27,15,7780,694,33.74930103500313,75.05441343169359,0
Jammu And Kashmir,Kulgam,Kulgam,57,2,24,hab,24,0,34,23,33,15,7781,694,33.661609787621096,75.00648635260356,0
Jammu And Kashmir,Kulgam,Kund,27,1,1,hab,1,0,2,25,26,15,7782,694,33.555592186449786,75.11128934435747,0
Jammu And Kashmir,Kulgam,Manzgam,46,0,140,osm,29,111,42,4,-94,15,7783,694,33.592742880081836,74.6935431891092,0
Jammu And Kashmir,Kulgam,Pahloo,23,0,4,hab,3,1,7,16,19,15,7784,694,33.60920123496592,75.01885469006578,0
Jammu And Kashmir,Kulgam,Pombay,20,1,29,osm,25,4,19,1,-9,15,7785,694,33.64757471835582,74.92945366379797,0
Jammu And Kashmir,Kulgam,Qaimoh,37,0,4,hab,4,0,10,27,33,15,7786,694,33.70108797075463,75.06729898822945,0
Jammu And Kashmir,Kupwara,Drugmulla,10,0,4,hab,4,0,5,5,6,15,7890,318,34.489827635063946,74.28667278764357,0
Jammu And Kashmir,Kupwara,Handwara,26,0,7,hab,7,0,9,17,19,15,7891,318,34.40447429559093,74.25600262109786,0
Jammu And Kashmir,Kupwara,Hayhama,36,0,17,hab,8,9,20,16,19,15,7892,318,34.66794208238585,74.21463246298484,0
Jammu And Kashmir,Kupwara,Kalaroos,28,0,5,hab,5,0,9,19,23,15,2617,318,34.61260539069521,74.34495047798158,0
Jammu And Kashmir,Kupwara,Keran,6,0,10,osm,3,7,4,2,-4,15,7893,318,34.635301875857515,74.0133368063433,0
Jammu And Kashmir,Kupwara,Kralpora,17,1,2,hab,2,0,2,15,15,15,3197,318,34.51559568433524,74.10580707768709,0
Jammu And Kashmir,Kupwara,Kupwara,20,0,12,hab,12,0,9,11,8,15,3274,318,34.51229070680205,74.23739213652257,0
Jammu And Kashmir,Kupwara,Langate,18,0,1,hab,1,0,3,15,17,15,3374,318,34.37543991094338,74.32326714678257,0
Jammu And Kashmir,Kupwara,Machil,13,0,14,osm,5,9,4,9,-1,15,7894,318,34.7258570567742,74.40909559205795,0
Jammu And Kashmir,Kupwara,Magam,21,0,2,hab,1,1,1,20,19,15,7895,318,34.458762414775414,74.21590494908016,0
Jammu And Kashmir,Kupwara,Mawar Kalamabad,39,0,6,hab,4,2,7,32,33,15,7896,318,34.3289287607404,74.086618360136,0
Jammu And Kashmir,Kupwara,Meliyal,10,0,1,hab,1,0,3,7,9,15,7897,318,34.55199754650041,74.07626487016738,0
Jammu And Kashmir,Kupwara,Nutnoosa,16,0,4,hab,3,1,4,12,12,15,7898,318,34.452898225976945,74.32793522308441,0
Jammu And Kashmir,Kupwara,Qadirabad,19,0,18,hab,12,6,10,9,1,15,7899,318,34.59062463958041,74.16250217275393,0
Jammu And Kashmir,Kupwara,Qaziabad Supernagama,48,0,1,hab,1,0,3,45,47,15,7900,318,34.34156470305635,74.32112482459527,0
Jammu And Kashmir,Kupwara,Rajwar,28,0,6,hab,5,1,3,25,22,15,5009,318,34.39673200759132,74.12492938348855,0
Jammu And Kashmir,Kupwara,Ramhal,13,1,22,osm,20,2,8,5,-9,15,5043,318,34.46977563003739,74.15831185614736,0
Jammu And Kashmir,Kupwara,Reddi Chowkibal,13,0,7,hab,4,3,6,7,6,15,7901,318,34.50910452084826,73.97315647806732,0
Jammu And Kashmir,Kupwara,Sogam,29,0,9,hab,9,0,16,13,20,15,5706,318,34.47439910160646,74.42277503031391,0
Jammu And Kashmir,Kupwara,Tangdar,16,0,3,hab,3,0,6,10,13,15,7902,318,34.41411147297367,73.90337162946003,0
Jammu And Kashmir,Kupwara,Tarathpora,24,0,6,hab,5,1,5,19,18,15,7903,318,34.444782499407765,74.06859058633424,0
Jammu And Kashmir,Kupwara,Teetwal,30,0,8,hab,2,6,2,28,22,15,5937,318,34.41019010857328,73.84681121603778,0
Jammu And Kashmir,Kupwara,Trehgam,10,0,13,osm,13,0,5,5,-3,15,6135,318,34.51281310952177,74.16565853034243,0
Jammu And Kashmir,Kupwara,Vawoora,33,0,6,hab,5,1,8,25,27,15,6296,318,34.5480655015486,74.43321558164175,0
Jammu And Kashmir,Poonch,Balakote,66,10,1,hab,0,1,0,66,65,15,437,432,33.54917617208038,74.21623814227034,0
Jammu And Kashmir,Poonch,Bufliaz,43,0,40,hab,1,39,1,42,3,15,7920,432,33.61040191632651,74.43840278704825,0
Jammu And Kashmir,Poonch,Lassana,41,0,0,hab,0,0,0,41,41,15,7921,432,33.71526982318875,74.22379966972042,0
Jammu And Kashmir,Poonch,Loran,27,0,69,osm,33,36,27,0,-42,15,7922,432,33.80561322522941,74.3707740897791,0
Jammu And Kashmir,Poonch,Mandi,38,0,72,osm,30,42,29,9,-34,15,3646,432,33.85033948205231,74.2830142596873,0
Jammu And Kashmir,Poonch,Mankote,66,3,1,hab,0,1,0,66,65,15,7923,432,33.65964193989505,74.04373151066483,0
Jammu And Kashmir,Poonch,Mendhar,121,6,1,hab,1,0,4,117,120,15,3839,432,33.632556410555615,74.17621194624502,0
Jammu And Kashmir,Poonch,Nangali Sahib Sain Baba,28,0,0,hab,0,0,0,28,28,15,7924,432,33.802932985279305,74.16512796647197,0
Jammu And Kashmir,Poonch,Poonch,48,0,0,hab,0,0,0,48,48,15,4809,432,33.758274445507126,74.07992869765988,0
Jammu And Kashmir,Poonch,Sathra,31,0,1,hab,1,0,2,29,30,15,7925,432,33.77490232530763,74.21306647855397,0
Jammu And Kashmir,Poonch,Surankote,52,2,12,hab,0,12,0,52,40,15,5815,432,33.69708026214799,74.3452473913668,0
Jammu And Kashmir,Pulwama,Aripal,56,0,28,hab,20,8,43,13,28,15,7904,438,34.030187523212675,75.10322270683895,0
Jammu And Kashmir,Pulwama,Awantipora,62,0,9,hab,9,0,22,40,53,15,7905,438,33.9037939231154,75.0139093150122,0
Jammu And Kashmir,Pulwama,Dadsara,50,0,15,hab,15,0,37,13,35,15,7906,438,33.89638446180017,75.07583325277945,0
Jammu And Kashmir,Pulwama,Ichegoza,30,0,5,hab,4,1,16,14,25,15,7907,438,33.79638342594919,74.73113406792478,0
Jammu And Kashmir,Pulwama,Kakapora,51,0,2,hab,2,0,6,45,49,15,2590,438,33.93488724080923,74.93158126204744,0
Jammu And Kashmir,Pulwama,Litter,61,0,1,hab,1,0,7,54,60,15,7908,438,33.81843094301558,74.97523939288789,0
Jammu And Kashmir,Pulwama,Newa,34,0,0,hab,0,0,0,34,34,15,7909,438,33.916742813244106,74.87172449987317,0
Jammu And Kashmir,Pulwama,Pampore,76,0,31,hab,27,4,43,33,45,15,4491,438,34.01333360853663,74.98745623962184,0
Jammu And Kashmir,Pulwama,Pulwama,87,0,2,hab,2,0,7,80,85,15,4852,438,33.85911645830428,74.90922209940821,0
Jammu And Kashmir,Pulwama,Shadimarg,40,1,1,hab,1,0,2,38,39,15,7910,438,33.82593355984312,74.83399388379034,0
Jammu And Kashmir,Pulwama,Tral,83,0,21,hab,21,0,51,32,62,15,6134,438,33.95986493680348,75.16053968811117,0
Jammu And Kashmir,Rajouri,Budhal,80,2,23,hab,10,13,12,68,57,15,1057,453,33.38012698112017,74.48035706231082,0
Jammu And Kashmir,Rajouri,Budhal New,24,0,44,osm,14,30,17,7,-20,15,7926,453,33.41122077885246,74.61255140786038,0
Jammu And Kashmir,Rajouri,Darhal,29,1,1,hab,1,0,2,27,28,15,1447,453,33.47879258103191,74.43133801797943,0
Jammu And Kashmir,Rajouri,Dhangri,16,0,0,hab,0,0,0,16,16,15,7927,453,33.29262285679405,74.33417328798102,0
Jammu And Kashmir,Rajouri,Doongi,59,0,27,hab,9,18,6,53,32,15,7928,453,33.29691447558186,74.23619346728339,0
Jammu And Kashmir,Rajouri,Kalakote,80,1,63,hab,42,21,53,27,17,15,2608,453,33.21746963003492,74.41850768185864,0
Jammu And Kashmir,Rajouri,Khawas,26,0,28,osm,12,16,13,13,-2,15,7929,453,33.277098706209344,74.61317400917348,0
Jammu And Kashmir,Rajouri,Lamberi,15,1,23,osm,12,11,14,1,-8,15,7930,453,33.13978000209095,74.3372402447995,0
Jammu And Kashmir,Rajouri,Manjakote,42,1,0,hab,0,0,0,42,42,15,3683,453,33.50228567746926,74.26434750021365,0
Jammu And Kashmir,Rajouri,Moughla,44,7,17,hab,9,8,10,34,27,15,7931,453,33.20852777079188,74.53727957996429,0
Jammu And Kashmir,Rajouri,Nowshera,29,0,10,hab,3,7,6,23,19,15,4348,453,33.17899194838443,74.15163686676537,0
Jammu And Kashmir,Rajouri,Panjgrian,31,2,0,hab,0,0,0,31,31,15,7932,453,33.41397641576361,74.24231800876848,0
Jammu And Kashmir,Rajouri,Planger,23,0,0,hab,0,0,0,23,23,15,7933,453,33.4705786495207,74.33088157094417,0
Jammu And Kashmir,Rajouri,Qila Darhal,34,0,0,hab,0,0,0,34,34,15,7934,453,33.25333393738116,74.15102981668053,0
Jammu And Kashmir,Rajouri,Rajouri,72,0,0,hab,0,0,0,72,72,15,4995,453,33.37108698328017,74.33416870751539,0
Jammu And Kashmir,Rajouri,Seri,16,0,23,osm,14,9,13,3,-7,15,7935,453,33.09260974383054,74.27766300934255,0
Jammu And Kashmir,Rajouri,Siot,26,7,26,osm,20,6,14,12,0,15,7936,453,33.104748213845745,74.45080550580312,0
Jammu And Kashmir,Rajouri,Sunderbani,55,2,43,hab,29,14,24,31,12,15,5809,453,33.048722622274056,74.44892904153356,0
Jammu And Kashmir,Rajouri,Thana Mandi,33,0,0,hab,0,0,0,33,33,15,7937,453,33.542340054895256,74.37759938202336,0
Jammu And Kashmir,Ramban,Banihal,57,1,56,hab,38,18,56,1,1,15,7846,695,33.44974054146959,75.19899712095021,0
Jammu And Kashmir,Ramban,Batote,27,0,55,osm,32,23,24,3,-28,15,7847,695,33.13120988189113,75.29402599278365,0
Jammu And Kashmir,Ramban,Gandhri,25,3,36,osm,21,15,19,6,-11,15,7848,695,33.19914339640383,75.16200547393571,0
Jammu And Kashmir,Ramban,Gool,23,0,22,hab,18,4,18,5,1,15,7849,695,33.247709931371304,75.00306547061193,0
Jammu And Kashmir,Ramban,Gundi Dharam,15,0,31,osm,14,17,14,1,-16,15,7850,695,33.318945600574494,75.0330165968014,0
Jammu And Kashmir,Ramban,Khari,20,0,75,osm,24,51,20,0,-55,15,7851,695,33.421114731566824,75.09464461056393,0
Jammu And Kashmir,Ramban,Rajgarh,22,0,40,osm,28,12,22,0,-18,15,7852,695,33.214134744169954,75.35265937492811,0
Jammu And Kashmir,Ramban,Ramban,54,0,129,osm,87,42,49,5,-75,15,7853,695,33.24734278511256,75.2588006724671,0
Jammu And Kashmir,Ramban,Ramsu,25,1,70,osm,33,37,25,0,-45,15,7854,695,33.347375631964745,75.20308060610202,0
Jammu And Kashmir,Ramban,Sangaldan,46,4,53,osm,36,17,39,7,-7,15,7855,695,33.23956823599947,75.08490592626198,0
Jammu And Kashmir,Ramban,Ukhral,13,0,97,osm,39,58,13,0,-84,15,7856,695,33.333490187900274,75.32417125996348,0
Jammu And Kashmir,Reasi,Arnas,67,0,21,hab,14,7,15,52,46,15,7952,696,33.187322204247614,74.90553333656487,0
Jammu And Kashmir,Reasi,Bamagh,44,2,16,hab,3,13,6,38,28,15,7953,696,33.08987124471248,74.96278691758249,0
Jammu And Kashmir,Reasi,Chassana,86,1,87,osm,57,30,70,16,-1,15,7954,696,33.41055145548624,74.73461891053992,0
Jammu And Kashmir,Reasi,Gulab Garh,28,0,48,osm,24,24,23,5,-20,15,7955,696,33.42271205543031,74.93635023150343,0
Jammu And Kashmir,Reasi,Jig Bagli,25,0,13,hab,7,6,9,16,12,15,7956,696,33.24708743767571,74.72782046461916,0
Jammu And Kashmir,Reasi,Katra,26,0,1,hab,0,1,0,26,25,15,7957,696,32.97930428700654,74.91873406243603,0
Jammu And Kashmir,Reasi,Mahore,58,0,36,hab,26,10,42,16,22,15,7958,696,33.32317288764673,74.87504451002997,0
Jammu And Kashmir,Reasi,Panthal,31,0,0,hab,0,0,0,31,31,15,7959,696,32.95704067728525,74.95756964485754,0
Jammu And Kashmir,Reasi,Pouni,112,6,3,hab,3,0,5,107,109,15,7960,696,33.11257860562761,74.67311223581936,0
Jammu And Kashmir,Reasi,Reasi,50,1,1,hab,0,1,0,50,49,15,7961,696,33.05710361860582,74.85389703764726,0
Jammu And Kashmir,Reasi,Thakrakote,37,4,0,hab,0,0,0,37,37,15,7962,696,33.162077275833546,74.74378679064684,0
Jammu And Kashmir,Reasi,Thuroo,55,1,21,hab,15,6,25,30,34,15,7963,696,33.2600566812876,74.86869355137561,0
Jammu And Kashmir,Samba,Gagwal,51,6,1,hab,1,0,4,47,50,15,7869,697,32.53186982198388,75.20859956497456,0
Jammu And Kashmir,Samba,Nud,51,3,12,hab,9,3,6,45,39,15,7870,697,32.649396545687715,75.11813768364213,0
Jammu And Kashmir,Samba,Purmandal,35,35,0,hab,0,0,0,35,35,15,7871,697,32.651164957884,74.93571908220406,0
Jammu And Kashmir,Samba,Purmandal Bari Brahamna,11,11,1,osm,0,1,0,11,10,15,7872,697,32.680849021732755,75.02433419935662,0
Jammu And Kashmir,Samba,Rajpura,36,2,0,hab,0,0,0,36,36,15,7873,697,32.461200638892905,75.16050364039074,0
Jammu And Kashmir,Samba,Ramgarh,76,0,0,hab,0,0,0,76,76,15,7874,697,32.506994441424425,74.95611966539651,0
Jammu And Kashmir,Samba,Samba,58,0,0,hab,0,0,0,58,58,15,7875,697,32.53541799089164,75.09122089897207,0
Jammu And Kashmir,Samba,Sumb,41,0,8,hab,6,2,3,38,33,15,7876,697,32.60595196641711,75.23900073444341,0
Jammu And Kashmir,Samba,Vijaypur,38,0,0,hab,0,0,0,38,38,15,7877,697,32.59711400908095,74.99671519965501,0
Jammu And Kashmir,Shopian,Chitragam,35,0,8,hab,8,0,17,18,27,15,7911,698,33.773726729090576,74.94573747220147,0
Jammu And Kashmir,Shopian,Harman,22,0,27,osm,26,1,22,0,-5,15,7912,698,33.704674363044816,74.92811453281696,0
Jammu And Kashmir,Shopian,Imamsahib,45,0,28,hab,28,0,36,9,17,15,7913,698,33.744407063692435,74.90575728194369,0
Jammu And Kashmir,Shopian,Kanji Ullar,19,0,23,osm,23,0,18,1,-4,15,7914,698,33.66302311199992,74.86856104351395,0
Jammu And Kashmir,Shopian,Kaprin,24,0,24,hab,24,0,24,0,0,15,7915,698,33.68343410931046,74.89983499955898,0
Jammu And Kashmir,Shopian,Kellar,71,0,41,hab,19,22,23,48,30,15,7916,698,33.748079249786755,74.76115298467786,0
Jammu And Kashmir,Shopian,Ramnagri,11,0,12,osm,12,0,10,1,-1,15,7917,698,33.67218793276636,74.81148623785407,0
Jammu And Kashmir,Shopian,Shupiyan,53,0,29,hab,24,5,31,22,24,15,7918,698,33.7233378996912,74.81232619081831,0
Jammu And Kashmir,Shopian,Zainpora,19,0,2,hab,2,0,3,16,17,15,7919,698,33.77571008899408,75.01070832739933,0
Jammu And Kashmir,Srinagar,Eidgah,15,0,7,hab,5,2,7,8,8,15,7945,529,34.140384854131966,74.77860209476486,0
Jammu And Kashmir,Srinagar,Harwan Rural Area Dara,18,0,13,hab,7,6,12,6,5,15,7946,529,34.14668744935034,75.00060395212604,0
Jammu And Kashmir,Srinagar,Khanmoh,11,0,4,hab,4,0,6,5,7,15,7948,529,34.06488936129598,74.95135549792612,0
Jammu And Kashmir,Srinagar,Qamarwari,14,0,6,hab,5,1,13,1,8,15,7949,529,34.10696994768701,74.73002920888982,0
Jammu And Kashmir,Srinagar,Srinagar,18,1,8,hab,3,5,8,10,10,15,5764,529,34.094015502997934,74.85362076661055,0
Jammu And Kashmir,Udhampur,Chanunta   Dalsar,18,0,0,hab,0,0,0,18,18,15,7964,562,32.84256580354323,75.2655837016034,0
Jammu And Kashmir,Udhampur,Chenani,97,0,58,hab,43,15,59,38,39,15,1226,562,33.01793742724721,75.32875473595965,0
Jammu And Kashmir,Udhampur,Dudu,48,3,174,osm,85,89,38,10,-126,15,1685,562,32.81532946880006,75.57660178352288,0
Jammu And Kashmir,Udhampur,Ghordi,70,1,0,hab,0,0,0,70,70,15,1946,562,32.904003204768,75.29258519280987,0
Jammu And Kashmir,Udhampur,Jaganoo,46,6,0,hab,0,0,0,46,46,15,7965,562,32.864248244239086,75.18542494233898,0
Jammu And Kashmir,Udhampur,Khoon,61,4,0,hab,0,0,0,61,61,15,7966,562,32.68686378830141,75.34176404024662,0
Jammu And Kashmir,Udhampur,Kulwanta,38,2,0,hab,0,0,0,38,38,15,7967,562,32.78406307705386,75.43541601749716,0
Jammu And Kashmir,Udhampur,Latti,50,2,75,osm,36,39,16,34,-25,15,7968,562,32.90893947308787,75.52442224421851,0
Jammu And Kashmir,Udhampur,Majalta,54,1,2,hab,2,0,3,51,52,15,3560,562,32.72172838709099,75.18418973103772,0
Jammu And Kashmir,Udhampur,Moungri,59,16,86,osm,64,22,44,15,-27,15,7969,562,33.09157230321639,75.06719006342017,0
Jammu And Kashmir,Udhampur,Narsoo,45,0,26,hab,23,3,35,10,19,15,7970,562,33.01078169943352,75.19188548172505,0
Jammu And Kashmir,Udhampur,Panchari,90,5,107,osm,84,23,81,9,-17,15,4497,562,33.105125571124134,75.15854533991866,0
Jammu And Kashmir,Udhampur,Parli Dhar,25,1,0,hab,0,0,0,25,25,15,7971,562,32.74721604392835,75.30232884550493,0
Jammu And Kashmir,Udhampur,Ramnagar,52,0,0,hab,0,0,0,52,52,15,5051,562,32.80796867338136,75.3178527795708,0
Jammu And Kashmir,Udhampur,Sewna,25,2,5,hab,3,2,5,20,20,15,7972,562,32.97380895972263,75.22164968982273,0
Jammu And Kashmir,Udhampur,Tikri,45,3,10,hab,7,3,4,41,35,15,7973,562,32.966542934459646,75.01632347332405,0
Jammu And Kashmir,Udhampur,Udhampur,176,0,21,hab,16,5,11,165,155,15,6180,562,32.92584775206882,75.1021005966486,0
Jharkhand,Bokaro,Bermo,21,0,23,osm,7,16,11,10,-2,16,728,86,23.77788942591355,86.01137387518806,0
Jharkhand,Bokaro,Chandankiyari,195,0,2,hab,2,0,6,189,193,16,1148,86,23.568642141499524,86.33584224125717,0
Jharkhand,Bokaro,Chas,189,0,1,hab,0,1,0,189,188,16,1192,86,23.61929056683037,86.17487043617493,0
Jharkhand,Bokaro,Gomia,188,1,8,hab,4,4,4,184,180,16,1991,86,23.794408854362587,85.71503923267954,0
Jharkhand,Bokaro,Jaridhi,59,1,2,hab,1,1,4,55,57,16,2446,86,23.596161822611602,85.9994277667686,0
Jharkhand,Bokaro,Kasmar,67,0,1,hab,1,0,3,64,66,16,2819,86,23.571213397893086,85.91035990427194,0
Jharkhand,Bokaro,Nawadih,102,1,8,hab,7,1,10,92,94,16,4248,86,23.85308296706493,86.00460323543975,0
Jharkhand,Bokaro,Petarwar,94,1,1,hab,0,1,0,94,93,16,4718,86,23.687820396501376,85.88198106853723,0
Jharkhand,Chatra,Chatra Sadar,327,0,1,hab,1,0,5,322,326,16,1196,108,24.24790173160929,84.93642705789954,0
Jharkhand,Chatra,Gidhor,86,2,3,hab,3,0,8,78,83,16,1954,108,24.184931307758273,85.07184639801261,0
Jharkhand,Chatra,Hunter Ganj,308,0,2,hab,2,0,10,298,306,16,2260,108,24.383120529841108,84.80431227614275,0
Jharkhand,Chatra,Itkhori,246,0,4,hab,4,0,6,240,242,16,2324,108,24.278476035988955,85.20737773504217,0
Jharkhand,Chatra,Kunda,74,0,1,hab,1,0,1,73,73,16,3254,108,24.18643340584971,84.6493037429435,0
Jharkhand,Chatra,Lawalong,112,2,7,hab,7,0,9,103,105,16,3395,108,24.077287886263047,84.71487076832398,0
Jharkhand,Chatra,Pathal Gadda,59,0,17,hab,16,1,25,34,42,16,4605,108,24.098043090727256,85.09812737465892,0
Jharkhand,Chatra,Pratappur,183,0,1,hab,1,0,5,178,182,16,4829,108,24.302093553202344,84.59843172422545,0
Jharkhand,Chatra,Simaria,106,0,7,hab,7,0,9,97,99,16,5637,108,24.029716315034705,85.0086426366533,0
Jharkhand,Chatra,Tandwa,97,0,4,hab,3,1,3,94,93,16,5898,108,23.8311821583119,85.00528286216493,0
Jharkhand,Deoghar,Deogarh Sadar,266,6,8,hab,8,0,23,243,258,16,1500,141,24.482734958298217,86.63142624940019,0
Jharkhand,Deoghar,Devipur,223,5,0,hab,0,0,0,223,223,16,1534,141,24.387729824645476,86.59058273516202,0
Jharkhand,Deoghar,Karon,260,44,3,hab,3,0,6,254,257,16,2791,141,24.179920392954106,86.67478582664343,0
Jharkhand,Deoghar,Madhupur,206,8,0,hab,0,0,0,206,206,16,3489,141,24.2734344678061,86.58131663285003,0
Jharkhand,Deoghar,Mohanpur,383,7,0,hab,0,0,0,383,383,16,3889,141,24.50695012419271,86.80511056217202,0
Jharkhand,Deoghar,Palajori,268,5,3,hab,3,0,8,260,265,16,4444,141,24.187242067322764,86.94505492087299,0
Jharkhand,Deoghar,Sarath,349,7,1,hab,1,0,3,346,348,16,5407,141,24.193091158258014,86.820868590235,0
Jharkhand,Deoghar,Sarwan,399,10,2,hab,2,0,9,390,397,16,5426,141,24.356547881638143,86.84077604945128,0
Jharkhand,Dhanbad,Baghmara,178,0,23,hab,18,5,46,132,155,16,382,146,23.79967749877951,86.27502759027143,0
Jharkhand,Dhanbad,Baliapur,63,0,7,hab,6,1,10,53,56,16,456,146,23.72393206984775,86.51848259860685,0
Jharkhand,Dhanbad,Dhanbad Sadar,26,0,5,hab,2,3,6,20,21,16,1554,146,23.779478261115816,86.39585878347225,0
Jharkhand,Dhanbad,Govindpur,213,0,0,hab,0,0,0,213,213,16,2029,146,23.854543934956666,86.50003817081245,0
Jharkhand,Dhanbad,Nirsa,221,0,9,hab,7,2,12,209,212,16,4317,146,23.778531357992303,86.69977431732207,0
Jharkhand,Dhanbad,Topchanchi,105,0,4,hab,2,2,5,100,101,16,6130,146,23.884282779115516,86.21001604419045,0
Jharkhand,Dhanbad,Tundi,269,1,2,hab,2,0,4,265,267,16,6152,146,23.95569505626367,86.47115562312574,0
Jharkhand,Dumka,Dumka Sadar,256,8,9,hab,9,0,11,245,247,16,1699,161,24.256872985430814,87.30953701356853,0
Jharkhand,Dumka,Gopikander,128,0,2,hab,2,0,5,123,126,16,2011,161,24.442987524380037,87.50727227838745,0
Jharkhand,Dumka,Jama,311,2,7,hab,7,0,22,289,304,16,2405,161,24.305820042312188,87.16296916108315,0
Jharkhand,Dumka,Jarmundi,470,2,9,hab,9,0,40,430,461,16,2447,161,24.415761941866908,87.02536518283891,0
Jharkhand,Dumka,Kathikund,193,0,1,hab,1,0,6,187,192,16,2830,161,24.363677011730818,87.44529006785578,0
Jharkhand,Dumka,Masalia,290,0,14,hab,14,0,32,258,276,16,3748,161,24.139080542670094,87.13339534847977,0
Jharkhand,Dumka,Ramgarh,323,0,5,hab,5,0,13,310,318,16,5039,161,24.50905732178403,87.23326216993638,0
Jharkhand,Dumka,Raneshwar,191,1,10,hab,10,0,15,176,181,16,5080,161,24.08420371497018,87.39378168250853,0
Jharkhand,Dumka,Saraiyahaat,293,1,2,hab,2,0,7,286,291,16,5401,161,24.560730153156598,87.0158829591216,0
Jharkhand,Dumka,Shikaripara,242,0,6,hab,6,0,13,229,236,16,5564,161,24.2034349417324,87.5117474899692,0
Jharkhand,Garhwa,Bhandaria,107,0,5,hab,5,0,10,97,102,16,792,191,23.71130445722342,83.88283439967373,0
Jharkhand,Garhwa,Bhawanathpur,153,0,47,hab,46,1,54,99,106,16,831,191,24.434055904769398,83.60143001881785,0
Jharkhand,Garhwa,Chinia,49,1,4,hab,3,1,6,43,45,16,1297,191,24.00213588461973,83.61659932858987,0
Jharkhand,Garhwa,Dandai,58,1,6,hab,6,0,12,46,52,16,1422,191,24.108077459775966,83.61720504391943,0
Jharkhand,Garhwa,Dhurki,184,0,23,hab,23,0,51,133,161,16,1623,191,24.139053262654244,83.45449675424173,0
Jharkhand,Garhwa,Garhwa Sadar,210,1,22,hab,19,3,32,178,188,16,1877,191,24.141070135136562,83.84849540955902,0
Jharkhand,Garhwa,Kandi,76,0,15,hab,15,0,21,55,61,16,2705,191,24.453416729574204,83.79206944898091,0
Jharkhand,Garhwa,Kharaundhi,85,0,11,hab,11,0,34,51,74,16,2969,191,24.446418280505874,83.45361876191348,0
Jharkhand,Garhwa,Majhiaon,63,0,30,hab,25,5,23,40,33,16,3563,191,24.32164028460253,83.74529232831144,0
Jharkhand,Garhwa,Meral,137,1,22,hab,20,2,37,100,115,16,3843,191,24.17633539475453,83.72401463691519,0
Jharkhand,Garhwa,Nagaruntari,209,1,15,hab,15,0,53,156,194,16,4068,191,24.293068787234144,83.4802648181599,0
Jharkhand,Garhwa,Ramkanda,65,0,5,hab,5,0,8,57,60,16,5045,191,23.87248178972578,83.85150975440551,0
Jharkhand,Garhwa,Ramna,219,0,2,hab,2,0,14,205,217,16,5048,191,24.238628925862404,83.58998228917247,0
Jharkhand,Garhwa,Ranka,127,1,7,hab,6,1,12,115,120,16,5101,191,23.926796128974463,83.72823808772591,0
Jharkhand,Giridih,Bagodar,130,0,17,hab,12,5,11,119,113,16,393,195,24.125498616066178,85.87859469034436,0
Jharkhand,Giridih,Bengabad,256,0,24,hab,24,0,35,221,232,16,719,195,24.315001808469212,86.3647649019004,0
Jharkhand,Giridih,Birni,172,0,54,hab,54,0,64,108,118,16,970,195,24.25144794592688,85.99252456268644,0
Jharkhand,Giridih,Deori,368,0,58,hab,58,0,109,259,310,16,1508,195,24.510772948230755,86.16656714289388,0
Jharkhand,Giridih,Dumri,192,0,7,hab,6,1,12,180,185,16,1705,195,24.027123274444968,86.05365177175338,0
Jharkhand,Giridih,Gandey,266,0,8,hab,8,0,25,241,258,16,1832,195,24.138066470993106,86.45139714086328,0
Jharkhand,Giridih,Gawan,138,0,45,hab,43,2,54,84,93,16,1900,195,24.63597731566989,85.8756276870986,0
Jharkhand,Giridih,Giridih Sadar,240,0,41,hab,38,3,49,191,199,16,1958,195,24.172290288297294,86.24926252531411,0
Jharkhand,Giridih,Jamua,497,0,61,hab,61,0,152,345,436,16,2430,195,24.364442808873086,86.1521726983005,0
Jharkhand,Giridih,Pirtand,298,0,18,hab,18,0,20,278,280,16,4775,195,24.016771329100326,86.21292568558225,0
Jharkhand,Giridih,Raj Dhanwar,280,0,44,hab,43,1,73,207,236,16,4956,195,24.409412951604025,85.9320511392362,0
Jharkhand,Giridih,Tisri,189,0,91,hab,85,6,90,99,98,16,6113,195,24.635820982956464,86.02979645143839,0
Jharkhand,Godda,Boarijore,310,1,47,hab,46,1,66,244,263,16,995,197,24.997675693753063,87.4078502202607,0
Jharkhand,Godda,Godda Sadar,197,1,35,hab,34,1,46,151,162,16,1964,197,24.788198773858745,87.25633142722496,0
Jharkhand,Godda,Mahagama,243,1,56,hab,56,0,124,119,187,16,3514,197,25.036295446662177,87.27064719001598,0
Jharkhand,Godda,Meharma,144,3,33,hab,33,0,65,79,111,16,3816,197,25.15738156113805,87.35777535366961,0
Jharkhand,Godda,Pathargama,229,2,47,hab,47,0,75,154,182,16,4611,197,24.94734697394913,87.22837856369968,0
Jharkhand,Godda,Poraihat,197,1,8,hab,7,1,8,189,189,16,4811,197,24.685266324037496,87.19154064839785,0
Jharkhand,Godda,Sunderpahari,221,0,2,hab,2,0,4,217,219,16,5810,197,24.724785284090647,87.4027930936448,0
Jharkhand,Godda,Thakurgangti,146,1,76,hab,76,0,129,17,70,16,5972,197,25.148325977066257,87.449270589462,0
Jharkhand,Gumla,Basia,177,0,13,hab,11,2,26,151,164,16,641,204,22.895328992878298,84.80321637784714,0
Jharkhand,Gumla,Bharno,189,0,7,hab,7,0,15,174,182,16,812,204,23.186775820479234,84.85605174170577,0
Jharkhand,Gumla,Bishnupur,152,0,19,hab,18,1,22,130,133,16,982,204,23.426266525156567,84.35257209508147,0
Jharkhand,Gumla,Chainpur,153,1,4,hab,4,0,8,145,149,16,1109,204,23.153318371266984,84.31329995637611,0
Jharkhand,Gumla,Dumri,174,0,25,hab,22,3,25,149,149,16,1704,204,23.15402347385277,84.16024024805043,0
Jharkhand,Gumla,Ghaghra,141,0,1,hab,0,1,0,141,140,16,1909,204,23.256900673923834,84.5024319455112,0
Jharkhand,Gumla,Gumla Sadar,296,1,0,hab,0,0,0,296,296,16,2061,204,23.074791925850036,84.57695280916788,0
Jharkhand,Gumla,Kamdara,111,2,2,hab,2,0,4,107,109,16,2681,204,22.89697085280952,84.91987267038652,0
Jharkhand,Gumla,Palkot,247,1,1,hab,1,0,10,237,246,16,4471,204,22.855644377079937,84.62056622231879,0
Jharkhand,Gumla,Raidih,196,0,17,hab,17,0,26,170,179,16,4934,204,22.927407767000435,84.41251686915527,0
Jharkhand,Gumla,Sisai,286,1,11,hab,11,0,37,249,275,16,5686,204,23.196139987215986,84.72638180597761,0
Jharkhand,Hazaribagh,Barhi,130,0,10,hab,10,0,16,114,120,16,597,220,24.275944094829125,85.47778256992719,0
Jharkhand,Hazaribagh,Barkagaon,168,2,12,hab,9,3,8,160,156,16,607,220,23.813624171427843,85.25992373667114,0
Jharkhand,Hazaribagh,Barkatha,129,2,2,hab,2,0,4,125,127,16,608,220,24.219582042484653,85.67410029734253,0
Jharkhand,Hazaribagh,Bishnugarh,173,0,28,hab,24,4,29,144,145,16,981,220,23.9998759990526,85.76090291050625,0
Jharkhand,Hazaribagh,Chauparan,244,3,28,hab,25,3,31,213,216,16,1205,220,24.404642895313383,85.27757832580883,0
Jharkhand,Hazaribagh,Churchu,118,0,12,hab,8,4,8,110,106,16,1364,220,23.84189535048999,85.46754061864284,0
Jharkhand,Hazaribagh,Hazaribagh Sadar,101,1,37,hab,34,3,45,56,64,16,2204,220,23.979090996960245,85.43907891367019,0
Jharkhand,Hazaribagh,Ichak,140,2,2,hab,2,0,3,137,138,16,2274,220,24.104980263849868,85.46637203448628,0
Jharkhand,Hazaribagh,Katkamsandi,193,2,43,hab,42,1,56,137,150,16,2838,220,24.066397977111308,85.26427016864,0
Jharkhand,Hazaribagh,Keredari,130,1,0,hab,0,0,0,130,130,16,2888,220,23.846588764427473,85.11319157140593,0
Jharkhand,Hazaribagh,Padma,41,0,6,hab,4,2,6,35,35,16,4416,220,24.199515946305514,85.36443843907145,0
Jharkhand,Jamtara,Jamtara Sadar,229,2,2,hab,1,1,2,227,227,16,2429,248,23.960936702118087,86.78085933473018,0
Jharkhand,Jamtara,Kundhit,245,1,1,hab,1,0,2,243,244,16,3260,248,23.98730556744988,87.14332310387573,0
Jharkhand,Jamtara,Nala,321,0,3,hab,3,0,9,312,318,16,4106,248,23.939057922727457,87.00149310319162,0
Jharkhand,Jamtara,Narayanpur,286,0,6,hab,6,0,25,261,280,16,4178,248,24.039771956504286,86.61823716456624,0
Jharkhand,Khunti,Arki,299,0,343,osm,311,32,292,7,-44,16,7064,619,22.95390004605257,85.50659130139817,0
Jharkhand,Khunti,Bundu,157,1,6,hab,6,0,15,142,151,16,7028,619,23.175551515282347,85.56690298759688,0
Jharkhand,Khunti,Karra,211,0,13,hab,11,2,19,192,198,16,6973,619,23.125482708719833,85.11377941258249,0
Jharkhand,Khunti,Khunti,227,0,12,hab,11,1,18,209,215,16,6974,619,23.10507567841549,85.3611674361366,0
Jharkhand,Khunti,Murhu,157,0,6,hab,5,1,7,150,151,16,6975,619,22.96741410088585,85.30850452067467,0
Jharkhand,Khunti,Rania,77,0,1,hab,1,0,2,75,76,16,6976,619,22.75848988956324,85.07653396775292,0
Jharkhand,Khunti,Sonahatu,155,0,34,hab,34,0,45,110,121,16,7027,619,23.209778586442336,85.74493621941075,0
Jharkhand,Khunti,Tamar,207,1,9,hab,6,3,10,197,198,16,7030,619,23.017718881180826,85.72111603302919,0
Jharkhand,Khunti,Torpa,194,0,5,hab,4,1,8,186,189,16,6977,619,22.933104065120173,85.11795207610687,0
Jharkhand,Koderma,Chandwara,75,0,43,hab,38,5,44,31,32,16,1174,301,24.428730527323985,85.44706334745766,0
Jharkhand,Koderma,Jainagar,111,0,17,hab,17,0,27,84,94,16,2356,301,24.355819044540155,85.66049538272172,0
Jharkhand,Koderma,Koderma Sadar,141,2,62,hab,59,3,82,59,79,16,3067,301,24.50790824301207,85.63240908364193,0
Jharkhand,Koderma,Markacho,134,1,15,hab,15,0,27,107,119,16,3733,301,24.41303235206963,85.79641557922353,0
Jharkhand,Koderma,Satgawn,111,0,53,hab,52,1,57,54,58,16,5437,301,24.72301398505662,85.77009421318341,0
Jharkhand,Latehar,Balumath,172,0,32,hab,29,3,25,147,140,16,478,329,23.875687291597565,84.75846006005104,0
Jharkhand,Latehar,Barwaidih,83,0,21,hab,19,2,19,64,62,16,627,329,23.777818774984183,84.16526385944135,0
Jharkhand,Latehar,Chandwa,84,0,31,hab,10,21,8,76,53,16,1172,329,23.669169156978786,84.7804921295999,0
Jharkhand,Latehar,Garu,80,0,22,hab,19,3,30,50,58,16,1886,329,23.6112241748314,84.22566560710557,0
Jharkhand,Latehar,Latehar Sadar,180,1,2,hab,2,0,5,175,178,16,3385,329,23.744423556170467,84.51030325081601,0
Jharkhand,Latehar,Mahuatand,104,0,13,hab,6,7,8,96,91,16,3544,329,23.452896067121408,84.12284664283017,0
Jharkhand,Latehar,Manika,106,0,1,hab,1,0,1,105,105,16,3678,329,23.846629589708346,84.38612579839715,0
Jharkhand,Lohardaga,Bhandra,56,0,2,hab,2,0,3,53,54,16,795,333,23.36229843135235,84.82406080638201,0
Jharkhand,Lohardaga,Kisko,90,0,2,hab,2,0,6,84,88,16,3055,333,23.559923921525122,84.57121512174912,0
Jharkhand,Lohardaga,Kuru,76,0,2,hab,2,0,3,73,74,16,3293,333,23.523250855190646,84.80751916856221,0
Jharkhand,Lohardaga,Lohardaga Sadar,42,0,1,hab,1,0,1,41,41,16,3428,333,23.457640953321707,84.73205196765785,0
Jharkhand,Lohardaga,Senha,88,0,1,hab,1,0,1,87,87,16,5482,333,23.402003425798036,84.580443595848,0
Jharkhand,Pakur,Amrapara,121,2,0,hab,0,0,0,121,121,16,158,410,24.576575712746042,87.53456526519317,0
Jharkhand,Pakur,Hiranpur,119,2,3,hab,3,0,3,116,116,16,2227,410,24.666884726048178,87.73599137165496,0
Jharkhand,Pakur,Littipara,275,0,10,hab,10,0,19,256,265,16,3421,410,24.71399856850357,87.57499872007313,0
Jharkhand,Pakur,Maheshpur,322,0,8,hab,8,0,19,303,314,16,3526,410,24.479458768782997,87.70779602434676,0
Jharkhand,Pakur,Pakur Sadar,155,0,37,hab,37,0,46,109,118,16,4439,410,24.645079103391634,87.84297471956782,0
Jharkhand,Pakur,Pakuria,148,1,7,hab,7,0,7,141,141,16,4440,410,24.34012609962802,87.6503049621991,0
Jharkhand,Palamu,Bishrampur,185,1,18,hab,6,12,8,177,167,16,986,412,24.275618426525575,83.96692091207483,0
Jharkhand,Palamu,Chainpur,178,0,33,hab,31,2,36,142,145,16,1107,412,23.979150851578638,83.99256213389225,0
Jharkhand,Palamu,Chattarpur,221,0,24,hab,24,0,27,194,197,16,1198,412,24.342800271414667,84.22085214186238,0
Jharkhand,Palamu,Daltonganj Sadar,58,0,20,hab,13,7,15,43,38,16,1407,412,24.01393866457021,84.13103185570016,0
Jharkhand,Palamu,Hariharganj,144,0,2,hab,2,0,4,140,142,16,2147,412,24.48605127043826,84.22515232681262,0
Jharkhand,Palamu,Hussainabad,246,0,8,hab,7,1,12,234,238,16,2264,412,24.484607283013233,83.97615355307833,0
Jharkhand,Palamu,Lesliganj,115,0,1,hab,1,0,7,108,114,16,3408,412,24.037429340626357,84.23191265766279,0
Jharkhand,Palamu,Manatu,176,0,5,hab,5,0,16,160,171,16,3625,412,24.173854981413527,84.41894512321221,0
Jharkhand,Palamu,Panki,189,0,1,hab,1,0,1,188,188,16,4523,412,24.012163231744594,84.44707728928189,0
Jharkhand,Palamu,Patan,176,0,20,hab,20,0,28,148,156,16,4594,412,24.171148833894264,84.19709221299601,0
Jharkhand,Palamu,Satbarwa,63,0,1,hab,1,0,4,59,62,16,5435,412,23.92842006894533,84.27497073681799,0
Jharkhand,Pashchimi Singhbhum,Bendgaon,215,16,6,hab,6,0,10,205,209,16,718,595,22.757369940644885,85.42368173808731,0
Jharkhand,Pashchimi Singhbhum,Chaibasa,166,0,63,hab,62,1,88,78,103,16,1104,595,22.546393988143752,85.81599431685983,0
Jharkhand,Pashchimi Singhbhum,Chakradharpur,221,0,32,hab,31,1,43,178,189,16,1121,595,22.717524757165787,85.61998893057523,0
Jharkhand,Pashchimi Singhbhum,Goelkera,189,0,37,hab,35,2,41,148,152,16,1966,595,22.512737919047638,85.30974448029657,0
Jharkhand,Pashchimi Singhbhum,Jagannathpur,378,2,55,hab,54,1,158,220,323,16,2333,595,22.158531281090543,85.65704294531594,0
Jharkhand,Pashchimi Singhbhum,Jhinkpani,149,2,75,hab,67,8,106,43,74,16,2503,595,22.34718055065807,85.76649945415687,0
Jharkhand,Pashchimi Singhbhum,Khuntpani,235,0,75,hab,72,3,111,124,160,16,3024,595,22.5986981974233,85.71705512215489,0
Jharkhand,Pashchimi Singhbhum,Kurnardungi,304,0,27,hab,27,0,78,226,277,16,3286,595,22.17868593912271,85.88400484712807,0
Jharkhand,Pashchimi Singhbhum,Manjhari,85,1,25,hab,24,1,33,52,60,16,3687,595,22.321292349266336,85.89267208909891,0
Jharkhand,Pashchimi Singhbhum,Manjhgaon,128,0,27,hab,27,0,36,92,101,16,3689,595,22.055838623691027,85.85946114437019,0
Jharkhand,Pashchimi Singhbhum,Manoharpur,225,0,89,hab,80,9,78,147,136,16,3697,595,22.298011427976988,85.18719101170062,0
Jharkhand,Pashchimi Singhbhum,Noamundi,198,0,17,hab,10,7,10,188,181,16,4332,595,22.19903191374345,85.44248610810635,0
Jharkhand,Pashchimi Singhbhum,Sonua,183,0,10,hab,9,1,22,161,173,16,5740,595,22.678072302982955,85.31692475417006,0
Jharkhand,Pashchimi Singhbhum,Tantnagar,110,0,17,hab,17,0,25,85,93,16,5906,595,22.42559314402667,85.92745781421394,0
Jharkhand,Pashchimi Singhbhum,Tonto,207,0,31,hab,27,4,52,155,176,16,6129,595,22.395251609989508,85.58441144383096,0
Jharkhand,Purbi Singhbhum,Bahragora,403,2,20,hab,20,0,67,336,383,16,409,171,22.30743641557351,86.72148577752941,0
Jharkhand,Purbi Singhbhum,Chakulia,259,1,21,hab,20,1,51,208,238,16,1124,171,22.47218732398539,86.69546400294423,0
Jharkhand,Purbi Singhbhum,Dhalbhumgarh,139,0,16,hab,16,0,31,108,123,16,1543,171,22.472221889484345,86.55126653577483,0
Jharkhand,Purbi Singhbhum,Dumaria,96,0,6,hab,5,1,10,86,90,16,1694,171,22.415784328890116,86.39311526772859,0
Jharkhand,Purbi Singhbhum,Ghatsila,152,0,38,hab,36,2,72,80,114,16,1935,171,22.660139844126363,86.49725914873801,0
Jharkhand,Purbi Singhbhum,Jamshedpur Sadar,83,0,3,hab,2,1,3,80,80,16,2428,171,22.76951138095942,86.27480493153675,0
Jharkhand,Purbi Singhbhum,Musabani,46,0,12,hab,10,2,17,29,34,16,4016,171,22.547143085778707,86.41484676331048,0
Jharkhand,Purbi Singhbhum,Patamda,177,0,69,hab,58,11,71,106,108,16,4590,171,22.91451840790707,86.34429106258122,0
Jharkhand,Purbi Singhbhum,Potka,285,1,43,hab,37,6,71,214,242,16,4816,171,22.58782353235895,86.23688202729322,0
Jharkhand,Ramgarh,Gola,205,0,40,hab,38,2,52,153,165,16,6969,618,23.53303280107586,85.7638443599154,0
Jharkhand,Ramgarh,Mandu,198,1,15,hab,11,4,46,152,183,16,6970,618,23.767348031393652,85.54415925862116,0
Jharkhand,Ramgarh,Patratu,111,0,45,hab,31,14,33,78,66,16,6971,618,23.62041122065413,85.35302434128624,0
Jharkhand,Ramgarh,Ramgarh,80,0,30,hab,21,9,21,59,50,16,6972,618,23.57956280116559,85.59488648804931,0
Jharkhand,Ranchi,Angara,215,1,55,hab,53,2,61,154,160,16,193,458,23.385005754557543,85.58989418592158,0
Jharkhand,Ranchi,Bero,248,0,10,hab,10,0,10,238,238,16,729,458,23.30635234747235,85.01130325961218,0
Jharkhand,Ranchi,Burmu,233,1,18,hab,15,3,29,204,215,16,1080,458,23.60978137722728,85.10038533274232,0
Jharkhand,Ranchi,Chanho,168,0,4,hab,4,0,11,157,164,16,1177,458,23.51483415458628,84.99079147366216,0
Jharkhand,Ranchi,Kanke,174,0,2,hab,2,0,4,170,172,16,2725,458,23.456412146479288,85.31475657332172,0
Jharkhand,Ranchi,Lapung,171,0,25,hab,25,0,43,128,146,16,3380,458,23.13144752190943,84.97322787251827,0
Jharkhand,Ranchi,Mandar,108,0,1,hab,1,0,2,106,107,16,3642,458,23.426428170581744,85.07208546755585,0
Jharkhand,Ranchi,Namkum,279,0,10,hab,9,1,17,262,269,16,4125,458,23.272388243762197,85.39655203533772,0
Jharkhand,Ranchi,Ormanjhi,125,0,36,hab,36,0,37,88,89,16,4394,458,23.50654304281113,85.46401801846535,0
Jharkhand,Ranchi,Ratu,153,0,9,hab,8,1,14,139,144,16,5123,458,23.35943418175102,85.20815271405856,0
Jharkhand,Ranchi,Silli,155,0,28,hab,27,1,29,126,127,16,5631,458,23.361383260170097,85.78211476804292,0
Jharkhand,Sahibganj,Borio,268,0,26,hab,26,0,54,214,242,16,1036,476,25.082544897464444,87.60737309718371,0
Jharkhand,Sahibganj,Burhait,201,3,1,hab,1,0,2,199,200,16,1074,476,24.88820595888133,87.57318745318852,0
Jharkhand,Sahibganj,Burharwa,162,0,22,hab,21,1,55,107,140,16,1078,476,24.812318432427197,87.814118658577,0
Jharkhand,Sahibganj,Mandro,184,0,35,hab,34,1,51,133,149,16,3653,476,25.177424009240116,87.53900130723616,0
Jharkhand,Sahibganj,Patna,133,3,6,hab,6,0,14,119,127,16,4622,476,24.83353428257639,87.71291720361036,0
Jharkhand,Sahibganj,Rajmahal,101,0,7,hab,7,0,15,86,94,16,4986,476,25.07150211864508,87.78819705183795,0
Jharkhand,Sahibganj,Sahebganj Sadar,21,0,3,hab,1,2,5,16,18,16,5259,476,25.276360141228267,87.62815751856073,0
Jharkhand,Sahibganj,Taljhari,206,2,11,hab,11,0,23,183,195,16,5875,476,25.048019838610838,87.71445047891932,0
Jharkhand,Sahibganj,Udhwa,76,0,0,hab,0,0,0,76,76,16,6182,476,24.939360485759856,87.87520694485744,0
Jharkhand,Saraikela Kharsawan,Chandil,117,0,35,hab,27,8,37,80,82,16,1156,483,22.92365361469539,86.01488784356734,0
Jharkhand,Saraikela Kharsawan,Gamharia Adityapur,187,0,17,hab,14,3,29,158,170,16,1823,483,22.788885300010516,86.06543694066943,0
Jharkhand,Saraikela Kharsawan,Ichagarh,134,0,16,hab,15,1,14,120,118,16,2273,483,23.06757149084215,85.9131951282323,0
Jharkhand,Saraikela Kharsawan,Kharsawan,129,0,38,hab,38,0,49,80,91,16,2979,483,22.781709329691704,85.82658700830558,0
Jharkhand,Saraikela Kharsawan,Kuchai,150,0,44,hab,40,4,33,117,106,16,3216,483,22.854915222699816,85.7028357329564,0
Jharkhand,Saraikela Kharsawan,Nimdih,135,0,2,hab,2,0,2,133,133,16,4309,483,23.01614691373275,86.10645483461873,0
Jharkhand,Saraikela Kharsawan,Rajnagar Govindpur ,246,0,27,hab,26,1,58,188,219,16,4992,483,22.61582200859629,86.02259592903754,0
Jharkhand,Saraikela Kharsawan,Saraikela Sadar,169,0,44,hab,41,3,50,119,125,16,5396,483,22.74639114909006,85.93204427763584,0
Jharkhand,Simdega,Bano,1794,0,4,hab,4,0,65,1729,1790,16,534,506,22.637212523771087,84.97369453096428,0
Jharkhand,Simdega,Bolba,87,5,21,hab,15,6,21,66,66,16,1017,506,22.410664947580756,84.30035835829776,0
Jharkhand,Simdega,Jaldega,142,0,8,hab,8,0,11,131,134,16,2392,506,22.509292314625664,84.78849520076342,0
Jharkhand,Simdega,Kolebira,117,0,7,hab,7,0,19,98,110,16,3092,506,22.677532550815865,84.738720758094,0
Jharkhand,Simdega,Kurdeg,186,0,61,hab,54,7,58,128,125,16,3280,506,22.558552202524275,84.17008504343875,0
Jharkhand,Simdega,Simdega Sadar,168,0,31,hab,19,12,24,144,137,16,5639,506,22.685805075384906,84.43552712314346,0
Jharkhand,Simdega,Thcthaitanger,296,1,51,hab,46,5,71,225,245,16,6004,506,22.507295016323187,84.46781256285809,0
Karnataka,Bagalkot,Badami,165,0,140,hab,135,5,151,14,25,17,353,35,15.985267747147164,75.63312936249358,0
Karnataka,Bagalkot,Bagalkot,110,0,65,hab,64,1,79,31,45,17,371,35,16.211821239997345,75.76031953192758,0
Karnataka,Bagalkot,Bilgi,109,1,44,hab,44,0,62,47,65,17,946,35,16.34641344167918,75.58846703666268,0
Karnataka,Bagalkot,Hungund,156,0,123,hab,121,2,133,23,33,17,2257,35,16.056355506291116,76.07111359709302,0
Karnataka,Bagalkot,Jamakhandi,105,1,61,hab,60,1,74,31,44,17,2408,35,16.554812708148006,75.28501267155951,0
Karnataka,Bagalkot,Mudhol,95,4,61,hab,60,1,69,26,34,17,3947,35,16.297943941990603,75.29230755362724,0
Karnataka,Bangalore R,Devanahalli,218,0,163,hab,163,0,197,21,55,17,1523,45,13.258191800775888,77.70954217819174,0
Karnataka,Bangalore R,Doddaballapur,432,1,214,hab,211,3,326,106,218,17,1653,45,13.334866022583698,77.47355804170363,0
Karnataka,Bangalore R,Hosakote,282,0,223,hab,219,4,264,18,59,17,2242,45,13.093724766496276,77.85109499053013,0
Karnataka,Bangalore R,Nelamangala,430,1,153,hab,153,0,308,122,277,17,4271,45,13.174676099491792,77.31330698940661,0
Karnataka,Bangalore U,Anekal,353,1,117,hab,114,3,196,157,236,17,191,46,12.791354984533205,77.69480444612141,0
Karnataka,Bangalore U,Bangalore(E),124,1,69,hab,62,7,84,40,55,17,503,46,13.004863911446899,77.70377750771614,0
Karnataka,Bangalore U,Bangalore(N),370,0,138,hab,135,3,234,136,232,17,504,46,13.08235326588148,77.54650302829175,0
Karnataka,Bangalore U,Bangalore(S),326,1,87,hab,85,2,172,154,239,17,505,46,12.88501923520662,77.49515778518264,0
Karnataka,Belgaum,Athani,195,0,93,hab,85,8,96,99,102,17,284,63,16.738452418764705,75.05999218054392,0
Karnataka,Belgaum,Bailahongala,132,0,122,hab,117,5,121,11,10,17,417,63,15.741675673135328,74.79902322663062,0
Karnataka,Belgaum,Belgaum,177,0,134,hab,127,7,143,34,43,17,701,63,15.866571903894084,74.5295404789032,0
Karnataka,Belgaum,Chikkodi,181,1,119,hab,117,2,126,55,62,17,1283,63,16.459824593752135,74.53096176235951,0
Karnataka,Belgaum,Gokak,160,1,111,hab,105,6,124,36,49,17,1976,63,16.18219809497226,74.91150204041367,0
Karnataka,Belgaum,Hukkeri,161,0,124,hab,120,4,123,38,37,17,2253,63,16.192321381802262,74.56762386148885,0
Karnataka,Belgaum,Khanapur,297,0,197,hab,184,13,221,76,100,17,2947,63,15.586709235332647,74.47399345496216,0
Karnataka,Belgaum,Raibag,138,2,54,hab,50,4,56,82,84,17,4932,63,16.47857736119959,74.85741581482651,0
Karnataka,Belgaum,Ramadurga,130,0,98,hab,96,2,106,24,32,17,5021,63,16.007319819480095,75.26648324102302,0
Karnataka,Belgaum,Soundatti,136,0,102,hab,101,1,111,25,34,17,5749,63,15.857127865055153,75.06129449490865,0
Karnataka,Bellary,Bellary,194,2,103,hab,92,11,116,78,91,17,709,64,15.222039529568516,76.92339327537209,0
Karnataka,Bellary,Hadagali,106,0,79,hab,75,4,84,22,27,17,2099,64,14.950086562380989,75.88952665985926,0
Karnataka,Bellary,Hagaribommanahalli,117,1,90,hab,86,4,97,20,27,17,2101,64,15.06405695542233,76.19811613352614,0
Karnataka,Bellary,Hospet,139,0,84,hab,77,7,92,47,55,17,2247,64,15.250393799755047,76.50280495438372,0
Karnataka,Bellary,Kudligi,208,0,166,hab,149,17,172,36,42,17,3222,64,14.776520528378793,76.42848627411182,0
Karnataka,Bellary,Sandoor,130,0,90,hab,87,3,99,31,40,17,5343,64,15.055232555391598,76.5822239726009,0
Karnataka,Bellary,Siruguppa,126,0,77,hab,73,4,87,39,49,17,5684,64,15.566782197561718,76.93482924352244,0
Karnataka,Bidar,Aurad,334,2,154,hab,149,5,192,142,180,17,311,77,18.22547837753002,77.37628533642656,0
Karnataka,Bidar,Basavanakalyan,209,0,140,hab,135,5,169,40,69,17,638,77,17.81318386452,76.91757527211333,0
Karnataka,Bidar,Bhalki,155,0,145,hab,138,7,141,14,10,17,785,77,18.03903436280821,77.19191472385312,0
Karnataka,Bidar,Bidar,161,1,124,hab,120,4,132,29,37,17,909,77,17.877241080755933,77.46704041552702,0
Karnataka,Bidar,Humnabad,123,0,95,hab,92,3,104,19,28,17,2256,77,17.749345269199722,77.22525244712469,0
Karnataka,Bijapur,Basavanabagevadi,167,2,113,hab,108,5,126,41,54,17,637,78,16.561244582456727,75.92507371544178,0
Karnataka,Bijapur,Bijapur,324,0,114,hab,109,5,147,177,210,17,924,78,16.78874548955869,75.6507997126638,0
Karnataka,Bijapur,Indi,243,1,124,hab,113,11,149,94,119,17,2294,78,17.19420418999888,75.88197127535507,0
Karnataka,Bijapur,Muddebihal,183,0,130,hab,126,4,156,27,53,17,3946,78,16.384730096218934,76.2082269345246,0
Karnataka,Bijapur,Sindagi,183,5,121,hab,110,11,125,58,62,17,5646,78,16.885849103753277,76.24332061437264,0
Karnataka,Chamarajanagar,CR Nagar,272,3,177,hab,173,4,218,54,95,17,1374,98,11.908290322076788,76.95452966990904,0
Karnataka,Chamarajanagar,Gundlupet,206,0,149,hab,149,0,169,37,57,17,2071,98,11.778983879936579,76.64903687492377,0
Karnataka,Chamarajanagar,Kollegala,312,0,137,hab,135,2,175,137,175,17,3096,98,12.062035253111791,77.3808855519127,0
Karnataka,Chamarajanagar,Yelandur,56,3,30,hab,29,1,39,17,26,17,6455,98,12.02364204290581,77.0938275672229,0
Karnataka,Chickballapur,Bagepalli,389,2,157,hab,156,1,262,127,232,17,376,111,13.782874344473164,77.93860913025792,0
Karnataka,Chickballapur,Chickballapur,310,0,160,hab,159,1,242,68,150,17,1274,111,13.491908741012761,77.7345247811733,0
Karnataka,Chickballapur,Chinthamani,422,0,280,hab,273,7,358,64,142,17,1309,111,13.47663481116544,78.07196910179096,0
Karnataka,Chickballapur,Gowribidanur,342,0,197,hab,194,3,277,65,145,17,2031,111,13.593214990129887,77.53636692717038,0
Karnataka,Chickballapur,Gudibanda,125,0,61,hab,59,2,97,28,64,17,2038,111,13.685579778212484,77.75166375410787,0
Karnataka,Chickballapur,Sidlaghatta,283,0,178,hab,176,2,228,55,105,17,5613,111,13.453066431981622,77.89786032634095,0
Karnataka,Chickmagalur,Chickmagalur,532,2,151,hab,147,4,259,273,381,17,1276,112,13.363187307516457,75.72043058880016,0
Karnataka,Chickmagalur,Kadur,460,0,197,hab,193,4,295,165,263,17,2572,112,13.545187598916426,76.0762871870463,0
Karnataka,Chickmagalur,Koppa,797,12,60,hab,59,1,233,564,737,17,3128,112,13.454456217710408,75.34078158503279,0
Karnataka,Chickmagalur,Mudigere,489,1,85,hab,84,1,198,291,404,17,3949,112,13.154751479330661,75.4809001513284,0
Karnataka,Chickmagalur,Narasimharajapura,448,0,52,hab,52,0,178,270,396,17,4166,112,13.567609095577483,75.50500758718684,0
Karnataka,Chickmagalur,Sringeri,509,1,57,hab,57,0,285,224,452,17,5765,112,13.379222398418456,75.20580973192759,0
Karnataka,Chickmagalur,Tarikere,244,0,164,hab,149,15,180,64,80,17,5924,112,13.70278853937333,75.85960759449816,0
Karnataka,Chitradurga,Challakere,327,1,175,hab,169,6,227,100,152,17,1128,113,14.3616574083497,76.72173980685297,0
Karnataka,Chitradurga,Chitradurga,275,0,190,hab,186,4,230,45,85,17,1324,113,14.275302384626203,76.35117857516765,0
Karnataka,Chitradurga,Hiriyur,360,0,170,hab,166,4,249,111,190,17,2229,113,13.972527198131946,76.65053705190836,0
Karnataka,Chitradurga,Holalkere,230,1,139,hab,133,6,177,53,91,17,2237,113,14.05133505938175,76.19560325970714,0
Karnataka,Chitradurga,Hosadurga,354,1,152,hab,145,7,227,127,202,17,2241,113,13.78614398242005,76.3449112818033,0
Karnataka,Chitradurga,Molakalmur,151,0,80,hab,78,2,115,36,71,17,3907,113,14.791405329691266,76.73621504129692,0
Karnataka,Dakshina Kannada,Bantwal,1040,10,100,hab,99,1,429,611,940,17,546,127,12.845108390941627,75.07215232245534,0
Karnataka,Dakshina Kannada,Belthangadi,1347,14,52,hab,52,0,275,1072,1295,17,713,127,12.998426175197839,75.32305579193611,0
Karnataka,Dakshina Kannada,Mangalore,847,6,145,hab,126,19,402,445,702,17,3664,127,12.996330283381477,74.92077969512702,0
Karnataka,Dakshina Kannada,Puttur,980,4,72,hab,71,1,250,730,908,17,4890,127,12.751729949000488,75.37591769316238,0
Karnataka,Dakshina Kannada,Sulya,735,11,64,hab,60,4,256,479,671,17,5801,127,12.598373270438428,75.47470410812998,0
Karnataka,Davanagere,Chennagiri,276,0,182,hab,178,4,226,50,94,17,1232,137,14.072945375028462,75.92247161633846,0
Karnataka,Davanagere,Davanagere,240,4,164,hab,152,12,193,47,76,17,1471,137,14.393185859310206,75.99107579670331,0
Karnataka,Davanagere,Harapanahalli,253,1,172,hab,170,2,203,50,81,17,2139,137,14.722049135349206,75.98201967951363,0
Karnataka,Davanagere,Harihara,84,1,78,hab,75,3,79,5,6,17,2146,137,14.440515003063922,75.76545611084646,0
Karnataka,Davanagere,Honnali,196,2,120,hab,118,2,153,43,76,17,2239,137,14.194860364114524,75.63786556360681,0
Karnataka,Davanagere,Jagalur,188,0,131,hab,130,1,157,31,57,17,2331,137,14.552754262822333,76.2916305250253,0
Karnataka,Dharwad,Dharwad,128,0,89,hab,82,7,86,42,39,17,1600,149,15.490186172173894,74.96029537813759,0
Karnataka,Dharwad,Hubli,49,0,53,osm,47,6,47,2,-4,17,2252,149,15.351168904727183,75.19352226040198,0
Karnataka,Dharwad,Kalghatgi,104,0,86,hab,86,0,94,10,18,17,2625,149,15.191816822261472,74.97888648916489,0
Karnataka,Dharwad,Kundgol,59,0,54,hab,53,1,56,3,5,17,3259,149,15.203770413602555,75.29908675936163,0
Karnataka,Dharwad,Navalgund,58,0,55,hab,54,1,54,4,3,17,4237,149,15.550041336508798,75.34460821632118,0
Karnataka,Gadag,Gadag,71,1,56,hab,55,1,59,12,15,17,1793,186,15.423675106523284,75.61762959410144,0
Karnataka,Gadag,Mundargi,75,0,58,hab,56,2,65,10,17,17,3988,186,15.224642451618722,75.80518222958526,0
Karnataka,Gadag,Nargund,31,0,31,hab,30,1,31,0,0,17,4183,186,15.75696348718814,75.41783836421908,0
Karnataka,Gadag,Ron,120,1,97,hab,96,1,106,14,23,17,5191,186,15.700055492209675,75.75016307060577,0
Karnataka,Gadag,Shirhatti,96,1,87,hab,85,2,91,5,9,17,5573,186,15.116005825834447,75.58678645478972,0
Karnataka,Gulbarga,Afzalpur,133,0,70,hab,69,1,86,47,63,17,26,203,17.248491935782692,76.40312596630919,0
Karnataka,Gulbarga,Aland,199,0,136,hab,135,1,162,37,63,17,74,203,17.538153446039487,76.59575502733762,0
Karnataka,Gulbarga,Chincholi,201,1,148,hab,140,8,154,47,53,17,1294,203,17.456566817257666,77.34449650510105,0
Karnataka,Gulbarga,Chittapur,191,0,126,hab,123,3,144,47,65,17,1330,203,17.15372124165079,77.05293737436014,0
Karnataka,Gulbarga,Gulbarga,191,0,122,hab,118,4,139,52,69,17,2060,203,17.36834668783977,76.8655364654646,0
Karnataka,Gulbarga,Jewargi,168,0,128,hab,124,4,143,25,40,17,2482,203,16.939715288582136,76.63475862359793,0
Karnataka,Gulbarga,Sedam,154,0,99,hab,98,1,111,43,55,17,5462,203,17.07942319654073,77.31786099905605,0
Karnataka,Hassan,Alur,345,2,105,hab,102,3,220,125,240,17,101,217,12.920454299787222,75.9527639900255,0
Karnataka,Hassan,Arakalgud,421,3,202,hab,199,3,343,78,219,17,217,217,12.68233313774642,76.06258893558078,0
Karnataka,Hassan,Arasikere,758,4,251,hab,244,7,506,252,507,17,226,217,13.31514639586139,76.25023467920359,0
Karnataka,Hassan,Belur,745,5,112,hab,108,4,329,416,633,17,715,217,13.150464845457362,75.90342596311335,0
Karnataka,Hassan,Channarayapatna,629,4,215,hab,209,6,390,239,414,17,1180,217,12.973147320773176,76.44497764480153,0
Karnataka,Hassan,Hassan,697,2,266,hab,254,12,524,173,431,17,2181,217,13.006884856645284,76.13678332687225,0
Karnataka,Hassan,Holenarasipur,369,1,199,hab,197,2,329,40,170,17,2238,217,12.759876075602556,76.25254005064522,0
Karnataka,Hassan,Sakaleshpur,629,5,160,hab,157,3,412,217,469,17,5284,217,12.863396651808651,75.74140926674947,0
Karnataka,Haveri,Byadgi,67,2,61,hab,58,3,59,8,6,17,1088,219,14.669888117939147,75.4361020336854,0
Karnataka,Haveri,Hangal,151,0,149,hab,138,11,142,9,2,17,2123,219,14.75261935394084,75.17693029836737,0
Karnataka,Haveri,Haveri,90,0,92,osm,87,5,88,2,-2,17,2196,219,14.840693764146774,75.50547324375458,0
Karnataka,Haveri,Hirekerur,126,0,119,hab,113,6,120,6,7,17,2228,219,14.453253037653052,75.45697186138061,0
Karnataka,Haveri,Ranibennur,110,0,105,hab,97,8,95,15,5,17,5092,219,14.608151125823916,75.65519879652416,0
Karnataka,Haveri,Savanur,65,0,53,hab,53,0,57,8,12,17,5453,219,14.97053969221573,75.3967244184312,0
Karnataka,Haveri,Shiggoan,94,0,87,hab,82,5,89,5,7,17,5563,219,15.010559340956506,75.19104925436334,0
Karnataka,Kodagu,Madikeri,640,46,64,hab,57,7,177,463,576,17,3492,300,12.369274449154817,75.61651370394944,0
Karnataka,Kodagu,Somavarpet,484,9,173,hab,162,11,317,167,311,17,5718,300,12.573598624256162,75.8474210163441,0
Karnataka,Kodagu,Virajpet,542,10,100,hab,85,15,174,368,442,17,6373,300,12.135346350967838,75.93493868531806,0
Karnataka,Kolar,Bangarpet,475,0,276,hab,273,3,380,95,199,17,507,304,12.941377203612586,78.24712336670194,0
Karnataka,Kolar,Kolar,352,0,250,hab,245,5,297,55,102,17,3088,304,13.169989804602816,78.10626142586904,0
Karnataka,Kolar,Malur,389,1,229,hab,227,2,329,60,160,17,3611,304,12.956396741298356,77.99084561222563,0
Karnataka,Kolar,Mulbagal,413,0,210,hab,209,1,310,103,203,17,3972,304,13.177427387215836,78.41869641244311,0
Karnataka,Kolar,Srinivasapura,385,3,228,hab,227,1,327,58,157,17,5766,304,13.40966042043446,78.26904020742317,0
Karnataka,Koppal,Gangavathi,277,25,110,hab,104,6,140,137,167,17,1851,308,15.538485484376208,76.52201253186108,0
Karnataka,Koppal,Koppal,166,11,139,hab,128,11,132,34,27,17,3129,308,15.333869970597581,76.16286555308358,0
Karnataka,Koppal,Kustagi,179,0,118,hab,114,4,136,43,61,17,3306,308,15.824415087263633,76.17138037248606,0
Karnataka,Koppal,Yelburga,157,0,132,hab,130,2,142,15,25,17,6456,308,15.554705769399968,76.05271489996706,0
Karnataka,Mandya,Krishnarajapet,395,18,255,hab,250,5,322,73,140,17,3206,356,12.67748836127102,76.48004505722734,0
Karnataka,Mandya,Maddur,277,1,180,hab,176,4,235,42,97,17,3476,356,12.611910008920008,77.0256020879208,0
Karnataka,Mandya,Malavalli,260,0,170,hab,160,10,209,51,90,17,3584,356,12.361959395216982,77.12035718698702,0
Karnataka,Mandya,Mandya,252,1,204,hab,201,3,229,23,48,17,3658,356,12.598014335429156,76.86068359503584,0
Karnataka,Mandya,Nagamangala,509,6,251,hab,249,2,388,121,258,17,4058,356,12.85917539340279,76.73824832600799,0
Karnataka,Mandya,Pandavapura,199,0,128,hab,127,1,172,27,71,17,4509,356,12.549577333748807,76.64604788611192,0
Karnataka,Mandya,Srirangapatna,116,0,90,hab,88,2,103,13,26,17,5769,356,12.412972194953442,76.73674698033608,0
Karnataka,Mysore,Heggadadevanakote,384,0,192,hab,180,12,256,128,192,17,2205,377,11.991471082619299,76.33226074181812,0
Karnataka,Mysore,Hunsur,305,2,224,hab,216,8,259,46,81,17,2259,377,12.287191664426489,76.30491623673994,0
Karnataka,Mysore,Krishnarajanagar,217,0,153,hab,151,2,181,36,64,17,3205,377,12.515568439634421,76.31458728815942,0
Karnataka,Mysore,Mysore,213,1,154,hab,148,6,171,42,59,17,4039,377,12.278401307626005,76.62456243297386,0
Karnataka,Mysore,Nanjangud,266,0,198,hab,195,3,216,50,68,17,4156,377,12.066341732069146,76.67308538132612,0
Karnataka,Mysore,Periyapatna,310,0,184,hab,182,2,252,58,126,17,4712,377,12.405321213978489,76.0784308247375,0
Karnataka,Mysore,T.Narasipur,198,1,143,hab,141,2,173,25,55,17,5844,377,12.25461481483539,76.92987484311627,0
Karnataka,Raichur,Deodurga,318,0,115,hab,114,1,138,180,203,17,1497,445,16.34598482187078,76.97010973516932,0
Karnataka,Raichur,Lingasugur,319,0,145,hab,144,1,187,132,174,17,3419,445,16.10209191105267,76.5165980225203,0
Karnataka,Raichur,Manvi,323,4,133,hab,131,2,176,147,190,17,3717,445,16.055835862802375,76.9719009790131,0
Karnataka,Raichur,Raichur,204,1,128,hab,128,0,145,59,76,17,4933,445,16.188088867362925,77.36632189456596,0
Karnataka,Raichur,Sindhanur,296,0,108,hab,106,2,155,141,188,17,5647,445,15.783517795705546,76.73097177604735,0
Karnataka,Ramnagar,Channapatna,278,1,119,hab,117,2,199,79,159,17,1179,456,12.629712482262448,77.18126006934017,0
Karnataka,Ramnagar,Kanakpur,682,2,229,hab,223,6,433,249,453,17,2692,456,12.497850899216521,77.45681937251007,0
Karnataka,Ramnagar,Magadi,585,0,150,hab,149,1,329,256,435,17,3502,456,13.006571485671882,77.21209033343038,0
Karnataka,Ramnagar,Ramanagar,373,1,130,hab,127,3,232,141,243,17,5024,456,12.753353823653038,77.32354823911525,0
Karnataka,Shimoga,Bhadravathi,268,3,145,hab,138,7,227,41,123,17,759,498,13.90136626162593,75.74229740992487,0
Karnataka,Shimoga,Hosanagar,1196,47,97,hab,95,2,271,925,1099,17,2243,498,13.888663420116135,75.10442720331659,0
Karnataka,Shimoga,Sagar,1172,2,80,hab,74,6,178,994,1092,17,5242,498,14.114566646165015,74.94335670946529,0
Karnataka,Shimoga,Shikaripur,216,1,150,hab,149,1,188,28,66,17,5565,498,14.3025480112848,75.344626422098,0
Karnataka,Shimoga,Shimoga,313,3,169,hab,153,16,233,80,144,17,5569,498,13.960132653360475,75.51114880958954,0
Karnataka,Shimoga,Soraba,405,4,271,hab,269,2,341,64,134,17,5743,498,14.441790854324722,75.0946534104875,0
Karnataka,Shimoga,Thirthahalli,1210,22,128,hab,122,6,430,780,1082,17,6017,498,13.704291793040545,75.25954260121308,0
Karnataka,Tumkur,C.N.Halli,574,1,182,hab,179,3,390,184,392,17,1091,558,13.514118876730693,76.57890856082759,0
Karnataka,Tumkur,Gubbi,821,5,211,hab,208,3,536,285,610,17,2033,558,13.358601859147708,76.86228098584616,0
Karnataka,Tumkur,Koratagere,446,1,154,hab,153,1,328,118,292,17,3133,558,13.502706615338143,77.25009641734532,0
Karnataka,Tumkur,Kunigal,830,2,221,hab,215,6,567,263,609,17,3264,558,12.94024055829385,77.00381956575488,0
Karnataka,Tumkur,Madhugiri,487,1,255,hab,248,7,425,62,232,17,3487,558,13.724294640861594,77.23908975745324,0
Karnataka,Tumkur,Pavagada,379,3,182,hab,177,5,332,47,197,17,4644,558,14.159452949595808,77.24852034192796,0
Karnataka,Tumkur,Sira,558,0,245,hab,239,6,431,127,313,17,5666,558,13.765634148325546,76.8790939776951,0
Karnataka,Tumkur,Tiptur,450,2,172,hab,171,1,309,141,278,17,6092,558,13.266177276304445,76.49821857759825,0
Karnataka,Tumkur,Tumkur,614,3,266,hab,258,8,458,156,348,17,6149,558,13.33206156536314,77.09913356406993,0
Karnataka,Tumkur,Turuvekere,493,1,163,hab,157,6,325,168,330,17,6159,558,13.144889030843565,76.71786605483393,0
Karnataka,Udupi,Karkala,1057,13,64,hab,63,1,289,768,993,17,2785,563,13.292931322004947,75.01445377450214,0
Karnataka,Udupi,Kundapura,1171,3,108,hab,103,5,372,799,1063,17,3258,563,13.714669197567913,74.81170982382729,0
Karnataka,Udupi,Udupi,1199,4,142,hab,139,3,598,601,1057,17,6185,563,13.370399345251306,74.81037477260504,0
Karnataka,Uttara Kannada,Ankola,479,0,77,hab,77,0,274,205,402,17,201,571,14.703006901806194,74.44438520975814,0
Karnataka,Uttara Kannada,Bhatkal,775,3,23,hab,22,1,240,535,752,17,818,571,14.043656098442423,74.5823019624734,0
Karnataka,Uttara Kannada,Haliyal,189,0,86,hab,84,2,119,70,103,17,2115,571,15.253035810747246,74.7363867072502,0
Karnataka,Uttara Kannada,Honnavara,1206,2,84,hab,83,1,661,545,1122,17,2240,571,14.266007901805144,74.5618889947127,0
Karnataka,Uttara Kannada,Joida/ Supa),538,0,101,hab,95,6,200,338,437,17,2521,571,15.20025323939569,74.44300377311617,0
Karnataka,Uttara Kannada,Karwar,591,0,55,hab,50,5,370,221,536,17,2803,571,14.873055931520971,74.28286844789767,0
Karnataka,Uttara Kannada,Kumta,597,1,90,hab,90,0,367,230,507,17,3251,571,14.480248798553252,74.49167170503948,0
Karnataka,Uttara Kannada,Mundagod,210,4,97,hab,94,3,156,54,113,17,3986,571,14.904801616715586,74.98950694652986,0
Karnataka,Uttara Kannada,Siddapura,1380,2,162,hab,160,2,743,637,1218,17,5601,571,14.37946925814097,74.80174911892507,0
Karnataka,Uttara Kannada,Sirsi,1599,0,220,hab,212,8,814,785,1379,17,5681,571,14.637252452492778,74.78924368793997,0
Karnataka,Uttara Kannada,Yellapura,1233,0,99,hab,99,0,405,828,1134,17,6462,571,14.929514329712486,74.73241499631688,0
Karnataka,Yadgir,Shahpur,196,0,153,hab,143,10,160,36,43,17,5517,598,16.660628965434064,76.93316051303177,0
Karnataka,Yadgir,Shorapur,244,0,158,hab,153,5,175,69,86,17,5592,598,16.49232068340936,76.56416556061798,0
Karnataka,Yadgir,Yadgiri,234,0,180,hab,176,4,205,29,54,17,6446,598,16.736704503225784,77.26320563594695,0
Kerala,Alappuzha,Ambalapuzha,142,5,6,hab,6,0,44,98,136,18,130,8,9.392983578875874,76.36836336857817,0
Kerala,Alappuzha,Aryad,142,8,3,hab,3,0,26,116,139,18,255,8,9.575225619158061,76.35448648797599,0
Kerala,Alappuzha,Bharanikavu,283,10,42,hab,42,0,122,161,241,18,804,8,9.170949321801295,76.60395634088373,0
Kerala,Alappuzha,Champakulam,165,14,10,hab,10,0,45,120,155,18,1136,8,9.42799619681286,76.42145429744468,0
Kerala,Alappuzha,Chengannur,266,12,7,hab,7,0,43,223,259,18,1231,8,9.29080630386704,76.5978432742803,0
Kerala,Alappuzha,Haripad,230,22,2,hab,2,0,25,205,228,18,2152,8,9.297291763833083,76.44410334986901,0
Kerala,Alappuzha,Kanjikuzhy,245,19,4,hab,4,0,28,217,241,18,2721,8,9.654283536998252,76.3375712285697,0
Kerala,Alappuzha,Mavelikara,410,42,7,hab,7,0,61,349,403,18,3780,8,9.252429735474125,76.5412221001107,0
Kerala,Alappuzha,Muthukulam,191,10,0,hab,0,0,0,191,191,18,4027,8,9.194640677972739,76.47619774813926,0
Kerala,Alappuzha,Pattanakkad,176,22,3,hab,3,0,19,157,173,18,4635,8,9.78083580525814,76.31079693318257,0
Kerala,Alappuzha,Thycattussery,100,5,8,hab,8,0,22,78,92,18,6072,8,9.798076607618757,76.35310617290915,0
Kerala,Alappuzha,Veliyanad,154,9,7,hab,7,0,38,116,147,18,6317,8,9.468364995325183,76.46094326468703,0
Kerala,Ernakulam,Alengad,71,0,31,hab,30,1,30,41,40,18,81,172,10.108250074901196,76.29673708972436,0
Kerala,Ernakulam,Ankamaly,157,13,13,hab,10,3,20,137,144,18,198,172,10.229228378776655,76.52006012833391,0
Kerala,Ernakulam,Edappally,35,3,1,hab,1,0,2,33,34,18,1726,172,10.023429813739268,76.25345201734687,0
Kerala,Ernakulam,Koovappady,92,7,20,hab,14,6,16,76,72,18,3124,172,10.134810338070926,76.53379678393154,0
Kerala,Ernakulam,Kothamangalam,176,12,42,hab,20,22,66,110,134,18,3165,172,10.146365579230109,76.78015672882049,0
Kerala,Ernakulam,Mulanthuruthy,86,3,17,hab,15,2,39,47,69,18,3969,172,9.88531551464153,76.4146184215455,0
Kerala,Ernakulam,Muvatupuzha,136,7,22,hab,15,7,34,102,114,18,4030,172,9.965476994925325,76.61435595749619,0
Kerala,Ernakulam,Palluruthy,65,0,4,hab,4,0,9,56,61,18,4479,172,9.88264006081407,76.29314185511991,0
Kerala,Ernakulam,Pampakuda,139,3,18,hab,16,2,43,96,121,18,4490,172,9.884534679662371,76.54188347493789,0
Kerala,Ernakulam,Parakkadavu,73,3,8,hab,6,2,12,61,65,18,4543,172,10.167107499737046,76.33086282398914,0
Kerala,Ernakulam,Paravur,55,2,8,hab,8,0,23,32,47,18,4556,172,10.133259434963511,76.23005070398112,0
Kerala,Ernakulam,Vadavucode,137,4,17,hab,13,4,36,101,120,18,6254,172,9.991300127548605,76.44898257501904,0
Kerala,Ernakulam,Vazhakkulam,107,2,5,hab,3,2,7,100,102,18,6298,172,10.07573758221873,76.41758750748045,0
Kerala,Ernakulam,Vypeen,43,0,6,hab,6,0,24,19,37,18,6394,172,10.095049908628864,76.20654517490574,0
Kerala,Idukki,Adimaly,247,7,15,hab,14,1,38,209,232,18,23,228,10.013181359697878,76.97817902686607,0
Kerala,Idukki,Azhutha,153,9,39,hab,31,8,47,106,114,18,328,228,9.527274460575084,77.13652278278374,0
Kerala,Idukki,Devikulam,147,5,22,hab,14,8,25,122,125,18,1532,228,10.152635129018613,77.13368423241292,0
Kerala,Idukki,Elemdesam,205,31,22,hab,17,5,47,158,183,18,1735,228,9.907587649082636,76.82999885377671,0
Kerala,Idukki,Idukki,208,30,26,hab,21,5,50,158,182,18,2280,228,9.837875445815602,76.95791204256912,0
Kerala,Idukki,Kattappana,162,23,69,hab,56,13,81,81,93,18,2851,228,9.720806860955628,77.09043028303233,0
Kerala,Idukki,Nedumkandom,125,11,35,hab,27,8,41,84,90,18,4264,228,9.873364425963295,77.16219351513536,0
Kerala,Idukki,Thodupuzha,200,18,17,hab,17,0,69,131,183,18,6047,228,9.882744904130709,76.70645983811998,0
Kerala,Kannur,Edakkad,164,7,14,hab,14,0,41,123,150,18,1725,272,11.884982016443974,75.44057429223683,0
Kerala,Kannur,Irikkur,192,2,39,hab,38,1,70,122,153,18,2306,272,12.047152086700414,75.56821217651054,0
Kerala,Kannur,Iritty,124,0,24,hab,19,5,31,93,100,18,2308,272,11.978505006859592,75.6993144572929,0
Kerala,Kannur,Kallyassery,132,0,19,hab,19,0,38,94,113,18,7109,272,12.00949151672597,75.30148089744957,0
Kerala,Kannur,Kannur,129,0,3,hab,3,0,26,103,126,18,2734,272,11.920684561272466,75.35375874528425,0
Kerala,Kannur,Kuthuparamba,142,0,25,hab,24,1,52,90,117,18,3311,272,11.817639877875184,75.64399388940109,0
Kerala,Kannur,Panoor,113,0,4,hab,4,0,12,101,109,18,7110,272,11.743785968797987,75.56820145497942,0
Kerala,Kannur,Payyanur,137,2,46,hab,34,12,45,92,91,18,4651,272,12.178802087339236,75.29920835332521,0
Kerala,Kannur,Peravoor,119,1,28,hab,25,3,47,72,91,18,4707,272,11.894689258859593,75.77459915385006,0
Kerala,Kannur,Taliparamba,169,0,54,hab,38,16,49,120,115,18,5874,272,12.120860565733913,75.42520765029937,0
Kerala,Kannur,Thalasseri,120,1,10,hab,10,0,30,90,110,18,5977,272,11.826699047131646,75.49825405827742,0
Kerala,Kasaragod,Kanhangad,99,1,71,hab,61,10,74,25,28,18,2716,283,12.378310930593432,75.1026092783341,0
Kerala,Kasaragod,Karadka,108,0,29,hab,16,13,18,90,79,18,7106,283,12.521042284796868,75.18756802213059,0
Kerala,Kasaragod,Kasaragod,123,0,29,hab,23,6,34,89,94,18,2804,283,12.549839845765629,75.02725962603422,0
Kerala,Kasaragod,Manjeshwar,143,0,38,hab,32,6,57,86,105,18,3684,283,12.683234777098294,74.99847994936977,0
Kerala,Kasaragod,Nileshwar,95,1,20,hab,15,5,25,70,75,18,4304,283,12.205051133301808,75.1921701666491,0
Kerala,Kasaragod,Parappa,115,4,99,hab,55,44,54,61,16,18,7107,283,12.370481444138115,75.29283861059602,0
Kerala,Kollam,Anchal,389,3,9,hab,9,0,39,350,380,18,180,307,8.943102720638635,77.07076456068452,0
Kerala,Kollam,Chadayamangalam,345,3,13,hab,13,0,58,287,332,18,1098,307,8.848005422272761,76.89926807823906,0
Kerala,Kollam,Chavara,182,0,5,hab,5,0,55,127,177,18,1210,307,8.989659754036824,76.55625247947641,0
Kerala,Kollam,Chittumala,160,0,11,hab,10,1,46,114,149,18,1334,307,8.967378657082051,76.62975805708798,0
Kerala,Kollam,Ithikkara,226,3,8,hab,8,0,56,170,218,18,2322,307,8.835743088358099,76.72465550734809,0
Kerala,Kollam,Kottarakkara,299,7,9,hab,9,0,45,254,290,18,3182,307,8.95641894076333,76.74774978537842,0
Kerala,Kollam,Mukhathala,231,10,4,hab,4,0,18,213,227,18,3961,307,8.8999495961848,76.6764341494594,0
Kerala,Kollam,Oachira,251,1,10,hab,10,0,73,178,241,18,4366,307,9.09335207706919,76.53726463747284,0
Kerala,Kollam,Pathanapuram,262,4,6,hab,6,0,22,240,256,18,4607,307,9.080560307147906,76.89997945061673,0
Kerala,Kollam,Sasthamkotta,366,1,13,hab,13,0,91,275,353,18,5430,307,9.06585828024332,76.63355482323095,0
Kerala,Kollam,Vettikkavala,363,3,31,hab,31,0,99,264,332,18,6349,307,9.006396014846663,76.78720144471372,0
Kerala,Kottayam,Erattupetta,47,0,38,hab,26,12,23,24,9,18,1746,313,9.701414683707446,76.80753791978472,0
Kerala,Kottayam,Ettumanoor,60,2,12,hab,8,4,14,46,48,18,1753,313,9.628667470223697,76.48272488434928,0
Kerala,Kottayam,Kaduthuruthy,72,3,14,hab,13,1,19,53,58,18,2573,313,9.776329382912834,76.48442991497953,0
Kerala,Kottayam,Kanjirappally,39,1,40,osm,14,26,15,24,-1,18,2722,313,9.52655438920247,76.8539189485926,0
Kerala,Kottayam,Lalam,43,1,68,osm,43,25,31,12,-25,18,3356,313,9.727831915079005,76.69392113178831,0
Kerala,Kottayam,Madappally,51,5,7,hab,7,0,7,44,44,18,3467,313,9.472821793233242,76.56836286007568,0
Kerala,Kottayam,Pallom,42,1,11,hab,10,1,11,31,31,18,4478,313,9.569169399540579,76.56806328987581,0
Kerala,Kottayam,Pampady,90,3,30,hab,24,6,32,58,60,18,4489,313,9.612043946120663,76.66290503072557,0
Kerala,Kottayam,Uzhavoor,52,0,47,hab,35,12,30,22,5,18,6248,313,9.765597754173337,76.59349234221304,0
Kerala,Kottayam,Vaikom,39,1,24,hab,22,2,13,26,15,18,6261,313,9.738093178805874,76.41354773935683,0
Kerala,Kottayam,Vazhoor,50,0,25,hab,19,6,18,32,25,18,6299,313,9.519928418797805,76.7055612433345,0
Kerala,Kozhikode,Balussery,222,3,83,hab,82,1,112,110,139,18,480,314,11.496579314934941,75.85435376859746,0
Kerala,Kozhikode,Chelannur,249,1,75,hab,75,0,163,86,174,18,1223,314,11.371829400306765,75.81533091934284,0
Kerala,Kozhikode,Koduvally,507,0,59,hab,58,1,133,374,448,18,3075,314,11.41851463064268,76.00332412921894,0
Kerala,Kozhikode,Kozhikode,37,0,12,hab,7,5,16,21,25,18,3196,314,11.187297311740634,75.84341433534726,0
Kerala,Kozhikode,Kunnamangulam,260,7,39,hab,39,0,103,157,221,18,3268,314,11.289389147489954,75.94074948157228,0
Kerala,Kozhikode,Kunnummel,306,6,32,hab,32,0,116,190,274,18,3270,314,11.684253501342702,75.77567460246237,0
Kerala,Kozhikode,Melady,154,6,7,hab,5,2,30,124,147,18,3827,314,11.51914721126005,75.66380051053802,0
Kerala,Kozhikode,Panthalayani,225,3,43,hab,22,21,48,177,182,18,4529,314,11.441613260037432,75.71757094449073,0
Kerala,Kozhikode,Perambra,378,14,32,hab,30,2,137,241,346,18,4704,314,11.584652336548766,75.80218622872505,0
Kerala,Kozhikode,Thodannur,142,1,6,hab,6,0,26,116,136,18,6046,314,11.593747381750193,75.65459906603701,0
Kerala,Kozhikode,Tuneri,172,0,8,hab,8,0,29,143,164,18,6154,314,11.722056038312475,75.67903122261137,0
Kerala,Kozhikode,Vadakara,126,0,4,hab,4,0,27,99,122,18,6250,314,11.653213909535683,75.58339281495265,0
Kerala,Malappuram,Areacode,299,11,82,hab,75,7,141,158,217,18,233,349,11.22144711308489,76.07386875907793,0
Kerala,Malappuram,Kalikavu,369,24,14,hab,13,1,58,311,355,18,7108,349,11.23891633293705,76.38426097246482,0
Kerala,Malappuram,Kondotty,295,10,32,hab,31,1,103,192,263,18,3118,349,11.179349445396166,75.93794722299798,0
Kerala,Malappuram,Kuttippuram,283,10,11,hab,11,0,61,222,272,18,3314,349,10.905575645934322,76.05197894939431,0
Kerala,Malappuram,Malappuram,219,15,36,hab,35,1,85,134,183,18,3582,349,11.06897243635812,76.08351555879271,0
Kerala,Malappuram,Mankada,238,8,57,hab,57,0,138,100,181,18,3692,349,10.99089741988913,76.13666435672054,0
Kerala,Malappuram,Nilambur,310,8,9,hab,9,0,33,277,301,18,4302,349,11.379800165237363,76.25177901918607,0
Kerala,Malappuram,Perinthalmanna,480,31,151,hab,149,2,256,224,329,18,4710,349,10.981852847739848,76.2499710935172,0
Kerala,Malappuram,Perumpadappu,169,9,4,hab,3,1,17,152,165,18,4716,349,10.730187103389026,75.99527998042855,0
Kerala,Malappuram,Ponani,136,0,12,hab,11,1,34,102,124,18,4798,349,10.799346982859735,75.98858678228524,0
Kerala,Malappuram,Tanur,170,1,24,hab,24,0,68,102,146,18,5909,349,10.957075381877399,75.92628805408563,0
Kerala,Malappuram,Tirur,177,2,14,hab,6,8,6,171,163,18,6105,349,10.866217771580553,75.93761930427428,0
Kerala,Malappuram,Tirurangadi,219,2,55,hab,54,1,116,103,164,18,6106,349,11.072104422965552,75.89135304721057,0
Kerala,Malappuram,Vengara,182,5,34,hab,33,1,68,114,148,18,6333,349,11.049558480141776,75.97721472203025,0
Kerala,Malappuram,Wandoor,273,11,10,hab,10,0,34,239,263,18,6414,349,11.173370402263094,76.20606661826163,0
Kerala,Palakkad,Alathur,261,6,10,hab,10,0,36,225,251,18,79,411,10.593019079882852,76.50124891806279,0
Kerala,Palakkad,Attappady,184,0,8,hab,7,1,23,161,176,18,304,411,11.10789381193121,76.5913173417822,0
Kerala,Palakkad,Chittur,212,8,10,hab,9,1,20,192,202,18,1335,411,10.724466780134886,76.81359405112215,0
Kerala,Palakkad,Kollengode,174,3,7,hab,7,0,17,157,167,18,3097,411,10.629745295711711,76.73072351080692,0
Kerala,Palakkad,Kuzhalmannam,174,4,7,hab,7,0,23,151,167,18,3316,411,10.723786075409954,76.5685677858535,0
Kerala,Palakkad,Malampuzha,141,3,5,hab,4,1,8,133,136,18,3581,411,10.840860162680139,76.700292247115,0
Kerala,Palakkad,Mannarkkad,165,3,19,hab,17,2,31,134,146,18,3695,411,10.99457939619668,76.46444304877423,0
Kerala,Palakkad,Nenmara,159,3,18,hab,17,1,31,128,141,18,4277,411,10.492258773639403,76.6872229285803,0
Kerala,Palakkad,Ottappalam,157,7,38,hab,38,0,62,95,119,18,4399,411,10.8185328003552,76.34741336764372,0
Kerala,Palakkad,Palakkad,118,3,15,hab,13,2,40,78,103,18,4445,411,10.821050195328276,76.53194997578706,0
Kerala,Palakkad,Pattambi,162,1,32,hab,32,0,82,80,130,18,4632,411,10.842185054651193,76.1801720811408,0
Kerala,Palakkad,S.K.Puram,116,5,37,hab,33,4,49,67,79,18,5221,411,10.903941272802589,76.4155460722457,0
Kerala,Palakkad,Thrithala,142,1,18,hab,18,0,49,93,124,18,6064,411,10.771891891774505,76.11161620603363,0
Kerala,Pathanamthitta,Elanthur,290,6,18,hab,18,0,118,172,272,18,1734,422,9.29470119319912,76.73884909275263,0
Kerala,Pathanamthitta,Koipuram,230,2,7,hab,7,0,39,191,223,18,3083,422,9.375583219756358,76.68330886198405,0
Kerala,Pathanamthitta,Konni,244,6,12,hab,10,2,53,191,232,18,3122,422,9.198777742386069,77.02258670031785,0
Kerala,Pathanamthitta,Mallappally,286,11,13,hab,13,0,72,214,273,18,3601,422,9.435454723992384,76.67634209605569,0
Kerala,Pathanamthitta,Pandalam,213,13,19,hab,19,0,82,131,194,18,4504,422,9.246233333490077,76.68572559142488,0
Kerala,Pathanamthitta,Parakode,409,26,16,hab,16,0,103,306,393,18,4544,422,9.141091743104687,76.78532937265972,0
Kerala,Pathanamthitta,Pulikeezh,217,21,4,hab,4,0,37,180,213,18,4846,422,9.364998878439042,76.53617857833746,0
Kerala,Pathanamthitta,Ranny,296,21,44,hab,42,2,110,186,252,18,5102,422,9.343885676464105,77.05610630775881,0
Kerala,Thiruvananthapuram,Athiyannur,116,0,6,hab,6,0,19,97,110,18,285,544,8.379235525735602,77.0274084557999,0
Kerala,Thiruvananthapuram,Chirayinkeezh,141,0,3,hab,3,0,13,128,138,18,1320,544,8.67853409328244,76.81586562590358,0
Kerala,Thiruvananthapuram,Kilimanoor,190,0,3,hab,3,0,7,183,187,18,3033,544,8.77679838559235,76.84265175447814,0
Kerala,Thiruvananthapuram,Nedumangad,198,16,4,hab,4,0,21,177,194,18,4263,544,8.617400340537724,76.98219475594749,0
Kerala,Thiruvananthapuram,Nemom,155,0,4,hab,4,0,20,135,151,18,4276,544,8.466775164614583,77.03785384418858,0
Kerala,Thiruvananthapuram,Parassala,170,6,19,hab,19,0,46,124,151,18,4552,544,8.345246324376548,77.1119711805005,0
Kerala,Thiruvananthapuram,Perumkadavila,175,0,5,hab,5,0,17,158,170,18,4715,544,8.495231773950316,77.18120594840542,0
Kerala,Thiruvananthapuram,Pothencode,132,1,4,hab,4,0,17,115,128,18,2872,544,8.615390591305268,76.85185845316595,0
Kerala,Thiruvananthapuram,Vamanapuram,248,24,6,hab,5,1,21,227,242,18,6279,544,8.737895413099496,77.03262932320986,0
Kerala,Thiruvananthapuram,Varkala,161,0,24,hab,24,0,48,113,137,18,6289,544,8.747522977567531,76.74997069869494,0
Kerala,Thiruvananthapuram,Vellanad,206,7,10,hab,10,0,35,171,196,18,6320,544,8.612593184222396,77.11703170489947,0
Kerala,Thrissur,Anthikkad,331,1,11,hab,11,0,106,225,320,18,210,546,10.454963814980157,76.13686056849838,0
Kerala,Thrissur,Chalakkudy,471,9,13,hab,8,5,72,399,458,18,1126,546,10.324820633465475,76.57463308511959,0
Kerala,Thrissur,Chavakkad,332,2,8,hab,7,1,54,278,324,18,1209,546,10.617338301932069,76.01746545592131,0
Kerala,Thrissur,Cherpu,198,0,0,hab,0,0,0,198,198,18,1242,546,10.44430027487614,76.2052817235041,0
Kerala,Thrissur,Chowannur,628,9,10,hab,10,0,108,520,618,18,1357,546,10.66017623096757,76.10313711045903,0
Kerala,Thrissur,Irinjalakuda,248,2,17,hab,17,0,96,152,231,18,2307,546,10.378267314722047,76.22421927430418,0
Kerala,Thrissur,Kodakara,520,5,28,hab,24,4,75,445,492,18,3063,546,10.418913151155028,76.39892307266724,0
Kerala,Thrissur,Mala,371,8,19,hab,19,0,133,238,352,18,3580,546,10.254778454545887,76.28675039868888,0
Kerala,Thrissur,Mathilakam,340,0,9,hab,9,0,82,258,331,18,3761,546,10.287557703570002,76.15335081774927,0
Kerala,Thrissur,Mullassery,246,6,3,hab,3,0,55,191,243,18,3975,546,10.54384441064972,76.0909781437858,0
Kerala,Thrissur,Ollukkara,382,20,2,hab,2,0,12,370,380,18,4383,546,10.530020293261115,76.3523916508891,0
Kerala,Thrissur,Pazhayannur,427,12,16,hab,16,0,123,304,411,18,4652,546,10.688691257564024,76.37080439934887,0
Kerala,Thrissur,Puzhakkal,324,10,5,hab,5,0,48,276,319,18,4892,546,10.577539261225892,76.17731197734747,0
Kerala,Thrissur,Thalikulam,322,8,8,hab,8,0,101,221,314,18,5978,546,10.448370322064903,76.08473857559936,0
Kerala,Thrissur,Vellangallur,392,17,33,hab,33,0,222,170,359,18,6321,546,10.297260532912329,76.21602160522876,0
Kerala,Thrissur,Wadakkanchery,350,41,7,hab,7,0,32,318,343,18,6398,546,10.676827763930259,76.24248867985035,0
Kerala,Wayanad,Kalpetta,289,8,42,hab,40,2,75,214,247,18,2654,587,11.590238926398754,76.064420512803,0
Kerala,Wayanad,Mananthavady,248,1,82,hab,73,9,117,131,166,18,3622,587,11.8205044071847,75.96157480373951,0
Kerala,Wayanad,Panamaram,277,4,23,hab,23,0,64,213,254,18,7105,587,11.761848128208165,76.13349422889998,0
Kerala,Wayanad,S.Battery,198,7,7,hab,7,0,15,183,191,18,5220,587,11.674297066977108,76.28501962945933,0
Ladakh,Kargil,Barsoo,20,0,27,osm,27,0,20,0,-7,37,7988,743,34.20917799981169,76.16157341684188,0
Ladakh,Kargil,Bhimbat,19,0,0,hab,0,0,0,19,19,37,7989,743,34.47037499326092,75.88926076993634,0
Ladakh,Kargil,Drass,19,0,14,hab,7,7,12,7,5,37,7760,743,34.39035971459554,75.57093585162394,0
Ladakh,Kargil,Kargil,46,0,33,hab,31,2,29,17,13,37,7761,743,34.53465788772897,76.09676266868625,0
Ladakh,Kargil,Karsha,24,0,43,osm,23,20,23,1,-19,37,7991,743,33.66279373828954,76.60407869695045,0
Ladakh,Kargil,LUNGNAK,23,0,39,osm,27,12,22,1,-16,37,7993,743,33.23786346432081,77.20440178675537,0
Ladakh,Kargil,Lotsum,20,0,6,hab,6,0,10,10,14,37,7992,743,34.47866078592796,76.29076664784736,0
Ladakh,Kargil,Pashkum,13,0,0,hab,0,0,0,13,13,37,7994,743,34.50347620929286,76.19284424933662,0
Ladakh,Kargil,Sankoo,21,0,22,osm,22,0,20,1,-1,37,7762,743,34.29360408502165,75.8769645458662,0
Ladakh,Kargil,Shakar Chiktan,53,0,30,hab,25,5,30,23,23,37,7763,743,34.41932133763173,76.51958125518019,0
Ladakh,Kargil,Shargole,30,0,17,hab,17,0,17,13,13,37,7764,743,34.33672635929128,76.32709113512405,0
Ladakh,Kargil,Soudh,25,0,8,hab,7,1,7,18,17,37,7997,743,34.63470931776199,76.3188493044347,0
Ladakh,Kargil,TSG,20,0,12,hab,12,0,20,0,8,37,7990,743,34.40193578214502,76.05066865182671,0
Ladakh,Kargil,Tai Suru,34,0,36,osm,34,2,34,0,-2,37,7765,743,34.03674363834552,76.16370694818707,0
Ladakh,Kargil,Zanaskar,16,0,19,osm,12,7,15,1,-3,37,7766,743,33.54568095956487,76.98293514070426,0
Ladakh,Leh,Chuchot,6,0,12,osm,4,8,4,2,-6,37,7977,742,33.993038105459846,77.56889839556061,0
Ladakh,Leh,Deskit,28,0,40,osm,26,14,26,2,-12,37,7978,742,34.586961398921005,77.64977048296856,0
Ladakh,Leh,Durbugh,32,0,71,osm,29,42,29,3,-39,37,7754,742,34.059078462578334,78.43759453085754,0
Ladakh,Leh,Khalsti,35,0,19,hab,11,8,16,19,16,37,7755,742,34.30554190020628,76.79779311831297,0
Ladakh,Leh,Kharu,33,0,48,osm,26,22,24,9,-15,37,7756,742,33.7687911550546,77.78914521592655,0
Ladakh,Leh,Leh,41,0,23,hab,18,5,20,21,18,37,7757,742,34.181472592373105,77.55860494755606,0
Ladakh,Leh,Nimoo,29,0,53,osm,27,26,23,6,-24,37,7979,742,33.96622535170957,77.31400604225414,0
Ladakh,Leh,Nyoma,9,0,41,osm,10,31,7,2,-32,37,7759,742,32.91206147731676,78.98522240224118,0
Ladakh,Leh,Panamic,25,0,30,osm,19,11,18,7,-5,37,7980,742,35.16934414927769,77.51213190881666,0
Ladakh,Leh,Rong,18,0,39,osm,16,23,15,3,-21,37,7981,742,33.51615590173278,78.22066916162044,0
Ladakh,Leh,Rupsho,11,0,50,osm,8,42,8,3,-39,37,7982,742,33.07005920918011,78.03047855835177,0
Ladakh,Leh,Saspol,22,0,21,hab,15,6,18,4,1,37,7983,742,34.272699457622515,77.10754609905707,0
Ladakh,Leh,Singay Lalok Wanla,19,0,25,osm,16,9,17,2,-6,37,7984,742,33.992928038136014,76.82966451508052,0
Ladakh,Leh,Skurbuchan,24,0,21,hab,11,10,16,8,3,37,7985,742,34.59030394739662,76.68014272039184,0
Ladakh,Leh,Thiksay,6,0,11,osm,8,3,6,0,-5,37,7986,742,34.082781084843994,77.72309049119482,0
Ladakh,Leh,Turtuk,8,0,12,osm,8,4,7,1,-4,37,7987,742,34.772048917428855,76.91553782178603,0
Madhya Pradesh,Agar,Agar,135,3,146,osm,118,28,116,19,-11,20,7111,639,23.666903761449664,76.05483937289178,0
Madhya Pradesh,Agar,Barod,142,2,131,hab,129,2,126,16,11,20,7112,639,23.79407402324158,75.88258769318148,0
Madhya Pradesh,Agar,Nalkheda,93,1,81,hab,78,3,80,13,12,20,7113,639,23.81552479082115,76.2468526668668,0
Madhya Pradesh,Agar,Susner,111,2,109,hab,100,9,100,11,2,20,7114,639,24.044031086726104,76.13268343783423,0
Madhya Pradesh,Alirajpur,Alirajpur,94,4,1,hab,1,0,1,93,93,20,90,10,22.289419229788376,74.41492710541931,0
Madhya Pradesh,Alirajpur,Bhabra,50,0,1,hab,0,1,0,50,49,20,746,10,22.555390060735757,74.34047938414851,0
Madhya Pradesh,Alirajpur,Jobat,63,0,2,hab,0,2,0,63,61,20,2517,10,22.39990950922082,74.58706944994437,0
Madhya Pradesh,Alirajpur,Katthiwara,121,0,0,hab,0,0,0,121,121,20,2853,10,22.370748400945164,74.1976204851442,0
Madhya Pradesh,Alirajpur,Sondwa,133,0,2,hab,2,0,2,131,131,20,5729,10,22.079617711031243,74.29935266707123,0
Madhya Pradesh,Alirajpur,Udaigarh,87,1,1,hab,1,0,1,86,86,20,6168,10,22.509708388264016,74.55426703673048,0
Madhya Pradesh,Anuppur,Annupur,87,0,17,hab,10,7,10,77,70,20,205,25,23.190793849503706,81.95889070392899,0
Madhya Pradesh,Anuppur,Jaithari,141,0,7,hab,3,4,3,138,134,20,2367,25,23.057984217529476,81.75260427605212,0
Madhya Pradesh,Anuppur,Kotma,69,0,30,hab,23,7,19,50,39,20,3176,25,23.295236091817696,82.0446060511447,0
Madhya Pradesh,Anuppur,Pushparajgarh,265,0,2,hab,1,1,1,264,263,20,4884,25,22.952806814454114,81.45599413151515,0
Madhya Pradesh,Ashok Nagar,Ashok Nagar,277,1,208,hab,199,9,219,58,69,20,258,29,24.549394495035568,77.6555315615938,0
Madhya Pradesh,Ashok Nagar,Chanderi,134,0,104,hab,94,10,98,36,30,20,1153,29,24.677789646059537,78.0756195059778,0
Madhya Pradesh,Ashok Nagar,Ishagarh,177,0,154,hab,142,12,151,26,23,20,2311,29,24.816832970359343,77.79564500153933,0
Madhya Pradesh,Ashok Nagar,Mungawali,231,0,160,hab,153,7,160,71,71,20,3994,29,24.418401534339857,78.00095262723184,0
Madhya Pradesh,Balaghat,Baihar,160,0,3,hab,2,1,2,158,157,20,413,39,22.097222362329806,80.7188150063807,0
Madhya Pradesh,Balaghat,Balaghat,155,0,35,hab,30,5,36,119,120,20,436,39,22.01491614266103,80.19979095847657,0
Madhya Pradesh,Balaghat,Birsa,148,4,9,hab,7,2,6,142,139,20,973,39,21.867338692051323,80.69941650757745,0
Madhya Pradesh,Balaghat,Katangi,125,0,8,hab,5,3,7,118,117,20,2823,39,21.698660218531387,79.73473350061583,0
Madhya Pradesh,Balaghat,Khairlanji,81,0,1,hab,1,0,1,80,80,20,2919,39,21.615786292756614,79.95629435430244,0
Madhya Pradesh,Balaghat,Kirnapur,134,0,13,hab,13,0,14,120,121,20,3046,39,21.66655902976009,80.38263135381663,0
Madhya Pradesh,Balaghat,Lalbarra,108,0,1,hab,1,0,1,107,107,20,3358,39,21.928045891744837,80.01354937453206,0
Madhya Pradesh,Balaghat,Lanji,132,0,2,hab,2,0,2,130,130,20,3377,39,21.497659753633883,80.58645863341,0
Madhya Pradesh,Balaghat,Paraswara,166,2,5,hab,4,1,5,161,161,20,4554,39,22.117134189689125,80.38300014265552,0
Madhya Pradesh,Balaghat,Waraseoni,76,0,0,hab,0,0,0,76,76,20,6418,39,21.740161342298386,80.04275349648346,0
Madhya Pradesh,Barwani,Barwani,95,0,1,hab,1,0,1,94,94,20,631,57,21.92725231534874,74.90045396202704,0
Madhya Pradesh,Barwani,Niwali,62,0,1,hab,1,0,1,61,61,20,4323,57,21.67599922997275,74.99232069231506,0
Madhya Pradesh,Barwani,Pansemal,101,0,6,hab,3,3,4,97,95,20,4526,57,21.712696835883534,74.69469491869769,0
Madhya Pradesh,Barwani,Pati,108,0,2,hab,1,1,1,107,106,20,4619,57,21.92482316417336,74.67492056717879,0
Madhya Pradesh,Barwani,Rajpur,98,0,1,hab,1,0,2,96,97,20,4996,57,21.86659648945526,75.14106858835378,0
Madhya Pradesh,Barwani,Sendhwa,152,0,8,hab,6,2,6,146,144,20,5478,57,21.55262573074258,75.29227229604862,0
Madhya Pradesh,Barwani,Thikri,95,0,2,hab,2,0,2,93,93,20,6010,57,22.042945692633243,75.22878424724841,0
Madhya Pradesh,Betul,Amla,153,0,0,hab,0,0,0,153,153,20,150,65,21.95421340355997,78.26001158908677,0
Madhya Pradesh,Betul,Athner,100,0,23,hab,22,1,23,77,77,20,287,65,21.55167336174585,77.86649748779878,0
Madhya Pradesh,Betul,Betul,188,0,3,hab,3,0,4,184,185,20,738,65,21.890367634771142,77.90171987593922,0
Madhya Pradesh,Betul,Bhainsdehi,132,0,4,hab,1,3,1,131,128,20,778,65,21.567172835497246,77.64006019885286,0
Madhya Pradesh,Betul,Bhimpur,151,1,0,hab,0,0,0,151,151,20,855,65,21.854058156401216,77.4330879665441,0
Madhya Pradesh,Betul,Chicholi,80,0,1,hab,1,0,2,78,79,20,1273,65,22.13605798396791,77.57632172366289,0
Madhya Pradesh,Betul,Ghoda Dongri,163,0,3,hab,3,0,3,160,160,20,1940,65,22.184251088755612,78.08673651441373,0
Madhya Pradesh,Betul,Multai,132,0,0,hab,0,0,0,132,132,20,3977,65,21.8015230925156,78.25818618212652,0
Madhya Pradesh,Betul,Prabhat Pattan,120,0,24,hab,21,3,21,99,96,20,4820,65,21.608510414599788,78.16274205671556,0
Madhya Pradesh,Betul,Shahpur,127,0,2,hab,2,0,1,126,125,20,5516,65,22.201859710269108,77.78349262512701,0
Madhya Pradesh,Bhind,Ater,184,0,164,hab,143,21,143,41,20,20,281,73,26.661667554881706,78.70645754226796,0
Madhya Pradesh,Bhind,Bhind,110,0,159,osm,103,56,84,26,-49,20,858,73,26.528031904273796,78.91822870685417,0
Madhya Pradesh,Bhind,Gohad,194,0,215,osm,180,35,170,24,-21,20,1973,73,26.370831265836305,78.47242042604164,0
Madhya Pradesh,Bhind,Lahar,172,1,132,hab,128,4,137,35,40,20,3325,73,26.11097260117164,78.8934266133142,0
Madhya Pradesh,Bhind,Mehgaon,210,1,211,osm,175,36,172,38,-1,20,3818,73,26.4725930889655,78.62444276197459,0
Madhya Pradesh,Bhind,Mihona (Ron),86,0,88,osm,75,13,74,12,-2,20,3856,73,26.3399702883769,78.96889498574797,0
Madhya Pradesh,Bhopal,Bersiya,288,0,239,hab,223,16,236,52,49,20,730,76,23.663399614477548,77.38467075394892,0
Madhya Pradesh,Bhopal,Phanda,224,0,7,hab,6,1,7,217,217,20,4727,76,23.26410509979449,77.39632468052302,0
Madhya Pradesh,Burhanpur,Burhanpur,133,0,3,hab,2,1,3,130,130,20,1076,95,21.333676705543365,76.22466828613712,0
Madhya Pradesh,Burhanpur,Khaknar,136,0,3,hab,3,0,3,133,133,20,2929,95,21.41365105544361,76.5235929089683,0
Madhya Pradesh,Chhatarpur,Badamalhara,152,0,51,hab,51,0,54,98,101,20,352,109,24.537064362051026,79.21281284594501,0
Madhya Pradesh,Chhatarpur,Bijawar,143,1,73,hab,72,1,71,72,70,20,929,109,24.56372623440755,79.62052573464992,0
Madhya Pradesh,Chhatarpur,Buxwaha,114,3,2,hab,2,0,2,112,112,20,1087,109,24.28900185187939,79.26812094354935,0
Madhya Pradesh,Chhatarpur,Chhatarpur,142,0,154,osm,140,14,131,11,-12,20,1257,109,24.886514058199477,79.52151974776005,0
Madhya Pradesh,Chhatarpur,Gaurihar,133,0,81,hab,79,2,84,49,52,20,1898,109,25.24531222168356,80.21438275243406,0
Madhya Pradesh,Chhatarpur,Laundi,148,0,140,hab,139,1,143,5,8,20,3392,109,25.09525399020479,80.0593055435858,0
Madhya Pradesh,Chhatarpur,Nowgong,117,0,128,osm,121,7,111,6,-11,20,4346,109,25.100531428667896,79.56945119415462,0
Madhya Pradesh,Chhatarpur,Rajnagar,134,0,167,osm,140,27,123,11,-33,20,4987,109,24.83821589226933,79.87058561312428,0
Madhya Pradesh,Chhindwara,Amarwara,149,0,1,hab,0,1,0,149,148,20,119,110,22.29771707186131,79.15473301462121,0
Madhya Pradesh,Chhindwara,Bichhua,139,0,1,hab,1,0,1,138,138,20,905,110,21.737535691714267,79.08131707076933,0
Madhya Pradesh,Chhindwara,Chhindwara,126,0,0,hab,0,0,0,126,126,20,1263,110,22.062392874715332,79.00368088135906,0
Madhya Pradesh,Chhindwara,Chourai,180,0,0,hab,0,0,0,180,180,20,1355,110,22.00959305696055,79.22907430069236,0
Madhya Pradesh,Chhindwara,Harrai,209,0,2,hab,1,1,1,208,207,20,2162,110,22.57518616564236,79.08404676328874,0
Madhya Pradesh,Chhindwara,Junnardeo ,262,0,8,hab,4,4,4,258,254,20,2545,110,22.19907189556772,78.44896636249946,0
Madhya Pradesh,Chhindwara,Mohkhed,182,0,24,hab,23,1,24,158,158,20,3898,110,21.92629901149242,78.77527496338827,0
Madhya Pradesh,Chhindwara,Pandhurna,160,0,4,hab,4,0,3,157,156,20,4512,110,21.681598637816087,78.5684951503566,0
Madhya Pradesh,Chhindwara,Parasia,191,1,1,hab,1,0,1,190,190,20,4550,110,22.174164653687104,78.79369929547138,0
Madhya Pradesh,Chhindwara,Sousar,134,0,2,hab,2,0,2,132,132,20,5750,110,21.648090982532004,78.79921222994248,0
Madhya Pradesh,Chhindwara,Tamiya,174,0,18,hab,13,5,12,162,156,20,5885,110,22.46139212408959,78.6964715289882,0
Madhya Pradesh,Damoh,Batiyagarh,142,0,3,hab,3,0,4,138,139,20,666,129,24.145841649123252,79.3977765915817,0
Madhya Pradesh,Damoh,Damoh,232,0,9,hab,9,0,11,221,223,20,1419,129,23.77151605669165,79.46749559876332,0
Madhya Pradesh,Damoh,Hatta,154,0,0,hab,0,0,0,154,154,20,2194,129,24.266990805968177,79.66166633784312,0
Madhya Pradesh,Damoh,Jabera,180,0,3,hab,3,0,6,174,177,20,2326,129,23.628744736167068,79.72653419259655,0
Madhya Pradesh,Damoh,Patera,157,1,2,hab,2,0,2,155,155,20,4603,129,23.961397339932624,79.69913358203745,0
Madhya Pradesh,Damoh,Patharia,132,0,1,hab,1,0,1,131,131,20,4612,129,23.917847697539898,79.27771583819133,0
Madhya Pradesh,Damoh,Tendukheda,180,0,4,hab,3,1,3,177,176,20,5954,129,23.39225076079453,79.44355172325089,0
Madhya Pradesh,Datia,Bhander,140,0,112,hab,110,2,113,27,28,20,794,135,25.811754018181485,78.74321083221727,0
Madhya Pradesh,Datia,Datia,247,0,195,hab,185,10,191,56,52,20,1466,135,25.61503679670033,78.45511941116423,0
Madhya Pradesh,Datia,Seondha,197,0,172,hab,162,10,166,31,25,20,5484,135,26.003972275246024,78.64161389031499,0
Madhya Pradesh,Dewas,Bagli,284,5,43,hab,39,4,52,232,241,20,389,143,22.61359733572469,76.32340973630072,0
Madhya Pradesh,Dewas,Dewas,221,1,8,hab,6,2,6,215,213,20,1539,143,22.958726675443792,76.0719653299326,0
Madhya Pradesh,Dewas,Kannod,164,0,0,hab,0,0,0,164,164,20,2733,143,22.57399472233944,76.6475380812965,0
Madhya Pradesh,Dewas,Khategaon,168,0,2,hab,2,0,2,166,166,20,2984,143,22.650329160308935,76.93225089584763,0
Madhya Pradesh,Dewas,Sonkachh,128,0,5,hab,5,0,5,123,123,20,5736,143,23.014734747194524,76.36788517231791,0
Madhya Pradesh,Dewas,Tonk Khurd,111,1,3,hab,3,0,3,108,108,20,6128,143,23.1412205388767,76.23706648944041,0
Madhya Pradesh,Dhar,Badnawar,165,0,3,hab,3,0,4,161,162,20,364,147,22.936136251596793,75.21217319034426,0
Madhya Pradesh,Dhar,Bagh,91,0,2,hab,2,0,4,87,89,20,378,147,22.430183426188098,74.79008891940184,0
Madhya Pradesh,Dhar,Bankaner,103,0,0,hab,0,0,0,103,103,20,520,147,22.248310326393987,75.24568052086516,0
Madhya Pradesh,Dhar,Dahi,62,0,6,hab,1,5,1,61,56,20,1399,147,22.13298183611402,74.61514854077657,0
Madhya Pradesh,Dhar,Dhar,98,0,2,hab,2,0,2,96,96,20,1568,147,22.68002199607103,75.36323995622276,0
Madhya Pradesh,Dhar,Dharampuri,100,2,1,hab,1,0,2,98,99,20,1576,147,22.23533675895497,75.42595613616608,0
Madhya Pradesh,Dhar,Gandhwani,144,0,1,hab,1,0,1,143,143,20,1836,147,22.43519755426615,75.01288075277661,0
Madhya Pradesh,Dhar,Kukshi,47,0,0,hab,0,0,0,47,47,20,3230,147,22.270775709733233,74.76427487767484,0
Madhya Pradesh,Dhar,Manawar,94,0,1,hab,0,1,0,94,93,20,3627,147,22.215126560454802,75.06182587561038,0
Madhya Pradesh,Dhar,Nalchha,180,0,1,hab,1,0,1,179,179,20,4108,147,22.490875542156353,75.47357429192338,0
Madhya Pradesh,Dhar,Nisarpur,58,0,1,hab,1,0,2,56,57,20,4318,147,22.149826002862728,74.83869649095583,0
Madhya Pradesh,Dhar,Sardarpur,190,0,4,hab,4,0,6,184,186,20,5410,147,22.721061128925932,74.99900864974086,0
Madhya Pradesh,Dhar,Tirla,141,1,0,hab,0,0,0,141,141,20,6094,147,22.51289245097474,75.23191609890826,0
Madhya Pradesh,Dindori,Amarpur,101,0,0,hab,0,0,0,101,101,20,116,159,22.76403804047357,80.96656310436785,0
Madhya Pradesh,Dindori,Bajag,93,0,3,hab,2,1,3,90,90,20,424,159,22.73363426709011,81.30807223552404,0
Madhya Pradesh,Dindori,Dindori,188,0,4,hab,4,0,6,182,184,20,1641,159,23.067542201308918,81.03252438208672,0
Madhya Pradesh,Dindori,Karanjia,104,0,4,hab,4,0,6,98,100,20,2763,159,22.64925840882899,81.52014223367136,0
Madhya Pradesh,Dindori,Mehandwani,111,0,1,hab,1,0,1,110,110,20,3815,159,22.946286704996915,80.70821731095035,0
Madhya Pradesh,Dindori,Shahpura,191,0,1,hab,1,0,1,190,190,20,5521,159,23.181995858622656,80.68361135360813,0
Madhya Pradesh,Dindori,Smanapur,115,0,1,hab,1,0,1,114,114,20,5703,159,22.677248182234315,81.16559020756857,0
Madhya Pradesh,Guna,Aron,140,0,125,hab,118,7,120,20,15,20,248,205,24.37449482883067,77.4588220378959,0
Madhya Pradesh,Guna,Bamori,252,2,196,hab,183,13,200,52,56,20,487,205,24.850945675649026,77.06873975087699,0
Madhya Pradesh,Guna,Chachoda,300,0,223,hab,210,13,219,81,77,20,1097,205,24.292782558832897,76.99582864693446,0
Madhya Pradesh,Guna,Guna,300,2,183,hab,171,12,194,106,117,20,2066,205,24.76869094056461,77.3526852226453,0
Madhya Pradesh,Guna,Raghogarh,318,0,204,hab,197,7,235,83,114,20,4913,205,24.27205454600656,77.20963274329249,0
Madhya Pradesh,Gwalior,Bhitarwar,158,0,146,hab,137,9,140,18,12,20,863,209,25.879662437434877,78.08848622759584,0
Madhya Pradesh,Gwalior,Dabra,153,0,149,hab,130,19,132,21,4,20,1384,209,25.967768165929613,78.3691940975208,0
Madhya Pradesh,Gwalior,Ghatigaon (Barai),132,0,134,osm,96,38,93,39,-2,20,1931,209,26.07364970271448,77.93315689953778,0
Madhya Pradesh,Gwalior,Morar,169,0,169,hab,148,21,147,22,0,20,3920,209,26.20000743724209,78.36350214484617,0
Madhya Pradesh,Harda,Harda,175,1,52,hab,51,1,52,123,123,20,2143,214,22.34961555308947,77.01780316319781,0
Madhya Pradesh,Harda,Khirkiya,177,0,43,hab,43,0,52,125,134,20,3007,214,22.11991813799927,76.99122609556473,0
Madhya Pradesh,Harda,Timarni,161,0,13,hab,13,0,17,144,148,20,6089,214,22.221088809835933,77.27470543681608,0
Madhya Pradesh,Hoshangabad,Babai,104,0,71,hab,65,6,74,30,33,20,336,224,22.73233001704022,77.95425130646593,0
Madhya Pradesh,Hoshangabad,Bankhedi,122,0,35,hab,31,4,29,93,87,20,526,224,22.7961248060276,78.53317052170647,0
Madhya Pradesh,Hoshangabad,Hoshangabad,93,0,82,hab,77,5,76,17,11,20,2244,224,22.666709125990106,77.71244185176245,0
Madhya Pradesh,Hoshangabad,Kesla,110,0,40,hab,35,5,36,74,70,20,2899,224,22.485819617484307,77.81072244623304,0
Madhya Pradesh,Hoshangabad,Pipariya,145,1,80,hab,73,7,78,67,65,20,4762,224,22.627375093230683,78.39388897708639,0
Madhya Pradesh,Hoshangabad,Seoni Malwa,193,0,155,hab,135,20,136,57,38,20,5486,224,22.44789547213025,77.46851011484542,0
Madhya Pradesh,Hoshangabad,Sohagpur,162,0,74,hab,71,3,88,74,88,20,5707,224,22.581699587432055,78.14289388296507,0
Madhya Pradesh,Indore,Depalpur,172,0,2,hab,1,1,2,170,170,20,1512,231,22.83716227181091,75.58100780259245,0
Madhya Pradesh,Indore,Indore,153,0,12,hab,11,1,11,142,141,20,2296,231,22.68776608764952,75.94703332888268,0
Madhya Pradesh,Indore,Mhow,173,1,17,hab,17,0,18,155,156,20,3850,231,22.48593542898983,75.78123945618195,0
Madhya Pradesh,Indore,Sanwer,147,1,2,hab,2,0,3,144,145,20,5390,231,22.907357539969528,75.82948540590671,0
Madhya Pradesh,Jabalpur,Bargi Jabalpur,202,1,7,hab,5,2,7,195,195,20,587,233,23.042770940005134,79.93241485297331,0
Madhya Pradesh,Jabalpur,Kundam,193,0,3,hab,3,0,4,189,190,20,3257,233,23.23445552407937,80.36027044527276,0
Madhya Pradesh,Jabalpur,Majholi,208,0,13,hab,10,3,12,196,195,20,3565,233,23.495972564564497,79.99054669430402,0
Madhya Pradesh,Jabalpur,Panagar,192,0,13,hab,11,2,18,174,179,20,4494,233,23.274536148970732,80.0063901575462,0
Madhya Pradesh,Jabalpur,Patan,226,2,3,hab,1,2,1,225,223,20,4592,233,23.300696917673797,79.74220629687383,0
Madhya Pradesh,Jabalpur,Shahpura Bhitoni,226,2,4,hab,2,2,3,223,222,20,5522,233,23.109354182951922,79.63027582682149,0
Madhya Pradesh,Jabalpur,Sihora,150,0,3,hab,3,0,5,145,147,20,5618,233,23.409913018064,80.16017541946036,0
Madhya Pradesh,Jhabua,Jhabua,128,1,0,hab,0,0,0,128,128,20,2484,253,22.801164228586014,74.57055012694019,0
Madhya Pradesh,Jhabua,Meghnagar,111,0,0,hab,0,0,0,111,111,20,3811,253,22.968617489847688,74.54614751135529,0
Madhya Pradesh,Jhabua,Petlawad,211,0,0,hab,0,0,0,211,211,20,4721,253,22.983442756627884,74.8729160208549,0
Madhya Pradesh,Jhabua,Rama,121,0,0,hab,0,0,0,121,121,20,5014,253,22.733784971517785,74.7274855581496,0
Madhya Pradesh,Jhabua,Ranapur,95,0,0,hab,0,0,0,95,95,20,5076,253,22.645579907454053,74.49583684748035,0
Madhya Pradesh,Jhabua,Thandla,112,0,1,hab,0,1,0,112,111,20,5988,253,23.09398634684803,74.5889754102147,0
Madhya Pradesh,Katni,Badwara,150,0,6,hab,6,0,9,141,144,20,369,286,23.777443182712133,80.69544564356913,0
Madhya Pradesh,Katni,Bohriband,183,0,6,hab,6,0,8,175,177,20,1008,286,23.694671150702398,80.0689343500551,0
Madhya Pradesh,Katni,Dhimarkhera,198,1,10,hab,10,0,17,181,188,20,1610,286,23.51036595968112,80.40414075321067,0
Madhya Pradesh,Katni,Katni,116,0,3,hab,3,0,3,113,113,20,2840,286,23.82519117852968,80.4017217585116,0
Madhya Pradesh,Katni,Rithi,110,0,3,hab,2,1,3,107,107,20,5172,286,23.859140045680025,80.15323939490244,0
Madhya Pradesh,Katni,Vijayraghogarh,139,1,0,hab,0,0,0,139,139,20,6363,286,23.978495204018014,80.66494518186536,0
Madhya Pradesh,Khandwa,Baldi,95,0,0,hab,0,0,0,95,95,20,447,293,22.25677334640836,76.65459030356955,0
Madhya Pradesh,Khandwa,Chhegon Makhan,87,0,4,hab,4,0,4,83,83,20,1261,293,21.883950290912487,76.22212239005616,0
Madhya Pradesh,Khandwa,Harsud,93,0,3,hab,2,1,4,89,90,20,2168,293,22.03011014203036,76.70937276589666,0
Madhya Pradesh,Khandwa,Khalwa,147,0,1,hab,1,0,1,146,146,20,2934,293,21.80324063542914,76.86814070524093,0
Madhya Pradesh,Khandwa,Khandwa,95,0,0,hab,0,0,0,95,95,20,2955,293,21.90506072778243,76.41897770831403,0
Madhya Pradesh,Khandwa,Pandhana,124,0,7,hab,5,2,4,120,117,20,4510,293,21.664637147388916,76.39346765436538,0
Madhya Pradesh,Khandwa,Punasa,147,0,5,hab,2,3,2,145,142,20,4853,293,22.177338659791864,76.35369315126925,0
Madhya Pradesh,Khargone,Barwaha,259,0,3,hab,3,0,3,256,256,20,626,294,22.24493564155789,76.01440339446057,0
Madhya Pradesh,Khargone,Bhagwanpura,106,0,4,hab,2,2,3,103,102,20,775,294,21.596782992986416,75.6183461737275,0
Madhya Pradesh,Khargone,Bhikangaon,128,0,0,hab,0,0,0,128,128,20,846,294,21.91550396684712,75.95350472227655,0
Madhya Pradesh,Khargone,Gogawa,80,0,1,hab,1,0,1,79,79,20,1968,294,21.81096919610771,75.70653939851111,0
Madhya Pradesh,Khargone,Kasrawad,176,0,16,hab,12,4,13,163,160,20,2821,294,22.053209801964247,75.60621773719853,0
Madhya Pradesh,Khargone,Khargone,84,0,20,hab,20,0,23,61,64,20,2970,294,21.857666365672067,75.51325906762028,0
Madhya Pradesh,Khargone,Maheshwar,175,0,0,hab,0,0,0,175,175,20,3527,294,22.259917689926787,75.7057329856294,0
Madhya Pradesh,Khargone,Segaon,54,1,1,hab,1,0,1,53,53,20,5468,294,21.80727327044257,75.37313239080167,0
Madhya Pradesh,Khargone,Zirniya,130,0,1,hab,1,0,1,129,129,20,6486,294,21.60122821486792,75.94079697923524,0
Madhya Pradesh,Mandla,Bichhiya,210,1,4,hab,2,2,3,207,206,20,904,354,22.41131090800605,80.59722214047363,0
Madhya Pradesh,Mandla,Bijadandi,139,1,1,hab,1,0,1,138,138,20,923,354,22.959835169680808,80.13896357802625,0
Madhya Pradesh,Mandla,Gughari,96,0,1,hab,1,0,2,94,95,20,2055,354,22.68819921054863,80.76300414795978,0
Madhya Pradesh,Mandla,Mandla,171,0,4,hab,4,0,4,167,167,20,3650,354,22.63905798839357,80.36572479120456,0
Madhya Pradesh,Mandla,Mawai,143,0,4,hab,3,1,3,140,139,20,3782,354,22.45351293351389,80.97893570282808,0
Madhya Pradesh,Mandla,Mohgaon,88,1,1,hab,1,0,2,86,87,20,3895,354,22.760549331258463,80.57853367790678,0
Madhya Pradesh,Mandla,Nainpur,161,0,42,hab,37,5,34,127,119,20,4094,354,22.45323239400596,80.19874800935162,0
Madhya Pradesh,Mandla,Narayanganj,133,1,1,hab,1,0,1,132,132,20,4170,354,22.857598636054913,80.31261993745932,0
Madhya Pradesh,Mandla,Niwas,100,0,4,hab,3,1,4,96,96,20,4325,354,23.05955016570537,80.40799033689649,0
Madhya Pradesh,Mandsour,Bhanpura,86,0,95,osm,70,25,64,22,-9,20,799,355,24.55905814676975,75.72402978056917,0
Madhya Pradesh,Mandsour,Garoth,195,0,200,osm,184,16,181,14,-5,20,1885,355,24.268174725668214,75.58500594097083,0
Madhya Pradesh,Mandsour,Malhargarh,168,0,152,hab,148,4,153,15,16,20,3590,355,24.242842151181208,75.11757778019174,0
Madhya Pradesh,Mandsour,Mandsour,223,0,202,hab,193,9,196,27,21,20,3654,355,23.974407821944194,75.09451090219454,0
Madhya Pradesh,Mandsour,Sitamau,234,0,222,hab,214,8,215,19,12,20,5692,355,24.05320881989387,75.46775699828966,0
Madhya Pradesh,Morena,Ambah,87,2,150,osm,89,61,76,11,-63,20,127,370,26.65727043905863,78.22154244990786,0
Madhya Pradesh,Morena,Joura,119,0,229,osm,154,75,115,4,-110,20,2531,370,26.410187022948513,77.8750167251646,0
Madhya Pradesh,Morena,Kailaras,109,0,148,osm,117,31,101,8,-39,20,2583,370,26.26134942131297,77.6125378547699,0
Madhya Pradesh,Morena,Morena,204,0,282,osm,199,83,173,31,-78,20,3922,370,26.491674761893837,78.0772484564485,0
Madhya Pradesh,Morena,Pahadgarh,131,0,214,osm,152,62,113,18,-83,20,4423,370,26.225860404549717,77.67329668704933,0
Madhya Pradesh,Morena,Porsa,96,0,167,osm,100,67,79,17,-71,20,4813,370,26.74682868233355,78.37131795719687,0
Madhya Pradesh,Morena,Sabalgarh,125,0,149,osm,109,40,101,24,-24,20,5224,370,26.230996080259448,77.36251940201639,0
Madhya Pradesh,Narsinghpur,Babai Chichli,149,1,1,hab,1,0,1,148,148,20,337,392,22.772807066465187,78.84706177459354,0
Madhya Pradesh,Narsinghpur,Chawarpata,211,0,2,hab,1,1,2,209,209,20,1211,392,23.059103319561096,78.90840848408745,0
Madhya Pradesh,Narsinghpur,Gotegaon,244,0,2,hab,2,0,3,241,242,20,2022,392,22.971314564693525,79.47621978142531,0
Madhya Pradesh,Narsinghpur,Kareli,142,0,0,hab,0,0,0,142,142,20,2771,392,22.969822821208886,79.0990425543604,0
Madhya Pradesh,Narsinghpur,Narsighpur,202,0,3,hab,3,0,3,199,199,20,4206,392,22.933202880103583,79.28715928504575,0
Madhya Pradesh,Narsinghpur,Saikhda Gadarwada,105,0,2,hab,2,0,3,102,103,20,5271,392,22.956300518127833,78.67321050795542,0
Madhya Pradesh,Neemuch,Jawad,264,0,227,hab,208,19,215,49,37,20,2466,399,24.775951841549237,75.06144031860444,0
Madhya Pradesh,Neemuch,Manasa,223,0,212,hab,193,19,186,37,11,20,3624,399,24.52023210640622,75.31682951638942,0
Madhya Pradesh,Neemuch,Neemuch,188,0,159,hab,148,11,154,34,29,20,4267,399,24.404175716303392,74.91281633414829,0
Madhya Pradesh,Panna,Ajaygarh,118,0,171,osm,148,23,118,0,-53,20,49,417,24.932580275971716,80.26981259795978,0
Madhya Pradesh,Panna,Gunnor,224,1,215,hab,212,3,216,8,9,20,2073,417,24.435058132317163,80.16333655823627,0
Madhya Pradesh,Panna,Panna,196,1,184,hab,182,2,181,15,12,20,4524,417,24.68744089812896,80.22705282103186,0
Madhya Pradesh,Panna,Pawai,201,1,187,hab,186,1,189,12,14,20,4645,417,24.25300607674874,80.13922690684751,0
Madhya Pradesh,Panna,Shahnagar,217,0,205,hab,205,0,209,8,12,20,5514,417,24.062678726434097,80.17117864939456,0
Madhya Pradesh,Raisen,Badi Breli,224,0,18,hab,16,2,23,201,206,20,361,449,23.031496094279152,78.1525581536695,0
Madhya Pradesh,Raisen,Begamganj,199,0,4,hab,4,0,4,195,195,20,683,449,23.541803694577137,78.45764340543143,0
Madhya Pradesh,Raisen,Gairtganj,166,0,3,hab,3,0,3,163,163,20,1809,449,23.388966719649794,78.19195618114348,0
Madhya Pradesh,Raisen,Obedullaganj,220,1,7,hab,4,3,6,214,213,20,4367,449,23.03976254717589,77.69329312994579,0
Madhya Pradesh,Raisen,Sanchi,217,0,15,hab,14,1,13,204,202,20,5335,449,23.344704236893936,77.76304040837417,0
Madhya Pradesh,Raisen,Silwani,245,0,0,hab,0,0,0,245,245,20,5635,449,23.263895878703394,78.4660303607799,0
Madhya Pradesh,Raisen,Udaipura,154,1,2,hab,2,0,2,152,152,20,6170,449,23.106247002095916,78.57592496025615,0
Madhya Pradesh,Rajgarh,Biaora,277,0,227,hab,225,2,235,42,50,20,898,450,23.89997464807185,77.02811843086334,0
Madhya Pradesh,Rajgarh,Jirapur,214,0,182,hab,181,1,193,21,32,20,2513,450,24.066778337579223,76.35046909396347,0
Madhya Pradesh,Rajgarh,Khilchipur,316,1,237,hab,233,4,267,49,79,20,3005,450,24.0481667236138,76.55998868177167,0
Madhya Pradesh,Rajgarh,Narsighgarh,302,0,261,hab,250,11,273,29,41,20,4205,450,23.628407567412196,76.93153755037456,0
Madhya Pradesh,Rajgarh,Rajgarh,380,0,262,hab,258,4,307,73,118,20,4978,450,23.95084769857135,76.75049747285357,0
Madhya Pradesh,Rajgarh,Sarangpur (Pachor),190,0,175,hab,172,3,174,16,15,20,5405,450,23.69010128451419,76.54508540525346,0
Madhya Pradesh,Ratlam,Alot,191,0,189,hab,182,7,182,9,2,20,99,460,23.737535086288663,75.46963492271561,0
Madhya Pradesh,Ratlam,Bajna,220,0,6,hab,6,0,14,206,214,20,427,460,23.29189621860463,74.73544764584075,0
Madhya Pradesh,Ratlam,Jaora,146,0,135,hab,129,6,130,16,11,20,2445,460,23.680910657674563,75.2036336342812,0
Madhya Pradesh,Ratlam,Piploda,90,0,79,hab,76,3,76,14,11,20,4764,460,23.64636839871452,74.99259549646536,0
Madhya Pradesh,Ratlam,Ratlam,170,0,125,hab,110,15,108,62,45,20,5119,460,23.30552865161833,75.08309359643668,0
Madhya Pradesh,Ratlam,Sailana,240,0,34,hab,32,2,64,176,206,20,5274,460,23.413475087812508,74.82337080961693,0
Madhya Pradesh,Rewa,Gangeva,270,0,3,hab,2,1,3,267,267,20,1853,463,24.75210097808568,81.53998434200103,0
Madhya Pradesh,Rewa,Hanumana,291,0,22,hab,15,7,6,285,269,20,2129,463,24.702352009693072,82.053803250787,0
Madhya Pradesh,Rewa,Java,246,1,66,hab,65,1,108,138,180,20,2465,463,24.999293886958565,81.39431075855776,0
Madhya Pradesh,Rewa,Mauganj,287,0,0,hab,0,0,0,287,287,20,3776,463,24.609809203661506,81.78518429155683,0
Madhya Pradesh,Rewa,Naigarhi,311,0,1,hab,1,0,2,309,310,20,4091,463,24.781637910069996,81.73917618802776,0
Madhya Pradesh,Rewa,Raipur Karchulian,288,2,1,hab,1,0,1,287,287,20,4948,463,24.557387473634517,81.51913904104124,0
Madhya Pradesh,Rewa,Rewa,205,1,1,hab,0,1,0,205,204,20,5165,463,24.499702924508924,81.30578573366748,0
Madhya Pradesh,Rewa,Sirmour,269,5,1,hab,1,0,1,268,268,20,5674,463,24.794413859771204,81.2685984285852,0
Madhya Pradesh,Rewa,Teonthar,264,2,111,hab,107,4,118,146,153,20,5960,463,24.972568036174398,81.6926718478248,0
Madhya Pradesh,Sagar,Banda,163,0,5,hab,5,0,7,156,158,20,494,473,24.042234496223838,78.89473950374855,0
Madhya Pradesh,Sagar,Bina,154,0,139,hab,134,5,136,18,15,20,954,473,24.25575474365734,78.20744120043256,0
Madhya Pradesh,Sagar,Deori,233,1,5,hab,5,0,9,224,228,20,1506,473,23.386068285581022,79.05663594569003,0
Madhya Pradesh,Sagar,Jaisinagar,146,0,7,hab,7,0,8,138,139,20,2363,473,23.680834316420455,78.61969549722303,0
Madhya Pradesh,Sagar,Kesli,172,0,5,hab,5,0,7,165,167,20,2900,473,23.397538167693224,78.80131889315841,0
Madhya Pradesh,Sagar,Khurai,177,0,5,hab,4,1,4,173,172,20,3025,473,24.07498247289755,78.35913711313391,0
Madhya Pradesh,Sagar,Malthon,175,0,6,hab,6,0,8,167,169,20,3610,473,24.17793615483516,78.55610124149084,0
Madhya Pradesh,Sagar,Rahatgarh,199,0,5,hab,4,1,7,192,194,20,4925,473,23.85394948068004,78.47212952944886,0
Madhya Pradesh,Sagar,Rahli,222,0,14,hab,12,2,16,206,208,20,4928,473,23.664923456977647,79.13526588401896,0
Madhya Pradesh,Sagar,Sagar,151,0,3,hab,2,1,2,149,148,20,5243,473,23.802410972796622,78.85670425782993,0
Madhya Pradesh,Sagar,Shahgarh,109,0,5,hab,5,0,5,104,104,20,5510,473,24.243261225283185,79.02232067781118,0
Madhya Pradesh,Satna,Amarpatan,169,1,156,hab,155,1,161,8,13,20,115,485,24.364868189904197,81.11743666059097,0
Madhya Pradesh,Satna,Chitrakut (Majhgawan),296,0,266,hab,260,6,273,23,30,20,1326,485,24.92127409384559,80.78216729189435,0
Madhya Pradesh,Satna,Maihar,240,1,212,hab,211,1,222,18,28,20,3550,485,24.164381906252625,80.7629783311156,0
Madhya Pradesh,Satna,Nagod,244,1,213,hab,213,0,227,17,31,20,4075,485,24.61246116886946,80.536000759259,0
Madhya Pradesh,Satna,Ram Nagar,207,0,147,hab,147,0,164,43,60,20,5010,485,24.20235671867875,81.15645805367345,0
Madhya Pradesh,Satna,Rampur Baghelan,215,1,199,hab,195,4,205,10,16,20,5062,485,24.571463771021055,81.0215809881242,0
Madhya Pradesh,Satna,Sohawal (Satna),235,2,198,hab,197,1,220,15,37,20,5710,485,24.666934092992104,80.79151389907396,0
Madhya Pradesh,Satna,Uchehra,211,2,170,hab,170,0,193,18,41,20,6165,485,24.40210489146076,80.6888420098142,0
Madhya Pradesh,Sehore,Ashta,279,0,30,hab,28,2,29,250,249,20,261,487,22.981902047437337,76.66658974507715,0
Madhya Pradesh,Sehore,Budni,138,0,24,hab,19,5,20,118,114,20,1060,487,22.81287061668792,77.6560537085324,0
Madhya Pradesh,Sehore,Ichhawar,142,0,0,hab,0,0,0,142,142,20,2276,487,22.982519653225097,77.08443610182579,0
Madhya Pradesh,Sehore,Nasrullaganj,165,0,17,hab,16,1,18,147,148,20,4216,487,22.755305974176224,77.23076101142804,0
Madhya Pradesh,Sehore,Sehore,298,2,113,hab,108,5,114,184,185,20,5470,487,23.31159367703175,77.12900929128406,0
Madhya Pradesh,Seoni,Barghat,136,0,2,hab,1,1,1,135,134,20,586,489,22.022299231748082,79.77622318338386,0
Madhya Pradesh,Seoni,Chhapara,159,1,3,hab,2,1,3,156,156,20,1253,489,22.40484022266412,79.47404203353373,0
Madhya Pradesh,Seoni,Dhanora,114,0,13,hab,13,0,13,101,101,20,1562,489,22.48468987355411,79.81111288548664,0
Madhya Pradesh,Seoni,Ghansor ,236,0,4,hab,4,0,4,232,232,20,1917,489,22.709846009039858,80.003504334397,0
Madhya Pradesh,Seoni,Kevlari,183,0,37,hab,36,1,40,143,146,20,2904,489,22.307551520001184,79.95356924373509,0
Madhya Pradesh,Seoni,Kurai,183,1,8,hab,7,1,7,176,175,20,3276,489,21.819204348619508,79.49449633441091,0
Madhya Pradesh,Seoni,Lakhnadon,288,2,22,hab,20,2,21,267,266,20,3346,489,22.67795644985504,79.60910284859347,0
Madhya Pradesh,Seoni,Seoni,289,0,15,hab,14,1,12,277,274,20,5485,489,22.179561223032096,79.56914101066211,0
Madhya Pradesh,Shahdol,Beohari,145,0,1,hab,0,1,0,145,144,20,722,492,24.071942587274954,81.29113079568015,0
Madhya Pradesh,Shahdol,Burhar,191,0,4,hab,2,2,2,189,187,20,1077,492,23.37678770304,81.74190394258426,0
Madhya Pradesh,Shahdol,Gohparu,126,0,2,hab,1,1,1,125,124,20,4466,492,23.516523458229845,81.44257134754568,0
Madhya Pradesh,Shahdol,Jaisingh Nagar,200,0,7,hab,1,6,1,199,193,20,2364,492,23.801265844043353,81.43285141241054,0
Madhya Pradesh,Shahdol,Sohagpur,158,0,4,hab,3,1,3,155,154,20,5708,492,23.21942104637298,81.42648285135783,0
Madhya Pradesh,Shajapur,Kalapipal,120,0,91,hab,90,1,95,25,29,20,2616,494,23.308128924950942,76.85546154895106,0
Madhya Pradesh,Shajapur,Moman Barodiya,167,0,158,hab,151,7,156,11,9,20,3908,494,23.528333652577025,76.41554881158774,0
Madhya Pradesh,Shajapur,Shajapur,171,0,139,hab,133,6,138,33,32,20,5526,494,23.356102305323123,76.33462162323104,0
Madhya Pradesh,Shajapur,Shujalpur,129,0,88,hab,84,4,88,41,41,20,5597,494,23.337208127022397,76.66368633438219,0
Madhya Pradesh,Sheopur,Karahal,115,2,50,hab,44,6,48,67,65,20,2752,490,25.565638302185437,76.94804275947598,0
Madhya Pradesh,Sheopur,Seopurkalan,232,0,180,hab,167,13,179,53,52,20,5487,490,25.685505973979573,76.65947256022102,0
Madhya Pradesh,Sheopur,Vijaypur,180,0,126,hab,107,19,103,77,54,20,6362,490,25.94619976336257,77.21970331841551,0
Madhya Pradesh,Shivpuri,Badarwas,139,0,135,hab,116,19,116,23,4,20,356,499,25.03376260208736,77.67277901967468,0
Madhya Pradesh,Shivpuri,Karera,105,3,91,hab,86,5,81,24,14,20,2773,499,25.449724512314233,78.11391561821928,0
Madhya Pradesh,Shivpuri,Khaniya Dhana,181,1,177,hab,145,32,142,39,4,20,2956,499,25.037193433182583,78.1325406651371,0
Madhya Pradesh,Shivpuri,Kolaras,199,1,155,hab,151,4,154,45,44,20,3089,499,25.201920339697562,77.517843543785,0
Madhya Pradesh,Shivpuri,Narwar,145,0,120,hab,108,12,109,36,25,20,4213,499,25.62991709172334,78.08267351223782,0
Madhya Pradesh,Shivpuri,Pichhore,127,0,121,hab,102,19,93,34,6,20,4747,499,25.25865692193251,78.05396704470267,0
Madhya Pradesh,Shivpuri,Pohri,236,0,155,hab,151,4,165,71,81,20,4787,499,25.597630076960602,77.38603922763126,0
Madhya Pradesh,Shivpuri,Shivpuri,189,0,148,hab,137,11,141,48,41,20,5583,499,25.55535298876821,77.71045784527239,0
Madhya Pradesh,Sidhi,Kusmi,130,1,4,hab,2,2,2,128,126,20,3304,503,23.94991624749616,81.86963414049504,0
Madhya Pradesh,Sidhi,Majholi,130,0,1,hab,1,0,1,129,129,20,3564,503,24.148935645554804,81.67974066820494,0
Madhya Pradesh,Sidhi,Rampur Naikin,184,0,0,hab,0,0,0,184,184,20,5065,503,24.345835011974174,81.55737755125364,0
Madhya Pradesh,Sidhi,Sidhi (Gopad Banas ),285,0,0,hab,0,0,0,285,285,20,5606,503,24.357237419130836,81.8619435356713,0
Madhya Pradesh,Sidhi,Sihawal,296,0,1,hab,1,0,5,291,295,20,5616,503,24.49058604696397,82.13573336842391,0
Madhya Pradesh,Singrauli,Baidhan,206,0,4,hab,2,2,3,203,202,20,412,508,23.980481091522957,82.4833859507255,0
Madhya Pradesh,Singrauli,Chitrangi,304,0,18,hab,15,3,16,288,286,20,1327,508,24.446161083587395,82.54575703152135,0
Madhya Pradesh,Singrauli,Deosar,218,1,4,hab,4,0,9,209,214,20,1510,508,24.191111752587016,82.20126348928818,0
Madhya Pradesh,Tikamgarh,Baldeogarh,151,0,134,hab,134,0,142,9,17,20,445,547,24.79031824425893,79.16614127363484,0
Madhya Pradesh,Tikamgarh,Jatara,171,0,103,hab,101,2,109,62,68,20,2458,547,24.9767540326975,78.86992575642641,0
Madhya Pradesh,Tikamgarh,Niwari,123,0,103,hab,92,11,90,33,20,20,4324,547,25.369691248634624,78.77602644982893,0
Madhya Pradesh,Tikamgarh,Palera,135,0,125,hab,125,0,127,8,10,20,4458,547,25.070881012639916,79.1433346814592,0
Madhya Pradesh,Tikamgarh,Prithivipur,130,0,33,hab,33,0,36,94,97,20,4834,547,25.19465815517127,78.71715179834354,0
Madhya Pradesh,Tikamgarh,Tikamgarh,155,0,125,hab,122,3,125,30,30,20,6081,547,24.684721489893224,78.92618459291386,0
Madhya Pradesh,Ujjain,Badnagar,190,1,11,hab,11,0,11,179,179,20,362,564,23.11650676067978,75.42914553384318,0
Madhya Pradesh,Ujjain,Ghatiya,128,0,126,hab,119,7,122,6,2,20,1932,564,23.31110702564652,75.78495437639269,0
Madhya Pradesh,Ujjain,Khachrod,219,0,200,hab,197,3,198,21,19,20,2905,564,23.421308845111362,75.39829533908103,0
Madhya Pradesh,Ujjain,Mahidpur,222,0,218,hab,207,11,211,11,4,20,3531,564,23.549548214744657,75.71356704148465,0
Madhya Pradesh,Ujjain,Tarana,210,0,197,hab,190,7,189,21,13,20,5918,564,23.38976065466519,76.0722265642902,0
Madhya Pradesh,Ujjain,Ujjain,130,0,6,hab,5,1,5,125,124,20,6190,564,23.128677662348142,75.8091680480763,0
Madhya Pradesh,Umaria,Manpur,231,0,4,hab,4,0,5,226,227,20,3702,566,23.73641348239735,81.0316856377322,0
Madhya Pradesh,Umaria,Pali Gohparu,105,0,0,hab,0,0,0,105,105,20,4463,566,23.39190077651831,81.190420098447,0
Madhya Pradesh,Umaria,Umaria Karkeli,258,0,0,hab,0,0,0,258,258,20,6201,566,23.446365334553416,80.78667172663543,0
Madhya Pradesh,Vidisha,Basoda,276,1,139,hab,133,6,140,136,137,20,648,579,23.850400502319253,78.0420572325146,0
Madhya Pradesh,Vidisha,Gyaraspur,190,0,75,hab,73,2,76,114,115,20,2095,579,23.619513929532737,78.06726221923675,0
Madhya Pradesh,Vidisha,Kurvai,208,0,139,hab,134,5,138,70,69,20,3298,579,24.082646447066157,78.06529773396308,0
Madhya Pradesh,Vidisha,Lateri,182,0,160,hab,136,24,148,34,22,20,3386,579,24.071248787791323,77.41514034657148,0
Madhya Pradesh,Vidisha,Nateran,179,3,164,hab,146,18,146,33,15,20,4218,579,23.856798200764953,77.66014315877268,0
Madhya Pradesh,Vidisha,Sironj,274,0,219,hab,209,10,223,51,55,20,5677,579,24.154840467905284,77.71296267799255,0
Madhya Pradesh,Vidisha,Vidisha,225,0,220,hab,205,15,208,17,5,20,6352,579,23.56707411680429,77.77920118079156,0
Maharashtra,Ahmednagar,Akole,471,0,53,hab,47,6,92,379,418,21,64,4,19.51344432895277,73.9028528879341,0
Maharashtra,Ahmednagar,Jamkhed,260,2,6,hab,6,0,14,246,254,21,2420,4,18.660215593561702,75.3481845925938,0
Maharashtra,Ahmednagar,Karjat,578,0,27,hab,26,1,98,480,551,21,2784,4,18.565579994622333,74.9560759348136,0
Maharashtra,Ahmednagar,Kopargaon,407,0,30,hab,29,1,79,328,377,21,3126,4,19.87548473819185,74.45430481564298,0
Maharashtra,Ahmednagar,Nagar,694,0,25,hab,25,0,101,593,669,21,4060,4,19.07564322566752,74.74636991573087,0
Maharashtra,Ahmednagar,Newasa,514,0,17,hab,17,0,48,466,497,21,4285,4,19.472509272247986,74.9591809830806,0
Maharashtra,Ahmednagar,Parner,872,3,52,hab,49,3,174,698,820,21,4571,4,19.078256299847705,74.40629789302412,0
Maharashtra,Ahmednagar,Pathardi,469,0,19,hab,19,0,55,414,450,21,4610,4,19.17157522421293,75.16109519093973,0
Maharashtra,Ahmednagar,Rahata,414,4,9,hab,9,0,51,363,405,21,4924,4,19.67894745457405,74.50816602730602,0
Maharashtra,Ahmednagar,Rahuri,291,4,20,hab,16,4,33,258,271,21,4930,4,19.400004070489107,74.61634652425226,0
Maharashtra,Ahmednagar,Sangamner,913,0,9,hab,9,0,48,865,904,21,5347,4,19.492832362071837,74.24411587105567,0
Maharashtra,Ahmednagar,Shevgaon,376,0,19,hab,19,0,44,332,357,21,5562,4,19.363742118497683,75.28670368970481,0
Maharashtra,Ahmednagar,Shrigonda,808,0,49,hab,45,4,203,605,759,21,5594,4,18.702872864624332,74.66091122930725,0
Maharashtra,Ahmednagar,Shrirampur,334,0,11,hab,11,0,47,287,323,21,5595,4,19.62897970213529,74.7050947230849,0
Maharashtra,Akola,Akola,175,0,9,hab,9,0,10,165,166,21,62,7,20.73112474154412,77.08992229321845,0
Maharashtra,Akola,Akot,151,0,2,hab,0,2,0,151,149,21,65,7,21.060311289473553,77.05843541215857,0
Maharashtra,Akola,Balapur,88,0,2,hab,2,0,2,86,86,21,440,7,20.733108017356084,76.83325491333754,0
Maharashtra,Akola,Barshitakli,126,1,8,hab,8,0,10,116,118,21,622,7,20.525297795292158,77.15203528307262,0
Maharashtra,Akola,Murtizapur,148,0,3,hab,3,0,4,144,145,21,4014,7,20.743171254876867,77.41588633620889,0
Maharashtra,Akola,Patur,88,0,1,hab,1,0,1,87,87,21,4640,7,20.429874784613148,76.85011664763465,0
Maharashtra,Akola,Telhara,94,0,2,hab,2,0,2,92,92,21,5947,7,21.04480665088256,76.87121499123683,0
Maharashtra,Amrawati,Achalpur,147,0,31,hab,31,0,38,109,116,21,9,16,21.2305112229544,77.46860110970844,0
Maharashtra,Amrawati,Amrawati,110,0,37,hab,3,34,3,107,73,21,160,16,20.993066759305574,77.81042933869242,0
Maharashtra,Amrawati,Anjangaon,105,0,17,hab,17,0,29,76,88,21,196,16,21.125466234049753,77.29891452424356,0
Maharashtra,Amrawati,Bhatkuli,111,0,2,hab,0,2,0,111,109,21,819,16,20.97378872053448,77.60225690132918,0
Maharashtra,Amrawati,Chandur Bazar,141,0,20,hab,20,0,35,106,121,21,1169,16,21.264039037243535,77.69331002307338,0
Maharashtra,Amrawati,Chandur Railway,79,0,2,hab,2,0,2,77,77,21,1170,16,20.77939418501022,77.96740352523601,0
Maharashtra,Amrawati,Chikhaldara,155,2,22,hab,12,10,13,142,133,21,1279,16,21.45624017799536,77.24136782074223,0
Maharashtra,Amrawati,Daryapur,136,0,11,hab,11,0,10,126,125,21,1454,16,20.955469817257978,77.32636654719052,0
Maharashtra,Amrawati,Dhamangaon Railway,86,0,15,hab,15,0,15,71,71,21,1544,16,20.787293495953943,78.16902632999452,0
Maharashtra,Amrawati,Dharni,156,0,18,hab,18,0,18,138,138,21,1595,16,21.488214793442367,76.93231318569985,0
Maharashtra,Amrawati,Morshi,108,0,10,hab,10,0,10,98,98,21,3929,16,21.27742574435827,77.95601923566886,0
Maharashtra,Amrawati,Nandgaon Khandeshwar,132,0,0,hab,0,0,0,132,132,21,4140,16,20.69164249743862,77.76186552922579,0
Maharashtra,Amrawati,Teosa,73,0,1,hab,1,0,3,70,72,21,5961,16,21.021894272790767,78.04017807874838,0
Maharashtra,Amrawati,Warud,128,0,20,hab,19,1,23,105,108,21,6425,16,21.460452385995314,78.28057511329291,0
Maharashtra,Aurangabad,Aurangabad,198,0,12,hab,8,4,14,184,186,21,315,31,19.880261470282196,75.44417643050505,0
Maharashtra,Aurangabad,Gangapur,225,2,3,hab,2,1,5,220,222,21,1845,31,19.78508502455378,75.06976155921365,0
Maharashtra,Aurangabad,Kannad,212,0,20,hab,17,3,21,191,192,21,2730,31,20.27018760821638,75.18290711123241,0
Maharashtra,Aurangabad,Khuldabad,130,0,7,hab,7,0,8,122,123,21,3021,31,20.080230242420807,75.2313633175118,0
Maharashtra,Aurangabad,Paithan,273,1,17,hab,17,0,25,248,256,21,4431,31,19.5887593455434,75.43566358336837,0
Maharashtra,Aurangabad,Phulambri,124,3,10,hab,8,2,9,115,114,21,7115,31,20.131479604361136,75.46515728949984,0
Maharashtra,Aurangabad,Sillod,148,2,3,hab,3,0,3,145,145,21,5632,31,20.397084183981633,75.61873951663004,0
Maharashtra,Aurangabad,Soyagaon,87,0,4,hab,4,0,6,81,83,21,5755,31,20.54877969663589,75.56736261221023,0
Maharashtra,Aurangabad,Vaijapur,181,0,5,hab,5,0,6,175,176,21,6260,31,19.96034343140029,74.82156265698934,0
Maharashtra,Beed,Ambejogai,146,0,4,hab,4,0,4,142,142,21,136,61,18.702687144296625,76.43187804243263,0
Maharashtra,Beed,Ashti,288,0,6,hab,6,0,8,280,282,21,262,61,18.907702701866846,75.09135294272951,0
Maharashtra,Beed,Beed,312,3,13,hab,8,5,10,302,299,21,681,61,18.92608754209946,75.77649976058012,0
Maharashtra,Beed,Dharur,90,0,2,hab,2,0,2,88,88,21,1597,61,18.882343093026737,76.18871295032403,0
Maharashtra,Beed,Georai,291,0,7,hab,7,0,10,281,284,21,1908,61,19.24451171145442,75.740898113744,0
Maharashtra,Beed,Kaij,179,0,1,hab,1,0,1,178,178,21,2581,61,18.717428492885244,76.04149065298122,0
Maharashtra,Beed,Majalgaon,204,0,6,hab,6,0,6,198,198,21,3559,61,19.155383718996024,76.19660749764617,0
Maharashtra,Beed,Parli,145,0,7,hab,7,0,9,136,138,21,4570,61,18.892811646755323,76.46983173342738,0
Maharashtra,Beed,Patoda,115,0,1,hab,1,0,1,114,114,21,4626,61,18.8587413940978,75.4571068586419,0
Maharashtra,Beed,Shirur (Kasar),128,0,8,hab,8,0,8,120,120,21,5577,61,19.049480742369667,75.4675176786561,0
Maharashtra,Beed,Wadwani,86,0,15,hab,15,0,19,67,71,21,6403,61,19.001051986653287,76.0635431563939,0
Maharashtra,Bhandara,Bhandara.,147,0,172,osm,136,36,141,6,-25,21,790,68,21.123949160471525,79.67488549831681,0
Maharashtra,Bhandara,Lakhandur,83,0,88,osm,80,8,81,2,-5,21,3336,68,20.79340622343733,79.86670287179717,0
Maharashtra,Bhandara,Lakhani,94,0,101,osm,92,9,92,2,-7,21,3337,68,21.017620156919502,79.85419189663432,0
Maharashtra,Bhandara,Mohadi,102,0,104,osm,96,8,98,4,-2,21,3880,68,21.31235614158592,79.66642835319797,0
Maharashtra,Bhandara,Pauni,135,0,157,osm,135,22,131,4,-22,21,4642,68,20.819222984566288,79.66881882892484,0
Maharashtra,Bhandara,Sakoli,91,0,94,osm,82,12,83,8,-3,21,5288,68,21.10154317602623,79.9794716029777,0
Maharashtra,Bhandara,Tumsar,136,0,149,osm,133,16,133,3,-13,21,6150,68,21.469687443388228,79.7024377690016,0
Maharashtra,Buldhana,Buldhana,101,0,7,hab,7,0,6,95,94,21,1066,92,20.46211944571312,76.11520144597607,0
Maharashtra,Buldhana,Chikhali,139,0,8,hab,7,1,6,133,131,21,1280,92,20.349969375494656,76.32837646730157,0
Maharashtra,Buldhana,Deulgaon Raja,63,0,1,hab,1,0,1,62,62,21,1521,92,20.06663488959544,76.14993302449645,0
Maharashtra,Buldhana,Jalgaon Jamod,120,0,24,hab,22,2,25,95,96,21,2397,92,21.04958837239169,76.51017204984942,0
Maharashtra,Buldhana,Khamgaon,148,0,21,hab,21,0,22,126,127,21,2939,92,20.612575952422414,76.55040375441746,0
Maharashtra,Buldhana,Lonar,87,0,84,hab,83,1,86,1,3,21,3434,92,19.983484898451685,76.51006442692494,0
Maharashtra,Buldhana,Malkapur,66,0,30,hab,30,0,31,35,36,21,3598,92,20.89120295633071,76.19860787848101,0
Maharashtra,Buldhana,Mehkar,142,0,32,hab,32,0,35,107,110,21,3819,92,20.251099366222245,76.6129880374107,0
Maharashtra,Buldhana,Motala,115,0,16,hab,16,0,20,95,99,21,3933,92,20.67868730976447,76.1500220352564,0
Maharashtra,Buldhana,Nandura,105,0,62,hab,61,1,61,44,43,21,4149,92,20.834627154982737,76.3863005779629,0
Maharashtra,Buldhana,Sangrampur,99,1,26,hab,26,0,38,61,73,21,5359,92,21.079766935343958,76.69769281510435,0
Maharashtra,Buldhana,Shegaon,67,0,3,hab,2,1,2,65,64,21,5548,92,20.809803392822754,76.65321688141526,0
Maharashtra,Buldhana,Sindhkhed Raja,105,0,20,hab,20,0,22,83,85,21,5650,92,20.021777389049483,76.28366775319985,0
Maharashtra,Chandrapur,Ballarpur,29,0,17,hab,15,2,16,13,12,21,7116,105,19.845481266366793,79.4229702439565,0
Maharashtra,Chandrapur,Bhadravati,123,0,17,hab,17,0,20,103,106,21,760,105,20.190663111725804,79.22548340445282,0
Maharashtra,Chandrapur,Brahmapuri,112,0,63,hab,60,3,61,51,49,21,1046,105,20.49343282488969,79.8527258737188,0
Maharashtra,Chandrapur,Chandrapur,92,0,15,hab,12,3,13,79,77,21,1164,105,20.010357423209996,79.38815253445173,0
Maharashtra,Chandrapur,Chimur,170,0,32,hab,31,1,33,137,138,21,1291,105,20.51142203293467,79.39792733532586,0
Maharashtra,Chandrapur,Gondpipri,101,0,10,hab,10,0,12,89,91,21,1997,105,19.68652104177361,79.62133448601729,0
Maharashtra,Chandrapur,Jiwati,167,0,41,hab,30,11,35,132,126,21,7117,105,19.580537527988632,79.09927421191114,0
Maharashtra,Chandrapur,Korpana,117,0,6,hab,5,1,5,112,111,21,3141,105,19.761354062836983,79.06011717363236,0
Maharashtra,Chandrapur,Mul,84,1,16,hab,16,0,19,65,68,21,3966,105,20.047692472898092,79.68325028449297,0
Maharashtra,Chandrapur,Nagbhid,117,0,41,hab,41,0,47,70,76,21,4071,105,20.525466099941404,79.66149940633757,0
Maharashtra,Chandrapur,Pomburna,65,0,11,hab,11,0,16,49,54,21,7118,105,19.870358790774738,79.666439023308,0
Maharashtra,Chandrapur,Rajura,125,1,14,hab,14,0,14,111,111,21,5008,105,19.701566821226876,79.34124755693853,0
Maharashtra,Chandrapur,Sawali,98,0,9,hab,9,0,11,87,89,21,5457,105,20.136273409357738,79.86967980380007,0
Maharashtra,Chandrapur,Shindewahi,96,0,11,hab,11,0,14,82,85,21,5570,105,20.27714913668961,79.62186470367953,0
Maharashtra,Chandrapur,Warora,152,0,53,hab,53,0,54,98,99,21,6423,105,20.348426026131868,79.02938092844589,0
Maharashtra,Dhule,Dhule,180,0,112,hab,108,4,122,58,68,21,1619,154,20.885661319218944,74.73556391836479,0
Maharashtra,Dhule,Sakri,475,0,98,hab,96,2,146,329,377,21,5292,154,21.0309012984659,74.22935250661857,0
Maharashtra,Dhule,Shindkheda,145,0,87,hab,87,0,91,54,58,21,5571,154,21.238857338597725,74.69025885254484,0
Maharashtra,Dhule,Shirpur,250,1,92,hab,89,3,115,135,158,21,5575,154,21.419033536176787,74.9382313072791,0
Maharashtra,Gadchiroli,Aheri,197,0,8,hab,8,0,13,184,189,21,36,187,19.26094928529926,80.14460024662684,0
Maharashtra,Gadchiroli,Armori,115,0,48,hab,48,0,57,58,67,21,241,187,20.424818601681316,80.08821635553073,0
Maharashtra,Gadchiroli,Bhamragad,121,0,2,hab,2,0,2,119,119,21,789,187,19.444357117675434,80.61194129277469,0
Maharashtra,Gadchiroli,Chamorshi,201,0,38,hab,37,1,44,157,163,21,1135,187,19.846431071989024,79.948001719677,0
Maharashtra,Gadchiroli,Dhanora,255,1,36,hab,33,3,35,220,219,21,1561,187,20.23939583614242,80.3549590843667,0
Maharashtra,Gadchiroli,Etapalli,189,0,9,hab,8,1,8,181,180,21,1750,187,19.724592410363968,80.37931605539416,0
Maharashtra,Gadchiroli,Gadchiroli,134,1,7,hab,4,3,4,130,127,21,1794,187,20.129350744519883,80.08373047571011,0
Maharashtra,Gadchiroli,Korchi,132,0,39,hab,39,0,45,87,93,21,3136,187,20.651655244650282,80.4858557951996,0
Maharashtra,Gadchiroli,Kurkheda,167,0,49,hab,48,1,64,103,118,21,3285,187,20.57806383226628,80.27416832388336,0
Maharashtra,Gadchiroli,Mulchera,82,0,3,hab,3,0,4,78,79,21,3973,187,19.64947995753559,80.0260332905237,0
Maharashtra,Gadchiroli,Sironcha,117,0,7,hab,6,1,8,109,110,21,5676,187,18.8788081158039,80.10489151543402,0
Maharashtra,Gadchiroli,Wadsa,35,0,19,hab,16,3,19,16,16,21,6402,187,20.622353100245498,80.02150712262402,0
Maharashtra,Gondia,Amgaon,111,0,23,hab,23,0,29,82,88,21,147,200,21.378314313520054,80.3556325636943,0
Maharashtra,Gondia,Arjuni/ Morgaon,161,0,60,hab,59,1,64,97,101,21,239,200,20.818123609822752,80.11564670769489,0
Maharashtra,Gondia,Deori,200,0,26,hab,22,4,31,169,174,21,1507,200,20.9744729465969,80.36575006634872,0
Maharashtra,Gondia,Gondia,176,0,17,hab,16,1,22,154,159,21,1994,200,21.503806046351603,80.1786415089916,0
Maharashtra,Gondia,Goregaon,131,0,8,hab,8,0,13,118,123,21,2014,200,21.30666659545502,80.20515177995885,0
Maharashtra,Gondia,Sadak/ Arjuni,165,0,29,hab,29,0,37,128,136,21,5229,200,21.127557237227705,80.16329884721682,0
Maharashtra,Gondia,Salekasa,147,0,8,hab,8,0,9,138,139,21,5299,200,21.28571785598285,80.51859165912073,0
Maharashtra,Gondia,Tirora,140,0,3,hab,3,0,3,137,137,21,6096,200,21.37269089622871,79.94712984354852,0
Maharashtra,Hingoli,Aundha Nagn,139,1,20,hab,19,1,20,119,119,21,309,221,19.55379382366076,77.03138040810562,0
Maharashtra,Hingoli,Basmath,142,0,24,hab,24,0,24,118,118,21,646,221,19.371253396649813,77.12197056175975,0
Maharashtra,Hingoli,Hingoli,153,0,1,hab,1,0,1,152,152,21,2224,221,19.78932449846036,77.16143806570275,0
Maharashtra,Hingoli,Kalamnuri,153,0,76,hab,74,2,78,75,77,21,2611,221,19.567829524045347,77.35525420778905,0
Maharashtra,Hingoli,Sengaon,133,0,11,hab,10,1,10,123,122,21,5481,221,19.83884075551604,76.86943198062806,0
Maharashtra,Jalgaon,Amalner,152,0,21,hab,21,0,29,123,131,21,107,242,21.076634103701583,75.05181176821011,0
Maharashtra,Jalgaon,Bhadgaon,59,0,0,hab,0,0,0,59,59,21,753,242,20.6688112468755,75.17461997075218,0
Maharashtra,Jalgaon,Bhusawal,50,0,3,hab,2,1,2,48,47,21,895,242,20.99843564547093,75.83186712814562,0
Maharashtra,Jalgaon,Bodhwad,51,0,7,hab,7,0,8,43,44,21,7119,242,20.886280023851057,75.97794315571743,0
Maharashtra,Jalgaon,Chalisgaon,139,0,2,hab,1,1,1,138,137,21,1127,242,20.481596603496932,74.96152351599395,0
Maharashtra,Jalgaon,Chopda,119,0,83,hab,82,1,91,28,36,21,1348,242,21.275286328165073,75.3223981519711,0
Maharashtra,Jalgaon,Dharangaon,89,0,1,hab,1,0,1,88,88,21,7120,242,21.044895751981397,75.34442691097185,0
Maharashtra,Jalgaon,Erandol,65,0,0,hab,0,0,0,65,65,21,1744,242,20.87893117061579,75.36207530739458,0
Maharashtra,Jalgaon,Jalgaon,86,0,10,hab,10,0,10,76,76,21,2396,242,20.99360285010401,75.56198668800975,0
Maharashtra,Jalgaon,Jamner,161,0,20,hab,20,0,24,137,141,21,2424,242,20.735095966918003,75.77581691762673,0
Maharashtra,Jalgaon,Muktainagar,80,0,4,hab,4,0,4,76,76,21,3963,242,21.04978001487269,76.16131638858558,0
Maharashtra,Jalgaon,Pachora,128,0,0,hab,0,0,0,128,128,21,4409,242,20.648700177676414,75.39588696253162,0
Maharashtra,Jalgaon,Parola,113,0,5,hab,5,0,6,107,108,21,4572,242,20.84923758936608,75.10177443999639,0
Maharashtra,Jalgaon,Raver,116,0,29,hab,29,0,36,80,87,21,5126,242,21.24887928184455,75.95816777789112,0
Maharashtra,Jalgaon,Yawal,104,0,55,hab,55,0,64,40,49,21,6449,242,21.224813699729843,75.69440429441268,0
Maharashtra,Jalna,Ambad,198,0,36,hab,33,3,42,156,162,21,126,243,19.559909889733188,75.75379907511778,0
Maharashtra,Jalna,Badnapur,146,0,2,hab,2,0,2,144,144,21,363,243,19.91897413259445,75.7503735674003,0
Maharashtra,Jalna,Bhokardan,229,0,12,hab,11,1,15,214,217,21,876,243,20.253265327003003,75.80930690308615,0
Maharashtra,Jalna,Ghanswangi,155,1,36,hab,35,1,33,122,119,21,1918,243,19.49876205948086,76.0195710583175,0
Maharashtra,Jalna,Jafrabad,124,0,7,hab,7,0,8,116,117,21,2328,243,20.190929606784366,76.01957735904745,0
Maharashtra,Jalna,Jalna,199,0,37,hab,35,2,41,158,162,21,2400,243,19.8126516851686,76.0351765520874,0
Maharashtra,Jalna,Mantha,152,1,51,hab,51,0,63,89,101,21,3710,243,19.743584351972135,76.38683939585464,0
Maharashtra,Jalna,Partur,108,0,3,hab,3,0,3,105,105,21,4579,243,19.496225181531425,76.23175298834552,0
Maharashtra,Kolhapur,Ajara,146,0,24,hab,24,0,33,113,122,21,48,306,16.124214044120812,74.19302602703799,0
Maharashtra,Kolhapur,Bhudargad,221,0,23,hab,22,1,46,175,198,21,888,306,16.225428849415025,74.07088512219215,0
Maharashtra,Kolhapur,Chandagad,215,0,55,hab,53,2,72,143,160,21,1145,306,15.911997900080072,74.24704499563154,0
Maharashtra,Kolhapur,Gadhinglaj,224,0,28,hab,28,0,60,164,196,21,1797,306,16.160985656467695,74.37869037998915,0
Maharashtra,Kolhapur,Gaganbavada,85,0,2,hab,2,0,4,81,83,21,1801,306,16.593819357642015,73.91274427762494,0
Maharashtra,Kolhapur,Hatkanangle,314,0,17,hab,15,2,52,262,297,21,2193,306,16.762129025568136,74.36411849524153,0
Maharashtra,Kolhapur,Kagal,244,0,16,hab,15,1,49,195,228,21,2575,306,16.441671695357062,74.25901595115955,0
Maharashtra,Kolhapur,Karveer,240,0,65,hab,63,2,124,116,175,21,2801,306,16.648966208360786,74.1853217053744,0
Maharashtra,Kolhapur,Panhala,229,0,20,hab,20,0,37,192,209,21,4518,306,16.767183096792998,74.05021752495608,0
Maharashtra,Kolhapur,Radhanagri,227,0,6,hab,6,0,11,216,221,21,4907,306,16.408146765740952,73.99254993129405,0
Maharashtra,Kolhapur,Shahuwadi,301,0,157,hab,129,28,171,130,144,21,5523,306,16.929811388146693,73.88702986263257,0
Maharashtra,Kolhapur,Shirol,228,0,21,hab,21,0,60,168,207,21,5574,306,16.708971541604377,74.57102984337119,0
Maharashtra,Latur,Ahmadpur,164,0,11,hab,10,1,11,153,153,21,38,330,18.701446798680248,76.91456908347294,0
Maharashtra,Latur,Ausa,167,0,25,hab,24,1,27,140,142,21,318,330,18.187432594806776,76.49327613461597,0
Maharashtra,Latur,Chakur,111,0,11,hab,11,0,12,99,100,21,1125,330,18.509147170128937,76.83663024386067,0
Maharashtra,Latur,Deoni,65,1,10,hab,10,0,9,56,55,21,1505,330,18.241017896136785,77.02259790900591,0
Maharashtra,Latur,Jalkot,72,0,4,hab,4,0,4,68,68,21,2399,330,18.5925650695776,77.16752606697123,0
Maharashtra,Latur,Latur,136,2,47,hab,40,7,38,98,89,21,3390,330,18.422299906258907,76.46033698880396,0
Maharashtra,Latur,Nilanga,175,0,27,hab,27,0,34,141,148,21,4303,330,18.082031675609535,76.78668188309236,0
Maharashtra,Latur,Renapur,100,0,9,hab,9,0,9,91,91,21,5152,330,18.572548194886387,76.5848263886944,0
Maharashtra,Latur,Shirur Anantpal,55,0,33,hab,33,0,27,28,22,21,5578,330,18.330949196044738,76.83108989490529,0
Maharashtra,Latur,Udgir,141,0,18,hab,18,0,19,122,123,21,6178,330,18.41530568956937,77.09478822363613,0
Maharashtra,Nagpur,Bhiwapur,106,0,27,hab,21,6,27,79,79,21,868,382,20.729459250109176,79.37487552608017,0
Maharashtra,Nagpur,Hingna,129,0,7,hab,6,1,6,123,122,21,2223,382,21.00399850032001,78.87155219567522,0
Maharashtra,Nagpur,Kalmeshwar,100,0,12,hab,12,0,15,85,88,21,2648,382,21.276815651570328,78.85870830288981,0
Maharashtra,Nagpur,Kamptee,74,0,11,hab,10,1,9,65,63,21,2686,382,21.159161378194643,79.23138736253702,0
Maharashtra,Nagpur,Katol,166,0,25,hab,25,0,32,134,141,21,2841,382,21.23064972028342,78.63523610007526,0
Maharashtra,Nagpur,Kuhi,139,0,18,hab,15,3,15,124,121,21,3226,382,20.983818755104878,79.4500359834941,0
Maharashtra,Nagpur,Mouda,119,0,85,hab,84,1,83,36,34,21,3941,382,21.23170134835442,79.43986245405684,0
Maharashtra,Nagpur,Nagpur,131,2,23,hab,21,2,21,110,108,21,4076,382,21.021368686049733,79.0041940662097,0
Maharashtra,Nagpur,Narkhed,132,0,6,hab,6,0,9,123,126,21,4191,382,21.384434371713947,78.49102304947792,0
Maharashtra,Nagpur,Parseoni,110,0,52,hab,52,0,60,50,58,21,4576,382,21.43222714154197,79.15331572050978,0
Maharashtra,Nagpur,Ramtek,146,0,101,hab,93,8,95,51,45,21,5073,382,21.517448942702885,79.35228543588066,0
Maharashtra,Nagpur,Saoner,130,1,28,hab,28,0,32,98,102,21,5391,382,21.426730644911927,78.94352795896958,0
Maharashtra,Nagpur,Umred,132,0,10,hab,10,0,10,122,122,21,6207,382,20.84967145555589,79.19801310097338,0
Maharashtra,Nanded,Ardhapur,48,0,10,hab,10,0,10,38,38,21,231,388,19.27559393537661,77.37628842355848,0
Maharashtra,Nanded,Bhokar,105,0,2,hab,2,0,2,103,103,21,875,388,19.203915350313338,77.71301757852605,0
Maharashtra,Nanded,Biloli,82,1,8,hab,7,1,7,75,74,21,951,388,18.763878952552826,77.68416034875656,0
Maharashtra,Nanded,Deglur,124,0,13,hab,13,0,15,109,111,21,1483,388,18.488414269038056,77.54858406366142,0
Maharashtra,Nanded,Dharmabad,52,0,0,hab,0,0,0,52,52,21,1586,388,18.908924426186722,77.7912158293509,0
Maharashtra,Nanded,Hadgaon,149,2,57,hab,50,7,52,97,92,21,2100,388,19.453196952480752,77.57503823474048,0
Maharashtra,Nanded,Himayatnagar,80,2,0,hab,0,0,0,80,80,21,2215,388,19.398661582431185,77.85136694002031,0
Maharashtra,Nanded,Kandhar,167,1,32,hab,31,1,31,136,135,21,2702,388,18.82641635851636,77.24344256085233,0
Maharashtra,Nanded,Kinwat,208,0,12,hab,12,0,11,197,196,21,3040,388,19.57430242803545,78.16591556743857,0
Maharashtra,Nanded,Loha,163,0,24,hab,23,1,23,140,139,21,3424,388,18.967153437461118,77.18113836900469,0
Maharashtra,Nanded,Mahur,96,0,3,hab,3,0,4,92,93,21,3546,388,19.812956311310064,77.9979991146028,0
Maharashtra,Nanded,Mudkhed,60,0,8,hab,8,0,7,53,52,21,3953,388,19.14178779482639,77.47798854284906,0
Maharashtra,Nanded,Mukhed,252,1,49,hab,47,2,61,191,203,21,3962,388,18.604474992425054,77.37551277512476,0
Maharashtra,Nanded,Naigaon,97,2,56,hab,55,1,62,35,41,21,4090,388,18.87321981142631,77.50958623373371,0
Maharashtra,Nanded,Nanded,92,0,7,hab,7,0,8,84,85,21,4137,388,19.16046623244993,77.28377382248505,0
Maharashtra,Nanded,Umri,82,0,1,hab,1,0,1,81,81,21,6210,388,19.036308047938416,77.63979880538085,0
Maharashtra,Nandurbar,Akkalkuwa,443,0,14,hab,14,0,46,397,429,21,61,389,21.69724915591223,73.95578909588734,0
Maharashtra,Nandurbar,Akrani,376,0,3,hab,3,0,5,371,373,21,67,389,21.837522216801982,74.28552471564622,0
Maharashtra,Nandurbar,Nandurbar,165,0,87,hab,85,2,97,68,78,21,4150,389,21.362458485725536,74.26179246313015,0
Maharashtra,Nandurbar,Nawapur,194,0,39,hab,35,4,48,146,155,21,4255,389,21.18595167813129,73.92542294344071,0
Maharashtra,Nandurbar,Shahada,196,0,74,hab,73,1,89,107,122,21,5502,389,21.564174582988286,74.54006688645389,0
Maharashtra,Nandurbar,Taloda,120,2,6,hab,6,0,7,113,114,21,5878,389,21.620606664873353,74.21487688221676,0
Maharashtra,Nashik,Baglan,252,0,35,hab,35,0,59,193,217,21,388,393,20.707276936605986,74.15900114462514,0
Maharashtra,Nashik,Chandwad,181,0,11,hab,11,0,17,164,170,21,1173,393,20.286709694747273,74.20970669412263,0
Maharashtra,Nashik,Deola,127,0,2,hab,2,0,3,124,125,21,1502,393,20.444457725529446,74.2312281390338,0
Maharashtra,Nashik,Dindori,272,0,13,hab,13,0,19,253,259,21,1640,393,20.261918111388677,73.77856262384753,0
Maharashtra,Nashik,Igatpuri,157,0,41,hab,35,6,42,115,116,21,2281,393,19.742912774948753,73.65694161182628,0
Maharashtra,Nashik,Kalwan,207,2,13,hab,13,0,20,187,194,21,2660,393,20.51979584865144,73.93469595997819,0
Maharashtra,Nashik,Malegaon,246,0,28,hab,27,1,35,211,218,21,3587,393,20.59120426713839,74.54454678562152,0
Maharashtra,Nashik,Nandgaon,193,0,8,hab,7,1,9,184,185,21,4139,393,20.30599483111015,74.67954928800387,0
Maharashtra,Nashik,Nashik,94,1,11,hab,9,2,12,82,83,21,4214,393,19.982433788824462,73.75716148566829,0
Maharashtra,Nashik,Niphad,179,0,23,hab,23,0,37,142,156,21,4313,393,20.078522217208516,74.10710395696944,0
Maharashtra,Nashik,Peth,220,0,15,hab,13,2,19,201,205,21,4719,393,20.257174538376216,73.51638013848229,0
Maharashtra,Nashik,Sinner,200,1,24,hab,22,2,30,170,176,21,5662,393,19.818476455124625,74.07976863090452,0
Maharashtra,Nashik,Surgana,359,0,4,hab,3,1,3,356,355,21,5818,393,20.52183452613281,73.57282030502316,0
Maharashtra,Nashik,Trimbkeshwar,320,0,23,hab,23,0,48,272,297,21,6136,393,20.018869970144305,73.4534045863853,0
Maharashtra,Nashik,Yeola,212,0,10,hab,10,0,17,195,202,21,6465,393,20.082668489399687,74.5127136277242,0
Maharashtra,Osmanabad,Bhoom,215,0,11,hab,11,0,20,195,204,21,877,409,18.501961041572937,75.5997645210185,0
Maharashtra,Osmanabad,Kallam,159,0,17,hab,16,1,18,141,142,21,2644,409,18.484763387977083,76.04196723541106,0
Maharashtra,Osmanabad,Lohara,65,0,7,hab,7,0,8,57,58,21,3427,409,17.954640720126722,76.38808850699601,0
Maharashtra,Osmanabad,Omerga,149,0,14,hab,14,0,20,129,135,21,4386,409,17.837308777642843,76.57483298265421,0
Maharashtra,Osmanabad,Osmanabad,171,0,25,hab,23,2,27,144,146,21,4397,409,18.223710573710857,76.12666046817475,0
Maharashtra,Osmanabad,Paranda,243,0,5,hab,5,0,13,230,238,21,4548,409,18.355698616614866,75.45729836450195,0
Maharashtra,Osmanabad,Tuljapur,206,0,18,hab,16,2,22,184,188,21,6147,409,17.882487765543694,76.12781227544781,0
Maharashtra,Osmanabad,Washi,135,0,4,hab,4,0,10,125,131,21,6427,409,18.551597751006753,75.79057442901075,0
Maharashtra,Palghar,Dahanu,1070,0,7,hab,7,0,45,1025,1063,21,7097,638,19.979002780256426,72.88249479539876,0
Maharashtra,Palghar,Jawhar,385,0,34,hab,32,2,89,296,351,21,7098,638,19.947757875115734,73.21518796894154,0
Maharashtra,Palghar,Mokhada,244,0,17,hab,15,2,35,209,227,21,7099,638,19.86180329326545,73.37648994167073,0
Maharashtra,Palghar,Palghar,1143,0,17,hab,17,0,80,1063,1126,21,7100,638,19.697103888563404,72.82733858178098,0
Maharashtra,Palghar,Talasari,251,0,3,hab,3,0,13,238,248,21,7101,638,20.144421062109647,72.89035262677639,0
Maharashtra,Palghar,Vasai,192,0,21,hab,12,9,35,157,171,21,7102,638,19.431443094102338,72.8808966972796,0
Maharashtra,Palghar,Vikramgad,557,4,16,hab,16,0,58,499,541,21,7103,638,19.806924292044005,73.07019943363795,0
Maharashtra,Palghar,Wada,839,0,19,hab,18,1,97,742,820,21,7104,638,19.64239975367243,73.13591729361563,0
Maharashtra,Parbhani,Gangakhed,151,0,8,hab,8,0,14,137,143,21,1842,419,18.91423715833476,76.74793992762487,0
Maharashtra,Parbhani,Jintur,193,0,15,hab,14,1,16,177,178,21,2510,419,19.614391965520685,76.6895981186556,0
Maharashtra,Parbhani,Manwath,57,0,5,hab,5,0,6,51,52,21,3718,419,19.26380056332116,76.55009461775252,0
Maharashtra,Parbhani,Palam,100,0,10,hab,10,0,10,90,90,21,4449,419,18.977734186646295,76.94940239992113,0
Maharashtra,Parbhani,Parbhani,134,0,14,hab,14,0,15,119,120,21,4559,419,19.251415053230918,76.76091496128214,0
Maharashtra,Parbhani,Pathri,74,0,3,hab,3,0,3,71,71,21,4617,419,19.234994015771036,76.38317577453253,0
Maharashtra,Parbhani,Purna,96,1,7,hab,7,0,9,87,89,21,4871,419,19.164040451940323,77.0064817840671,0
Maharashtra,Parbhani,Sailu,99,1,11,hab,11,0,14,85,88,21,5275,419,19.476429112347727,76.47305987238614,0
Maharashtra,Parbhani,Sonpeth,75,0,5,hab,5,0,7,68,70,21,5738,419,19.000059367156545,76.56714647829872,0
Maharashtra,Pune,Ambegaon,701,1,52,hab,51,1,184,517,649,21,135,439,19.0419121865214,73.85787528677905,0
Maharashtra,Pune,Baramati,693,0,21,hab,20,1,53,640,672,21,563,439,18.203915976024643,74.45996055677638,0
Maharashtra,Pune,Bhor,291,0,41,hab,35,6,57,234,250,21,883,439,18.173145140440983,73.80079722104536,0
Maharashtra,Pune,Dound,680,2,37,hab,37,0,135,545,643,21,1675,439,18.451937151281154,74.45518929983388,0
Maharashtra,Pune,Haveli,712,88,37,hab,33,4,153,559,675,21,2195,439,18.51381688404569,73.92936641279904,0
Maharashtra,Pune,Indapur,595,0,29,hab,28,1,81,514,566,21,2291,439,18.115471848298224,74.89077458030275,0
Maharashtra,Pune,Junnar,723,0,32,hab,29,3,78,645,691,21,2544,439,19.204037216977298,73.952149662592,0
Maharashtra,Pune,Khed,725,0,60,hab,51,9,155,570,665,21,2990,439,18.86930881407788,73.80122794674178,0
Maharashtra,Pune,Maval,363,0,77,hab,60,17,109,254,286,21,3779,439,18.76616522590255,73.54657321260606,0
Maharashtra,Pune,Mulshi,355,0,62,hab,57,5,107,248,293,21,3976,439,18.516510766504148,73.53984645735522,0
Maharashtra,Pune,Purandhar,589,0,45,hab,43,2,139,450,544,21,4863,439,18.294380516844253,74.11057131810526,0
Maharashtra,Pune,Shirur,583,0,43,hab,42,1,104,479,540,21,5576,439,18.741295663171552,74.25678551347517,0
Maharashtra,Pune,Velha,191,0,58,hab,44,14,65,126,133,21,6315,439,18.300562226343928,73.61862968577897,0
Maharashtra,Raigad,Alibag,226,0,35,hab,31,4,59,167,191,21,84,446,18.657608268476988,72.96125295200146,0
Maharashtra,Raigad,Karjat,297,1,80,hab,68,12,104,193,217,21,2783,446,19.002923686905376,73.39540558244614,0
Maharashtra,Raigad,Khalapur,300,1,24,hab,22,2,67,233,276,21,2930,446,18.82975019788596,73.2734264945568,0
Maharashtra,Raigad,Mahad,732,0,61,hab,59,2,138,594,671,21,3512,446,18.11571561401229,73.4515926766551,0
Maharashtra,Raigad,Mangaon,292,0,44,hab,42,2,84,208,248,21,3667,446,18.271896417966985,73.30254631621447,0
Maharashtra,Raigad,Mhasala,138,0,2,hab,2,0,5,133,136,21,3849,446,18.127961154965117,73.1337361834638,0
Maharashtra,Raigad,Murud,114,0,11,hab,10,1,24,90,103,21,4015,446,18.398566706230774,72.96820865543674,0
Maharashtra,Raigad,Panvel,283,0,57,hab,53,4,82,201,226,21,4530,446,18.984161073796642,73.13688561110108,0
Maharashtra,Raigad,Pen,397,0,17,hab,17,0,72,325,380,21,4687,446,18.715700206489643,73.1123444116239,0
Maharashtra,Raigad,Poladpur,278,0,1,hab,1,0,9,269,277,21,4790,446,17.9694837121091,73.5257483166189,0
Maharashtra,Raigad,Roha,186,0,17,hab,15,2,25,161,169,21,5179,446,18.444143724636348,73.13503944422528,0
Maharashtra,Raigad,Shriwardhan,142,0,11,hab,10,1,28,114,131,21,5596,446,18.11136701555832,73.02800579506906,0
Maharashtra,Raigad,Sudhagad,225,0,21,hab,19,2,48,177,204,21,5779,446,18.584552711192064,73.27835041213089,0
Maharashtra,Raigad,Tala,94,0,33,hab,32,1,37,57,61,21,5860,446,18.279712175724626,73.13593094524244,0
Maharashtra,Raigad,Uran,108,0,16,hab,15,1,25,83,92,21,6228,446,18.887219898396413,73.0045197170749,0
Maharashtra,Ratnagiri,Chiplun,1307,1,11,hab,10,1,56,1251,1296,21,1314,461,17.44841076632165,73.52801962909635,0
Maharashtra,Ratnagiri,Dapoli,1054,0,30,hab,30,0,229,825,1024,21,1440,461,17.761317463007757,73.2180650483279,0
Maharashtra,Ratnagiri,Guhagar,820,0,21,hab,20,1,155,665,799,21,2056,461,17.42450013846696,73.2803837536809,0
Maharashtra,Ratnagiri,Khed,1146,2,11,hab,9,2,58,1088,1135,21,2989,461,17.713398244236025,73.48129585125241,0
Maharashtra,Ratnagiri,Lanja,698,0,15,hab,15,0,58,640,683,21,3376,461,16.85115125154916,73.57079572786112,0
Maharashtra,Ratnagiri,Mandangad,353,0,34,hab,34,0,72,281,319,21,3638,461,17.97398696161807,73.22255913365203,0
Maharashtra,Ratnagiri,Rajapur,1107,0,29,hab,27,2,97,1010,1078,21,4969,461,16.65702942206805,73.55126402408818,0
Maharashtra,Ratnagiri,Ratnagiri,1081,1,34,hab,34,0,210,871,1047,21,5120,461,17.039127876100945,73.35834631088962,0
Maharashtra,Ratnagiri,Sangameshwar,1305,0,36,hab,33,3,149,1156,1269,21,5346,461,17.12314082930846,73.60859336050387,0
Maharashtra,Sangali,Atpadi,439,0,8,hab,8,0,27,412,431,21,297,481,17.40543844625895,74.8646310872221,0
Maharashtra,Sangali,Jath,971,6,26,hab,24,2,55,916,945,21,2459,481,17.08572648601712,75.33407771721839,0
Maharashtra,Sangali,Kadegaon   ,395,0,9,hab,9,0,29,366,386,21,7121,481,17.290841636741717,74.37279825704863,0
Maharashtra,Sangali,Kavathemahankal,598,0,17,hab,17,0,72,526,581,21,2863,481,17.04632857623415,74.90869971823453,0
Maharashtra,Sangali,Khanapur,307,0,17,hab,17,0,50,257,290,21,2948,481,17.28136532579672,74.60846106782168,0
Maharashtra,Sangali,Miraj,575,0,69,hab,64,5,95,480,506,21,3862,481,16.85961385068425,74.6923651578627,0
Maharashtra,Sangali,Palus,212,0,6,hab,6,0,25,187,206,21,4482,481,17.051113328155868,74.45485271158164,0
Maharashtra,Sangali,Shirala,311,0,95,hab,94,1,200,111,216,21,5572,481,17.07376896073375,73.98242631987809,0
Maharashtra,Sangali,Tasgaon,563,0,21,hab,21,0,87,476,542,21,5934,481,17.097123487837994,74.6655886873529,0
Maharashtra,Sangali,Walwa,471,0,65,hab,64,1,170,301,406,21,6412,481,17.0163343621352,74.28925057942153,0
Maharashtra,Satara,Jaoli,292,0,27,hab,14,13,35,257,265,21,2444,484,17.753373174751026,73.80484285267642,0
Maharashtra,Satara,Karad,419,1,33,hab,33,0,70,349,386,21,2751,484,17.300466334762895,74.13798683802311,0
Maharashtra,Satara,Khandala,189,0,15,hab,15,0,33,156,174,21,2950,484,18.071958283443898,74.04030734900027,0
Maharashtra,Satara,Khatav,503,0,19,hab,19,0,40,463,484,21,2983,484,17.573960208706083,74.42299407171828,0
Maharashtra,Satara,Koregaon,218,0,8,hab,8,0,14,204,210,21,3137,484,17.74085856492588,74.16631328254267,0
Maharashtra,Satara,Mahableshwar,189,0,19,hab,17,2,31,158,170,21,3509,484,17.836766307609818,73.66871620367559,0
Maharashtra,Satara,Man,495,0,23,hab,18,5,81,414,472,21,3617,484,17.682111337858448,74.65283060192357,0
Maharashtra,Satara,Patan,672,0,63,hab,52,11,84,588,609,21,4591,484,17.36755675596909,73.87250882404915,0
Maharashtra,Satara,Phaltan,517,0,24,hab,23,1,65,452,493,21,4726,484,17.96559907464625,74.41521801259105,0
Maharashtra,Satara,Satara,406,0,17,hab,17,0,38,368,389,21,5432,484,17.6481606237855,73.9896114039246,0
Maharashtra,Satara,Wai,271,0,11,hab,10,1,23,248,260,21,6407,484,17.951497088040657,73.8754923994414,0
Maharashtra,Sindhudurg,Devgad,689,0,28,hab,26,2,71,618,661,21,1530,507,16.39955335720504,73.49124659464289,0
Maharashtra,Sindhudurg,Dodamarg,289,0,118,hab,111,7,234,55,171,21,1652,507,15.743922325651232,74.03856296634567,0
Maharashtra,Sindhudurg,Kankavli,697,1,182,hab,182,0,260,437,515,21,2724,507,16.331029410333823,73.74429521756254,0
Maharashtra,Sindhudurg,Kudal,913,0,103,hab,101,2,138,775,810,21,3221,507,16.058052472874333,73.7713060943105,0
Maharashtra,Sindhudurg,Malvan,716,0,34,hab,34,0,117,599,682,21,3612,507,16.147560028600356,73.5615913082967,0
Maharashtra,Sindhudurg,Savantwadi,712,0,141,hab,141,0,248,464,571,21,5452,507,15.8899355982515,73.89474880936123,0
Maharashtra,Sindhudurg,Vaibhavwadi,297,0,13,hab,13,0,39,258,284,21,6259,507,16.52810435453559,73.77294874923047,0
Maharashtra,Sindhudurg,Vengurla,387,0,11,hab,10,1,52,335,376,21,6334,507,15.885970753701866,73.6423409590261,0
Maharashtra,Solapur,Akkalkot,214,0,23,hab,23,0,40,174,191,21,60,517,17.50002402916919,76.19097281297587,0
Maharashtra,Solapur,Barshi,265,0,7,hab,7,0,13,252,258,21,621,517,18.17158019062101,75.78244939564031,0
Maharashtra,Solapur,Karmala,314,0,20,hab,19,1,29,285,294,21,2788,517,18.316375605817115,75.14849313505917,0
Maharashtra,Solapur,Madha,486,0,18,hab,18,0,40,446,468,21,3478,517,18.039612964330455,75.37974622964839,0
Maharashtra,Solapur,Malshiras,559,0,23,hab,22,1,55,504,536,21,3609,517,17.826012896290894,74.91972910565232,0
Maharashtra,Solapur,Mangalwedha,237,0,14,hab,14,0,21,216,223,21,3665,517,17.416716820479685,75.45882543713618,0
Maharashtra,Solapur,Mohol,142,0,18,hab,17,1,23,119,124,21,3900,517,17.777382966183563,75.61577006258257,0
Maharashtra,Solapur,North Solapur,51,1,14,hab,12,2,12,39,37,21,4343,517,17.750198637615654,75.84883580259783,0
Maharashtra,Solapur,Pandharpur,289,0,18,hab,18,0,24,265,271,21,4511,517,17.710667409113398,75.31349861337566,0
Maharashtra,Solapur,Sangola,163,2,29,hab,26,3,26,137,134,21,5356,517,17.396695835591622,75.12649293970395,0
Maharashtra,Solapur,South Solapur,222,2,18,hab,17,1,38,184,204,21,5754,517,17.569985263332374,75.91641619900794,0
Maharashtra,Thane,Ambarnath,133,0,12,hab,3,9,7,126,121,21,132,540,19.151513460890843,73.24622143703711,0
Maharashtra,Thane,Bhiwandi,424,0,28,hab,26,2,46,378,396,21,866,540,19.3711660012816,73.08996452124853,0
Maharashtra,Thane,Kalyan,111,0,16,hab,15,1,22,89,95,21,2661,540,19.263649951622654,73.20220101986925,0
Maharashtra,Thane,Murbad,287,0,39,hab,37,2,42,245,248,21,4007,540,19.278793671198173,73.53146580432764,0
Maharashtra,Thane,Shahapur,589,0,65,hab,62,3,101,488,524,21,5503,540,19.510976992530907,73.42646444008709,0
Maharashtra,Thane,Thane,10,0,18,osm,0,18,0,10,-8,21,5990,540,19.187625433277194,72.96558564751307,0
Maharashtra,Wardha,Arvi,147,1,3,hab,3,0,5,142,144,21,251,585,20.94155106518793,78.33585030508394,0
Maharashtra,Wardha,Ashti,84,0,3,hab,3,0,2,82,81,21,263,585,21.223530385940784,78.18471022123158,0
Maharashtra,Wardha,Deoli,106,0,9,hab,9,0,10,96,97,21,1503,585,20.614708918742874,78.42506650805838,0
Maharashtra,Wardha,Hinganghat,139,0,10,hab,9,1,9,130,129,21,2221,585,20.48015485519163,78.76151708747126,0
Maharashtra,Wardha,Karanja,95,0,14,hab,14,0,15,80,81,21,2761,585,21.107429385824446,78.43912801879762,0
Maharashtra,Wardha,Samudrapur,166,1,83,hab,81,2,85,81,83,21,5331,585,20.61712127932332,79.00980056354143,0
Maharashtra,Wardha,Seloo,134,0,39,hab,38,1,41,93,95,21,5473,585,20.861244711148807,78.71348130870463,0
Maharashtra,Wardha,Wardha,115,0,15,hab,14,1,17,98,100,21,6419,585,20.71893581415669,78.59020107486613,0
Maharashtra,Washim,Karanja,133,0,2,hab,2,0,3,130,131,21,2760,586,20.541162873524634,77.5123131926158,0
Maharashtra,Washim,Malegaon,116,0,5,hab,5,0,5,111,111,21,3586,586,20.260394834239627,77.00839044975673,0
Maharashtra,Washim,Mangrulpir,117,0,1,hab,1,0,1,116,116,21,3673,586,20.304525069082086,77.32718937786623,0
Maharashtra,Washim,Monora,117,0,1,hab,1,0,2,115,116,21,3913,586,20.198662007996717,77.53328701584962,0
Maharashtra,Washim,Rishod,96,0,16,hab,16,0,18,78,80,21,5170,586,20.03535893644079,76.7921445998157,0
Maharashtra,Washim,Washim,126,0,11,hab,11,0,13,113,115,21,6428,586,20.0826372185619,77.1849254628781,0
Maharashtra,Yavatmal,Arni,131,0,19,hab,18,1,25,106,112,21,244,600,20.036875972856695,78.01035049179349,0
Maharashtra,Yavatmal,Babulgaon,113,0,19,hab,18,1,30,83,94,21,345,600,20.57278023611827,78.14309808350055,0
Maharashtra,Yavatmal,Darwha,137,1,6,hab,6,0,6,131,131,21,1453,600,20.319330597944614,77.76962811663054,0
Maharashtra,Yavatmal,Digras,90,0,8,hab,8,0,8,82,82,21,1632,600,20.09706292823427,77.76582151711628,0
Maharashtra,Yavatmal,Ghatanji,156,0,18,hab,18,0,23,133,138,21,1928,600,20.038981399513975,78.30732796356266,0
Maharashtra,Yavatmal,Kalamb,151,0,7,hab,6,1,7,144,144,21,2610,600,20.38793212670031,78.36600494440066,0
Maharashtra,Yavatmal,Kelapur,184,0,27,hab,25,2,36,148,157,21,2881,600,20.020572939051085,78.52878966471012,0
Maharashtra,Yavatmal,Mahagaon,124,0,6,hab,6,0,9,115,118,21,3515,600,19.836188391640654,77.76426132251939,0
Maharashtra,Yavatmal,Maregaon,132,0,8,hab,7,1,11,121,124,21,3725,600,20.132245726318935,78.7869401949229,0
Maharashtra,Yavatmal,Ner,100,0,5,hab,5,0,5,95,95,21,4279,600,20.487751690155257,77.85220515224489,0
Maharashtra,Yavatmal,Pusad,216,0,46,hab,45,1,56,160,170,21,4882,600,19.898611027091654,77.48709500534359,0
Maharashtra,Yavatmal,Relagaon,141,0,7,hab,7,0,13,128,134,21,5150,600,20.31459979831639,78.597184298243,0
Maharashtra,Yavatmal,Umarkhed,176,1,12,hab,12,0,14,162,164,21,6202,600,19.595293922004522,77.86879566704333,0
Maharashtra,Yavatmal,Wani,149,0,11,hab,11,0,12,137,138,21,6415,600,19.968766540432508,78.96568581693863,0
Maharashtra,Yavatmal,Yeotmal,154,0,10,hab,10,0,12,142,144,21,6466,600,20.300752575142056,78.13261417845716,0
Maharashtra,Yavatmal,Zarijamni,141,0,13,hab,13,0,19,122,128,21,6480,600,19.87794933584974,78.74172648007728,0
Manipur,Bishnupur,Bishnupur C.D. Block,78,6,3,hab,3,0,22,56,75,22,983,85,24.616284440896504,93.78904445784288,0
Manipur,Bishnupur,Moirang C.D.Block,62,9,9,hab,3,6,4,58,53,22,3904,85,24.45808996215161,93.80427816612467,0
Manipur,Chandel,Chakpikarong T.D.Block,169,19,28,hab,28,0,53,116,141,22,1120,104,24.055544078369206,93.99643873181041,0
Manipur,Chandel,Chandel T.D.Block,100,25,10,hab,7,3,7,93,90,22,1152,104,24.305904983438584,94.03651235237416,0
Manipur,Chandel,Machi T.D.Block,68,17,5,hab,5,0,6,62,63,22,3460,104,24.533632947953233,94.1797705326462,0
Manipur,Chandel,Tengnoupal T.D.Block,95,17,26,hab,22,4,19,76,69,22,5956,104,24.35005783022897,94.24262769717153,0
Manipur,Churachandpur,Churachandpur T.D.Block,210,12,37,hab,31,6,50,160,173,22,1363,117,24.281296429379072,93.72787523538808,0
Manipur,Churachandpur,Henglep T.D.Block,123,32,5,hab,4,1,7,116,118,22,2208,117,24.44858501633716,93.53414377264303,0
Manipur,Churachandpur,Parbung T.D.Block,40,7,13,hab,10,3,11,29,27,22,4560,117,24.353824174182165,93.1170368053541,0
Manipur,Churachandpur,Samulamlan T.D.Block,92,24,2,hab,1,1,4,88,90,22,5332,117,24.415510365720152,93.76249786175318,0
Manipur,Churachandpur,Singhat T.D.Block,62,3,26,hab,17,9,18,44,36,22,5655,117,24.11559398411048,93.57309668658992,0
Manipur,Churachandpur,Thanlon T.D.Block,50,10,20,hab,19,1,18,32,30,22,5993,117,24.295428228902644,93.30352713100801,0
Manipur,Imphal East,Imphal East _II C.D.Block,58,13,3,hab,1,2,1,57,55,22,2287,229,24.740445967352244,94.01812431913342,0
Manipur,Imphal East,Imphal East-I C.D.Block,99,30,3,hab,2,1,5,94,96,22,2288,229,24.888384757448094,94.01745556925684,0
Manipur,Imphal East,Jiribam C.D.Block,72,0,3,hab,2,1,3,69,69,22,2514,229,24.703663732893222,93.13334055534816,0
Manipur,Imphal West,Imphal West-I C.D.Block,86,7,8,hab,8,0,13,73,78,22,2289,230,24.84113382028962,93.86236377019665,0
Manipur,Imphal West,Imphal West-II C.D.Block,83,11,4,hab,4,0,16,67,79,22,2290,230,24.64591509043981,93.8767880086711,0
Manipur,Senapati,Kangpokpi T.D.Block,139,20,0,hab,0,0,0,139,139,22,2713,488,25.196462311114903,93.90331435727664,0
Manipur,Senapati,Mao Maram T.D. Block,88,5,9,hab,9,0,13,75,79,22,3719,488,25.400941855134985,94.03743472918349,0
Manipur,Senapati,Paomata T.D.Block,20,0,3,hab,3,0,6,14,17,22,4533,488,25.480609486826854,94.31406595343893,0
Manipur,Senapati,Purul T.D.Block,35,4,0,hab,0,0,0,35,35,22,4876,488,25.35805149034045,94.25048850634924,0
Manipur,Senapati,Saikul T.D.Block,225,91,1,hab,1,0,4,221,224,22,5273,488,25.000991872909957,94.06148422409083,0
Manipur,Senapati,Saitu Gamphazol T.D.Block,172,25,3,hab,2,1,25,147,169,22,5279,488,24.90856623235898,93.81245713337387,0
Manipur,Tamenglong,Nungba T.D.Block,56,0,13,hab,5,8,5,51,43,22,4356,536,24.687776369392985,93.48667711677378,0
Manipur,Tamenglong,Tamei T.D.Block,38,1,7,hab,7,0,8,30,31,22,5883,536,25.202782374725505,93.7345181850276,0
Manipur,Tamenglong,Tamenglong T.D.Block,50,3,9,hab,8,1,7,43,41,22,5884,536,24.943211170790764,93.57017586984593,0
Manipur,Tamenglong,Tousem T.D.Block,61,9,13,hab,10,3,15,46,48,22,6133,536,24.99304161108997,93.36160768999947,0
Manipur,Thoubal,Kakching C.D.Block,36,7,2,hab,1,1,2,34,34,22,2592,545,24.46278096313499,93.92487659972394,0
Manipur,Thoubal,Thoubal C.D.Block,96,14,7,hab,5,2,17,79,89,22,6061,545,24.61776443718739,94.01567415230825,0
Manipur,Ukhrul,Chingai T.D.Block,30,2,10,hab,10,0,10,20,20,22,1295,565,25.392867905736214,94.49829088307158,0
Manipur,Ukhrul,Kamjong T.D.Block,51,8,4,hab,3,1,3,48,47,22,2683,565,24.873718211784684,94.54965648845601,0
Manipur,Ukhrul,Kasom Khullen T.D.Block,30,4,7,hab,6,1,6,24,23,22,2820,565,24.65549427191632,94.28884176333897,0
Manipur,Ukhrul,Phungyar T.D.Block,39,6,5,hab,4,1,4,35,34,22,4745,565,24.846689999804827,94.32160806045711,0
Manipur,Ukhrul,Ukhrul T.D.Block,74,12,9,hab,9,0,11,63,65,22,6191,565,25.1070726657199,94.38868091379544,0
Meghalaya,East Garo Hills,Dambo Rongjeng ,190,0,4,hab,4,0,24,166,186,23,1411,166,25.70402486930943,90.80274147425726,0
Meghalaya,East Garo Hills,Kharkutta,174,0,2,hab,2,0,4,170,172,23,2977,166,25.851518031173434,90.890676988251,0
Meghalaya,East Garo Hills,Resubelpara,289,2,2,hab,2,0,5,284,287,23,5164,166,25.886448961834994,90.56351047709441,0
Meghalaya,East Garo Hills,Samanda,146,0,3,hab,3,0,8,138,143,23,5316,166,25.52861089816825,90.51400902367602,0
Meghalaya,East Garo Hills,Songsak,210,0,2,hab,2,0,3,207,208,23,5734,166,25.7056014416428,90.58101095597871,0
Meghalaya,East Khasi Hills,Laitkroh-Khadar Shnong,73,0,8,hab,8,0,14,59,65,23,3334,169,25.37100539659364,91.79409896243105,0
Meghalaya,East Khasi Hills,Mawkynrew,67,0,19,hab,19,0,24,43,48,23,3786,169,25.408857396952794,92.00991778471611,0
Meghalaya,East Khasi Hills,Mawphlang,164,0,4,hab,3,1,16,148,160,23,3788,169,25.474773852199643,91.6880926224558,0
Meghalaya,East Khasi Hills,Mawryngkneng,51,0,10,hab,9,1,15,36,41,23,3789,169,25.563876059724045,92.024803131272,0
Meghalaya,East Khasi Hills,Mawsynram,151,0,51,hab,51,0,63,88,100,23,3791,169,25.257246652724675,91.53957569993406,0
Meghalaya,East Khasi Hills,Mylliem,104,0,3,hab,3,0,5,99,101,23,4037,169,25.58044449503026,91.87516098157187,0
Meghalaya,East Khasi Hills,Pynursla,87,0,30,hab,27,3,39,48,57,23,4894,169,25.26490716858527,91.8973352936265,0
Meghalaya,East Khasi Hills,Shella Bholaganj,118,0,39,hab,38,1,64,54,79,23,5551,169,25.23137120293473,91.69589548841508,0
Meghalaya,Jaintia,Amlarem,95,0,17,hab,16,1,31,64,78,23,151,236,25.255705511166596,92.12262300290332,0
Meghalaya,Jaintia,Khliehriat,104,0,17,hab,15,2,17,87,87,23,3009,236,25.23794294585762,92.33466387919404,0
Meghalaya,Jaintia,Laskein,83,0,5,hab,5,0,10,73,78,23,3384,236,25.536768098884657,92.45082465113046,0
Meghalaya,Jaintia,Saipung,64,0,3,hab,3,0,4,60,61,23,5278,236,25.29007703662623,92.5844221007887,0
Meghalaya,Jaintia,Thadlaskein,83,0,5,hab,5,0,8,75,78,23,5969,236,25.579535278047246,92.25079938530814,0
Meghalaya,Ribhoi,Jirang,84,14,2,hab,1,1,1,83,82,23,2511,465,25.89260272479334,91.60823337520758,0
Meghalaya,Ribhoi,Umling,191,0,1,hab,1,0,1,190,190,23,6206,465,25.954170292702003,91.9151991380833,0
Meghalaya,Ribhoi,Umsning,251,7,10,hab,10,0,27,224,241,23,6211,465,25.79730520453746,92.01551852185013,0
Meghalaya,South Garo Hills,Baghmara,158,0,1,hab,0,1,0,158,157,23,381,524,25.340814343562677,90.63613421727416,0
Meghalaya,South Garo Hills,Chokpot,279,0,0,hab,0,0,0,279,279,23,1344,524,25.367506883604563,90.40764362070576,0
Meghalaya,South Garo Hills,Gasuapara,159,0,2,hab,2,0,5,154,157,23,1890,524,25.222502324487433,90.36953809824436,0
Meghalaya,South Garo Hills,Rongara,131,0,1,hab,1,0,7,124,130,23,5192,524,25.251853078300172,90.79267978500887,0
Meghalaya,West Garo Hills,Betasing,200,0,2,hab,2,0,7,193,198,23,734,590,25.51596484544641,89.99854729516531,0
Meghalaya,West Garo Hills,Dadenggre,127,0,1,hab,1,0,1,126,126,23,1389,590,25.785085875865327,90.18300736245203,0
Meghalaya,West Garo Hills,Dalu,188,0,2,hab,2,0,8,180,186,23,1408,590,25.29386113568302,90.1490276846587,0
Meghalaya,West Garo Hills,Gambegre,154,0,2,hab,2,0,6,148,152,23,1820,590,25.421646944556635,90.13353132039963,0
Meghalaya,West Garo Hills,Rongram,172,1,1,hab,0,1,0,172,171,23,5196,590,25.623202931539513,90.277295607953,0
Meghalaya,West Garo Hills,Selsella,374,0,2,hab,2,0,10,364,372,23,5474,590,25.734419397850846,90.0293502964066,0
Meghalaya,West Garo Hills,Tikrikilla,173,2,0,hab,0,0,0,173,173,23,6082,590,25.912458461906564,90.3082605482084,0
Meghalaya,West Garo Hills,Zikzak,220,2,3,hab,3,0,27,193,217,23,6483,590,25.381913884342172,89.91426262034865,0
Meghalaya,West Khasi Hills,Mairang,143,0,1,hab,1,0,1,142,142,23,3556,593,25.67968829801469,91.62625569897712,0
Meghalaya,West Khasi Hills,Mawkyrwat,146,0,4,hab,3,1,8,138,142,23,3787,593,25.367699249963415,91.3571494829514,0
Meghalaya,West Khasi Hills,Mawshynrut,244,0,2,hab,1,1,1,243,242,23,3790,593,25.60014476183259,91.01568086080111,0
Meghalaya,West Khasi Hills,Mawthadraishan,97,0,1,hab,1,0,1,96,96,23,3792,593,25.549608666311588,91.44982386950869,0
Meghalaya,West Khasi Hills,Nongstoin,163,0,1,hab,0,1,0,163,162,23,4339,593,25.557500042038786,91.23646919320792,0
Meghalaya,West Khasi Hills,Ranikor,154,2,13,hab,12,1,33,121,141,23,5095,593,25.25994011529318,91.15890835961162,0
Mizoram,Aizawl,Aibawk,21,0,2,hab,1,1,1,20,19,24,42,5,23.480505350745265,92.7365678169212,0
Mizoram,Aizawl,Darlawn,27,0,16,hab,15,1,15,12,11,24,1451,5,24.090069011756277,92.92802127048303,0
Mizoram,Aizawl,Phullen,12,0,3,hab,3,0,3,9,9,24,4742,5,23.955718428523152,93.0750101313258,0
Mizoram,Aizawl,Thingsulthliah,21,2,10,hab,8,2,8,13,11,24,6015,5,23.678040236853473,92.91696730561016,0
Mizoram,Aizawl,Tlangnuam,9,0,2,hab,1,1,1,8,7,24,6119,5,23.763248465963894,92.72293711756235,0
Mizoram,Champhai,Khawbung,23,0,6,hab,4,2,4,19,17,24,2987,102,23.19228140505073,93.27071127083802,0
Mizoram,Champhai,Khawzawl,40,0,13,hab,12,1,12,28,27,24,2988,102,23.527607041317143,93.22268822868817,0
Mizoram,Champhai,Ngopa,15,1,8,hab,8,0,7,8,7,24,4286,102,23.86466777634965,93.21885129384039,0
Mizoram,Kolasib,Thingdawl,28,1,9,hab,5,4,6,22,19,24,6014,305,24.158122918152625,92.72729421138243,0
Mizoram,Lawngtlai,Chawngte,59,0,23,hab,15,8,15,44,36,24,1213,331,22.401068913720312,92.59831663647527,0
Mizoram,Lawngtlai,Lawngtlai,50,3,43,hab,29,14,30,20,7,24,3396,331,22.375688097389627,92.76648584954168,0
Mizoram,Lunglei,Bunghmun,19,0,13,hab,7,6,7,12,6,24,1070,340,23.199023091984454,92.54323536715535,0
Mizoram,Lunglei,Hnahthial,17,0,4,hab,3,1,3,14,13,24,2233,340,22.953475081697583,92.9859448407041,0
Mizoram,Lunglei,Lunglei,28,0,3,hab,1,2,1,27,25,24,3447,340,22.89529453591471,92.79266097490509,0
Mizoram,Lunglei,Lungsen,35,1,5,hab,3,2,4,31,30,24,3448,340,22.85433856103782,92.58389302665192,0
Mizoram,Mamit,Reiek,20,1,4,hab,3,1,3,17,16,24,5149,352,23.714642018910403,92.58717564024245,0
Mizoram,Mamit,W.Phaileng,22,0,9,hab,8,1,8,14,13,24,6396,352,23.56001532092803,92.41535787415441,0
Mizoram,Mamit,Zawlnuam,23,2,4,hab,2,2,3,20,19,24,6482,352,23.985867190172755,92.41555599700592,0
Mizoram,Saiha,Sangau,15,0,11,hab,11,0,11,4,4,24,5352,477,22.664471500812372,93.03192719969144,0
Mizoram,Saiha,Tuipang,44,0,46,osm,39,7,40,4,-2,24,6145,477,22.291844657883793,93.00064056656373,0
Mizoram,Serchhip,E.Lungdar,12,0,2,hab,1,1,1,11,10,24,1724,491,23.15198218531757,93.05759204294462,0
Mizoram,Serchhip,Serchhip,22,0,4,hab,3,1,3,19,18,24,5493,491,23.378620387271503,92.89195319368308,0
Nagaland,Dimapur,Dhansaripar,45,0,1,hab,1,0,1,44,44,25,1564,157,25.749503629270848,93.6564269526232,0
Nagaland,Dimapur,Kuhoboto,42,1,1,hab,1,0,1,41,41,25,3228,157,25.922932499988185,93.82717276204936,0
Nagaland,Dimapur,Medziphema,73,0,8,hab,8,0,9,64,65,25,3808,157,25.785973655014494,93.84670385473538,0
Nagaland,Dimapur,Niuland,63,0,3,hab,1,2,1,62,60,25,4321,157,25.963800028234292,93.90225109074923,0
Nagaland,Kiphire,Kiphire,30,0,3,hab,3,0,5,25,27,25,3041,298,25.93774835294259,94.78702892530472,0
Nagaland,Kiphire,Pungro,51,0,7,hab,6,1,9,42,44,25,4857,298,25.783279562373938,94.91258007424578,0
Nagaland,Kiphire,Sitimi,35,0,13,hab,12,1,18,17,22,25,5695,298,25.88245015571872,94.68358576780815,0
Nagaland,Kohima,Chiephopozou,30,0,19,hab,19,0,20,10,11,25,1277,302,25.800031682005564,94.13194967071355,0
Nagaland,Kohima,Jakhama,17,0,18,osm,18,0,15,2,-1,25,2372,302,25.605062889127677,94.1365465743095,0
Nagaland,Kohima,Kohima,18,0,14,hab,13,1,15,3,4,25,3078,302,25.67220589883534,94.02324498859689,0
Nagaland,Kohima,Tsemenyu,41,0,11,hab,11,0,23,18,30,25,6140,302,25.938728699411037,94.16033544518243,0
Nagaland,Longleng,Longleng,26,0,7,hab,7,0,14,12,19,25,3437,335,26.47486810920868,94.80824877512748,0
Nagaland,Longleng,Tamlu,23,0,6,hab,6,0,9,14,17,25,5887,335,26.64348977106032,94.78440278780337,0
Nagaland,Mokokchung,Changtongya,31,0,5,hab,5,0,5,26,26,25,1176,367,26.54015341145226,94.64707379121799,0
Nagaland,Mokokchung,Kobulong,10,0,4,hab,4,0,6,4,6,25,3057,367,26.42735375898158,94.52423003938219,0
Nagaland,Mokokchung,Longchem,14,0,1,hab,1,0,1,13,13,25,3435,367,26.623170653433128,94.47981893457658,0
Nagaland,Mokokchung,Mangkolemba,32,0,14,hab,13,1,14,18,18,25,3669,367,26.532281128545574,94.45630624284728,0
Nagaland,Mokokchung,Ongpangkong (N),10,1,3,hab,3,0,3,7,7,25,4389,367,26.298854027844207,94.53942125976653,0
Nagaland,Mokokchung,Ongpangkong (S),9,0,9,hab,8,1,7,2,0,25,4390,367,26.31149885187143,94.42151938145516,0
Nagaland,Mon,Chen,28,0,16,hab,14,2,15,13,12,25,1225,368,26.5531315180573,94.99660412199869,0
Nagaland,Mon,Mon,21,0,12,hab,12,0,13,8,9,25,3910,368,26.758742714362374,95.02103431288621,0
Nagaland,Mon,Phomching,15,1,16,osm,16,0,14,1,-1,25,4736,368,26.689995527711034,95.14519522652377,0
Nagaland,Mon,Tizit,28,0,11,hab,9,2,10,18,17,25,6118,368,26.896149755455173,95.11355457096091,0
Nagaland,Mon,Tobu,24,0,13,hab,13,0,19,5,11,25,6120,368,26.38751076903769,95.00576523587226,0
Nagaland,Mon,Wakching,16,0,6,hab,5,1,5,11,10,25,6408,368,26.761122834256785,94.8763809969622,0
Nagaland,Peren,Jalukie,46,0,9,hab,8,1,10,36,37,25,2403,427,25.556530903219624,93.52193120001031,0
Nagaland,Peren,Peren,31,0,10,hab,9,1,10,21,21,25,4709,427,25.557108285420373,93.7729381170568,0
Nagaland,Peren,Tening,27,0,10,hab,10,0,12,15,17,25,5957,427,25.36016104411458,93.58808689738295,0
Nagaland,Phek,Kikruma,12,0,3,hab,3,0,4,8,9,25,3032,428,25.646013064192417,94.25206368530301,0
Nagaland,Phek,Meluri,34,0,14,hab,13,1,18,16,20,25,3835,428,25.61986534017546,94.70802615644905,0
Nagaland,Phek,Pfutsero,30,0,11,hab,10,1,12,18,19,25,4722,428,25.577411371248925,94.3221763004239,0
Nagaland,Phek,Phek,25,0,2,hab,2,0,3,22,23,25,4731,428,25.712428197230633,94.47402216786901,0
Nagaland,Phek,Sekruzu,17,0,4,hab,4,0,4,13,13,25,5471,428,25.758466766965,94.35553627939782,0
Nagaland,Tuensang,Chare,13,0,1,hab,1,0,2,11,12,25,1186,557,26.283466994629208,94.61958366955778,0
Nagaland,Tuensang,Chessore,15,0,5,hab,5,0,5,10,10,25,1244,557,26.098391646472383,94.75855819627944,0
Nagaland,Tuensang,Longkhim,12,0,1,hab,1,0,1,11,11,25,3436,557,26.243230902502827,94.68609640546929,0
Nagaland,Tuensang,Noklak,31,0,6,hab,6,0,9,22,25,25,4337,557,26.193495968011735,95.02177126089475,0
Nagaland,Tuensang,Noksen,12,0,1,hab,1,0,1,11,11,25,4338,557,26.365333099923195,94.7389746870129,0
Nagaland,Tuensang,Sangsangnyu,24,0,1,hab,1,0,1,23,23,25,5364,557,26.268804916296194,94.83112666945001,0
Nagaland,Tuensang,Shamator,12,0,4,hab,4,0,4,8,8,25,5529,557,26.08417113224296,94.8612726968121,0
Nagaland,Tuensang,Thonknyu,14,0,1,hab,1,0,1,13,13,25,6053,557,26.00267238114159,95.01541995189079,0
Nagaland,Wokha,Bhandari,50,1,2,hab,2,0,3,47,48,25,791,597,26.31509797936007,94.16173147877838,0
Nagaland,Wokha,Chukidong,13,0,1,hab,1,0,2,11,12,25,1361,597,26.096589649173815,94.33025697507836,0
Nagaland,Wokha,Sanis,37,0,7,hab,7,0,11,26,30,25,5367,597,26.243832735554722,94.23398578980131,0
Nagaland,Wokha,Wokha,25,0,1,hab,1,0,2,23,24,25,6438,597,26.109178880665826,94.22835315721044,0
Nagaland,Wokha,Wozhuro/Ralang,27,0,3,hab,3,0,5,22,24,25,6439,597,26.028362789018182,94.03278764709563,0
Nagaland,Zunheboto,Akuluto,40,0,4,hab,4,0,8,32,36,25,68,601,26.1402453837748,94.45228619762945,0
Nagaland,Zunheboto,Ghathashi,22,0,5,hab,5,0,5,17,17,25,1930,601,25.874851040784634,94.32011923707819,0
Nagaland,Zunheboto,Satakha,38,0,14,hab,14,0,15,23,24,25,5431,601,25.897153324064114,94.49305940767293,0
Nagaland,Zunheboto,Suruhuto,32,0,3,hab,3,0,5,27,29,25,5824,601,26.1485962687129,94.61149216193486,0
Nagaland,Zunheboto,Tokiye,34,0,7,hab,7,0,11,23,27,25,6126,601,25.99206691160336,94.59974931258323,0
Nagaland,Zunheboto,Zunheboto,19,0,1,hab,0,1,0,19,18,25,6489,601,26.030703738665963,94.53153879840376,0
Odisha,Angul,Angul,239,0,5,hab,5,0,6,233,234,26,194,23,20.703870804627165,84.940303028303,0
Odisha,Angul,Athamallik,216,0,2,hab,2,0,3,213,214,26,283,23,20.792216723503074,84.56988059918059,0
Odisha,Angul,Banarpal,141,2,2,hab,2,0,2,139,139,26,492,23,20.835292454130155,85.10820740665416,0
Odisha,Angul,Chendipada,183,0,10,hab,9,1,13,170,173,26,1228,23,21.012471677368527,84.87068586664671,0
Odisha,Angul,Kaniha,210,0,11,hab,11,0,13,197,199,26,2718,23,21.14014787517054,85.07068704373849,0
Odisha,Angul,Kishorenagar,234,0,3,hab,3,0,6,228,231,26,3053,23,20.9691367729035,84.58502050405436,0
Odisha,Angul,Pallahara,291,0,2,hab,1,1,5,286,289,26,4474,23,21.375084620652075,85.19865109156838,0
Odisha,Angul,Talcher,183,0,0,hab,0,0,0,183,183,26,5868,23,20.95892545236662,85.14697844315049,0
Odisha,Balangir,Agalpur,114,0,1,hab,1,0,1,113,113,26,28,87,20.97086882874256,83.45910722224666,0
Odisha,Balangir,Bangomunda,142,0,2,hab,2,0,3,139,140,26,510,87,20.27863236616956,82.89746726364282,0
Odisha,Balangir,Belpara,155,0,4,hab,4,0,4,151,151,26,710,87,20.601485352997482,82.95243596297131,0
Odisha,Balangir,Bolangir,137,0,2,hab,2,0,3,134,135,26,1016,87,20.700989734695785,83.39735066143173,0
Odisha,Balangir,Deogaon,138,0,0,hab,0,0,0,138,138,26,1498,87,20.57579544597763,83.37663042999728,0
Odisha,Balangir,Gudvella,94,0,2,hab,2,0,2,92,92,26,2053,87,20.44610119042287,83.54367389845414,0
Odisha,Balangir,Khaprakhol,166,0,21,hab,19,2,28,138,145,26,2964,87,20.773705643840017,82.88598600158403,0
Odisha,Balangir,Loisinga,111,0,1,hab,1,0,2,109,110,26,3433,87,20.83593683709488,83.40892623616155,0
Odisha,Balangir,Muribahal,160,0,0,hab,0,0,0,160,160,26,4009,87,20.388278167783234,83.05058265302688,0
Odisha,Balangir,Patnagarh,192,0,4,hab,3,1,4,188,188,26,4625,87,20.74985023688438,83.13944974562908,0
Odisha,Balangir,Puintala,150,0,0,hab,0,0,0,150,150,26,4844,87,20.723615657778073,83.57365002215091,0
Odisha,Balangir,Saintala,159,0,2,hab,1,1,1,158,157,26,5276,87,20.454997873892804,83.27765429466824,0
Odisha,Balangir,Titilagarh,155,0,3,hab,3,0,6,149,152,26,6117,87,20.27382515644223,83.14614203201226,0
Odisha,Balangir,Tureikela,121,0,2,hab,2,0,3,118,119,26,6157,87,20.477180358664793,82.81325510984969,0
Odisha,Balasore,Bahanaga,155,5,2,hab,2,0,9,146,153,26,404,40,21.309344042118795,86.80710264564718,0
Odisha,Balasore,Balasore,253,0,3,hab,3,0,7,246,250,26,443,40,21.500074250073666,87.0062542015356,0
Odisha,Balasore,Baliapal,202,0,1,hab,1,0,7,195,201,26,455,40,21.608071037774785,87.24447986303889,0
Odisha,Balasore,Basta,345,1,2,hab,2,0,13,332,343,26,654,40,21.686325992667864,87.12147945535162,0
Odisha,Balasore,Bhogarai,343,0,4,hab,4,0,22,321,339,26,870,40,21.672404290958045,87.3895920913581,0
Odisha,Balasore,Jaleswar,224,1,1,hab,1,0,2,222,223,26,2395,40,21.829611924200428,87.21264513216788,0
Odisha,Balasore,Khaira,318,3,2,hab,2,0,6,312,316,26,2915,40,21.255304610727787,86.4821791232557,0
Odisha,Balasore,Nilagiri,160,1,2,hab,1,1,4,156,158,26,4300,40,21.48946779156295,86.68018616405183,0
Odisha,Balasore,Oupada,157,2,0,hab,0,0,0,157,157,26,4400,40,21.371074168159186,86.61085150252218,0
Odisha,Balasore,Remuna,238,0,1,hab,1,0,8,230,237,26,5151,40,21.482086152838797,86.87164126269201,0
Odisha,Balasore,Simulia,163,0,3,hab,3,0,5,158,160,26,5645,40,21.170861502379015,86.6119479320064,0
Odisha,Balasore,Soro,157,0,1,hab,0,1,0,157,156,26,5747,40,21.282935062943118,86.6739212982796,0
Odisha,Bargarh,Ambabhona,110,0,112,osm,108,4,110,0,-2,26,125,54,21.61361272307101,83.54272944447955,0
Odisha,Bargarh,Attabira,124,0,134,osm,120,14,112,12,-10,26,303,54,21.449172527890898,83.76459817531422,0
Odisha,Bargarh,Bargarh,89,0,121,osm,97,24,87,2,-32,26,585,54,21.3222621421465,83.61690559490823,0
Odisha,Bargarh,Barpali,93,0,90,hab,83,7,87,6,3,26,616,54,21.174937144891256,83.58538993867721,0
Odisha,Bargarh,Bhatli,112,0,110,hab,106,4,105,7,2,26,820,54,21.459889417514038,83.51353125485797,0
Odisha,Bargarh,Bheden,103,0,155,osm,132,23,102,1,-52,26,837,54,21.20169463534204,83.78798032849117,0
Odisha,Bargarh,Bijepur,109,0,114,osm,111,3,109,0,-5,26,930,54,21.143374203663917,83.42928486994303,0
Odisha,Bargarh,Gaisilet,102,0,102,hab,102,0,102,0,0,26,1810,54,20.965479978115116,83.28748927476704,0
Odisha,Bargarh,Jharbandh,80,0,98,osm,84,14,80,0,-18,26,2497,54,21.08659995697588,82.79943355806014,0
Odisha,Bargarh,Padampur,151,0,149,hab,142,7,149,2,2,26,4412,54,20.994919237529356,83.10338968096076,0
Odisha,Bargarh,Paikmal,131,0,141,osm,134,7,128,3,-10,26,4430,54,20.944840993044426,82.84997466107002,0
Odisha,Bargarh,Sohella,134,0,141,osm,136,5,132,2,-7,26,5711,54,21.254674471334457,83.34126477283623,0
Odisha,Bhadrak,Basudevpur,174,0,1,hab,1,0,2,172,173,26,658,66,21.083484649816555,86.77550972764509,0
Odisha,Bhadrak,Bhadrak,207,0,2,hab,2,0,7,200,205,26,758,66,21.070923413024392,86.51054066170988,0
Odisha,Bhadrak,Bhandaripokhari,233,0,10,hab,10,0,38,195,223,26,793,66,20.9530175231627,86.35540772521021,0
Odisha,Bhadrak,Bonth,199,0,2,hab,2,0,8,191,197,26,1030,66,21.12195242566467,86.36728533390463,0
Odisha,Bhadrak,Chandbali,271,0,4,hab,4,0,7,264,267,26,1151,66,20.850811346389516,86.81311525816662,0
Odisha,Bhadrak,Dhamnagar,187,187,20,osm,0,20,0,187,167,26,1548,66,16.767183096792998,74.05021752495608,0
Odisha,Bhadrak,Tihidi,223,0,1,hab,1,0,1,222,222,26,6075,66,20.958816999520014,86.66335488005276,0
Odisha,Boudh,Boudh,385,0,1,hab,1,0,2,383,384,26,1043,89,20.720318962623008,84.11816482856321,0
Odisha,Boudh,Harbhanga,340,0,2,hab,2,0,6,334,338,26,2141,89,20.5937812803682,84.51010106912209,0
Odisha,Boudh,Kantamal,393,0,3,hab,3,0,8,385,390,26,2736,89,20.62566227391864,83.80241364133286,0
Odisha,Cuttack,Athagarh,182,0,4,hab,4,0,11,171,178,26,282,123,20.54411299252619,85.7280959343144,0
Odisha,Cuttack,Banki,104,0,1,hab,1,0,3,101,103,26,528,123,20.36805515132301,85.49322301597068,0
Odisha,Cuttack,Banki-Dampada,64,0,3,hab,2,1,6,58,61,26,529,123,20.36552551855417,85.60855382735119,0
Odisha,Cuttack,Baramba,137,0,6,hab,6,0,8,129,131,26,564,123,20.42744805276945,85.34743340097805,0
Odisha,Cuttack,Baranga,93,0,1,hab,1,0,4,89,92,26,568,123,20.381038427610655,85.88092543379005,0
Odisha,Cuttack,Cuttack,139,0,2,hab,2,0,6,133,137,26,1379,123,20.424203193865367,85.94681826322612,0
Odisha,Cuttack,Kantapara,92,0,2,hab,2,0,7,85,90,26,2737,123,20.271607262029896,86.01182452151349,0
Odisha,Cuttack,Mahanga,193,1,1,hab,1,0,8,185,192,26,3519,123,20.572421527423515,86.18789150674192,0
Odisha,Cuttack,Narsinghpur,239,0,122,hab,122,0,179,60,117,26,4208,123,20.506111613878225,85.08542890274585,0
Odisha,Cuttack,Niali,203,0,2,hab,2,0,17,186,201,26,4287,123,20.14637252526399,86.1036241854809,0
Odisha,Cuttack,Nischintakoili,226,0,2,hab,2,0,5,221,224,26,4319,123,20.435652036656784,86.19377160580552,0
Odisha,Cuttack,Salipur,166,0,1,hab,1,0,2,164,165,26,5303,123,20.49114437867455,86.06045974716494,0
Odisha,Cuttack,Tangi Choudwar,154,0,4,hab,3,1,13,141,150,26,5901,123,20.585021540861383,85.93590809742143,0
Odisha,Cuttack,Tigiria,60,0,2,hab,2,0,3,57,58,26,6074,123,20.46647972640813,85.50698612408058,0
Odisha,Deogarh,Barkote,226,0,4,hab,3,1,7,219,222,26,610,140,21.53878756325691,84.96359824044819,0
Odisha,Deogarh,Reamal,257,0,22,hab,21,1,30,227,235,26,5140,140,21.321227112714457,84.77537860606871,0
Odisha,Deogarh,Tileibani,240,0,4,hab,4,0,10,230,236,26,6086,140,21.538973337182757,84.62168824072006,0
Odisha,Dhenkanal,Bhuban,135,0,14,hab,13,1,23,112,121,26,886,152,20.903521290932968,85.77217488636535,0
Odisha,Dhenkanal,Dhenkanal,157,0,5,hab,4,1,11,146,152,26,1608,152,20.638842653907567,85.59825613290216,0
Odisha,Dhenkanal,Gondia,187,0,5,hab,5,0,12,175,182,26,1995,152,20.767211753248258,85.83305951125445,0
Odisha,Dhenkanal,Hindol,224,0,3,hab,3,0,7,217,221,26,2217,152,20.650193110328356,85.3002330230575,0
Odisha,Dhenkanal,Kamakhyanagar,209,0,49,hab,46,3,90,119,160,26,2669,152,20.8599214465258,85.54774038447762,0
Odisha,Dhenkanal,Kankadahad,136,0,1,hab,1,0,1,135,135,26,2723,152,21.06908333057727,85.50834911886373,0
Odisha,Dhenkanal,Odapada,137,0,3,hab,2,1,6,131,134,26,4374,152,20.708261817307886,85.41823983000486,0
Odisha,Dhenkanal,Parajang,131,0,7,hab,5,2,9,122,124,26,4542,152,20.939840989263057,85.34460727070419,0
Odisha,Gajapati,Gumma,218,0,1,hab,1,0,2,216,217,26,2062,188,18.933595167330434,84.02009184348215,0
Odisha,Gajapati,Kasinagar,87,0,1,hab,0,1,0,87,86,26,2815,188,18.896663573692095,83.91354958413397,0
Odisha,Gajapati,Mohana,448,0,3,hab,3,0,4,444,445,26,3885,188,19.450845657930365,84.18011613077012,0
Odisha,Gajapati,Nuagada,181,0,1,hab,1,0,4,177,180,26,4349,188,19.171215750703198,84.09389396281075,0
Odisha,Gajapati,Paralakhemundi,120,0,12,hab,12,0,14,106,108,26,4545,188,18.828835952089893,84.22109737694913,0
Odisha,Gajapati,R Udayagiri,237,0,2,hab,2,0,2,235,235,26,4902,188,19.179513000293703,84.27014558005897,0
Odisha,Gajapati,Rayagada,247,0,20,hab,18,2,31,216,227,26,5136,188,18.95907102159426,84.24779764100406,0
Odisha,Ganjam,Aska,130,0,9,hab,9,0,17,113,121,26,267,190,19.657919741353922,84.66688645281863,0
Odisha,Ganjam,Beguniapada,154,0,2,hab,1,1,1,153,152,26,686,190,19.685493765761848,84.9805382559741,0
Odisha,Ganjam,Belguntha,101,0,1,hab,1,0,3,98,100,26,703,190,19.84100947467743,84.61530725967552,0
Odisha,Ganjam,Bhanjanagar,162,0,3,hab,3,0,4,158,159,26,798,190,20.023324534810417,84.52121954486381,0
Odisha,Ganjam,Buguda,140,0,3,hab,3,0,8,132,137,26,1061,190,19.839441237603804,84.80754254683043,0
Odisha,Ganjam,Chhatrapur,76,0,84,osm,71,13,65,11,-8,26,1259,190,19.37032888914769,84.94559361469625,0
Odisha,Ganjam,Chikiti,122,0,34,hab,32,2,51,71,88,26,1282,190,19.181198902519544,84.65321979842827,0
Odisha,Ganjam,Dharakote,207,0,2,hab,2,0,3,204,205,26,1571,190,19.615056189128357,84.51978636358193,0
Odisha,Ganjam,Digapahandi,213,0,71,hab,67,4,85,128,142,26,1629,190,19.31622623565617,84.52320814061353,0
Odisha,Ganjam,Ganjam,103,0,20,hab,20,0,28,75,83,26,1862,190,19.4602184049609,85.05737579639052,0
Odisha,Ganjam,Hingilicut,61,0,24,hab,24,0,27,34,37,26,2222,190,19.450265003816057,84.78226319748043,0
Odisha,Ganjam,Jaganathprasad,168,0,2,hab,2,0,2,166,166,26,2332,190,20.063955596507675,84.73940092086391,0
Odisha,Ganjam,Kabisuryanagar,81,0,23,hab,23,0,30,51,58,26,2555,190,19.607119399270985,84.78617028198776,0
Odisha,Ganjam,Khallikote,230,0,4,hab,3,1,10,220,226,26,2932,190,19.61292336568447,85.0778099269269,0
Odisha,Ganjam,Kukudakhandi,98,0,32,hab,32,0,36,62,66,26,3231,190,19.32433983754909,84.72870386231094,0
Odisha,Ganjam,Patrapur,286,0,61,hab,58,3,95,191,225,26,4629,190,19.095487890058216,84.47601989922737,0
Odisha,Ganjam,Polasara,135,0,1,hab,1,0,4,131,134,26,4792,190,19.73809763940722,84.86654882186367,0
Odisha,Ganjam,Purusottampur,123,2,50,hab,45,5,58,65,73,26,4879,190,19.513035060053053,84.87152603185015,0
Odisha,Ganjam,Rengailunda,81,0,11,hab,10,1,13,68,70,26,5153,190,19.256686939620742,84.81758696590808,0
Odisha,Ganjam,Sanakhemundi,146,0,22,hab,22,0,32,114,124,26,5333,190,19.451964666618586,84.52862118165412,0
Odisha,Ganjam,Seragada,98,0,12,hab,12,0,21,77,86,26,5490,190,19.522770923280525,84.64738739486077,0
Odisha,Ganjam,Sorada,247,1,1,hab,1,0,2,245,246,26,5744,190,19.739011095340175,84.34917221690662,0
Odisha,Jagatsinghpur,Balikuda,228,0,2,hab,2,0,7,221,226,26,460,234,20.100294954346886,86.31308832921854,0
Odisha,Jagatsinghpur,Biridi,81,0,1,hab,1,0,4,77,80,26,967,234,20.334893962512098,86.06835548161162,0
Odisha,Jagatsinghpur,Erasama,197,0,2,hab,2,0,6,191,195,26,1745,234,20.173499233887362,86.45146992731402,0
Odisha,Jagatsinghpur,Jagatsinghpur,170,0,0,hab,0,0,0,170,170,26,2337,234,20.246850852679454,86.16799187692918,0
Odisha,Jagatsinghpur,Kujanga,157,0,2,hab,2,0,6,151,155,26,3229,234,20.292367956808114,86.53438505952903,0
Odisha,Jagatsinghpur,Nuagaon,87,0,1,hab,1,0,4,83,86,26,4351,234,20.10643476133749,86.20171601829654,0
Odisha,Jagatsinghpur,Raghunathpur,92,0,0,hab,0,0,0,92,92,26,4920,234,20.3291485324414,86.20069885582714,0
Odisha,Jagatsinghpur,Tirtol,249,0,3,hab,3,0,9,240,246,26,6097,234,20.286295146378013,86.3218726378369,0
Odisha,Jajpur,Badachana,264,0,8,hab,8,0,31,233,256,26,349,239,20.663438429955264,86.12541846746454,0
Odisha,Jajpur,Bari,111,0,1,hab,1,0,2,109,110,26,601,239,20.679693404863496,86.35536203723257,0
Odisha,Jajpur,Binjharpur,123,0,1,hab,1,0,3,120,122,26,958,239,20.73635084404649,86.44817995133079,0
Odisha,Jajpur,Danagadi,201,2,2,hab,2,0,5,196,199,26,1420,239,21.02448652747954,86.01156646349978,0
Odisha,Jajpur,Dasrathpur,197,0,3,hab,3,0,9,188,194,26,1463,239,20.816740375256522,86.49106450218558,0
Odisha,Jajpur,Dharmasala,312,0,20,hab,20,0,68,244,292,26,1593,239,20.77763733328733,86.10337054085424,0
Odisha,Jajpur,Jajpur,196,0,3,hab,3,0,11,185,193,26,2371,239,20.82656782516302,86.28456354609602,0
Odisha,Jajpur,Korei,252,2,10,hab,10,0,23,229,242,26,3138,239,20.973038237578244,86.18487849497345,0
Odisha,Jajpur,Rasulpur,192,0,9,hab,9,0,31,161,183,26,5115,239,20.82230328487674,86.16786523500498,0
Odisha,Jajpur,Sukinda,176,0,6,hab,5,1,8,168,170,26,5786,239,21.00233735865883,85.86201906344213,0
Odisha,Jharsuguda,Jharsuguda,73,0,2,hab,0,2,0,73,71,26,2501,257,21.84904220983032,83.96007287954768,0
Odisha,Jharsuguda,Kirimira,39,0,1,hab,0,1,0,39,38,26,3044,257,21.93296917329883,84.14551896734123,0
Odisha,Jharsuguda,Kolabira,97,0,1,hab,1,0,2,95,96,26,3087,257,21.804842269627045,84.18567987667093,0
Odisha,Jharsuguda,Laikera,105,0,1,hab,1,0,1,104,104,26,3332,257,21.933285492403332,84.29010399654922,0
Odisha,Jharsuguda,Lakhanpur,156,0,17,hab,17,0,18,138,139,26,3338,257,21.716467269470172,83.74701560840059,0
Odisha,Kalahandi,Bhawanipatna,351,2,1,hab,1,0,1,350,350,26,833,265,19.9400742275031,83.12551322115293,0
Odisha,Kalahandi,Dharmagarh,125,0,10,hab,10,0,14,111,115,26,1587,265,19.84006912886221,82.74602048130882,0
Odisha,Kalahandi,Golamunda,201,0,3,hab,3,0,5,196,198,26,1986,265,20.037381627420555,82.89039880254556,0
Odisha,Kalahandi,Jaipatna,187,0,5,hab,5,0,6,181,182,26,2358,265,19.50388406010559,82.75976167381323,0
Odisha,Kalahandi,Junagarh,250,0,1,hab,1,0,1,249,249,26,2541,265,19.80607750603925,82.94271921843144,0
Odisha,Kalahandi,Kalampur,72,0,0,hab,0,0,0,72,72,26,2612,265,19.60652854648885,82.86235449147631,0
Odisha,Kalahandi,Karlamunda,78,0,0,hab,0,0,0,78,78,26,2786,265,20.34033759449892,83.46326907924818,0
Odisha,Kalahandi,Kesinga,122,0,1,hab,1,0,1,121,121,26,2898,265,20.164679660606055,83.24913805067438,0
Odisha,Kalahandi,Koksara,257,0,4,hab,4,0,19,238,253,26,3086,265,19.6539904179428,82.66441334351988,0
Odisha,Kalahandi,Lanjigarh,599,0,2,hab,2,0,9,590,597,26,3378,265,19.802381145207438,83.33623631026876,0
Odisha,Kalahandi,M.Rampur,237,0,1,hab,1,0,1,236,236,26,3452,265,20.21699318484079,83.59451155677506,0
Odisha,Kalahandi,Narla,189,0,2,hab,2,0,5,184,187,26,4193,265,20.100486274519692,83.36289832574825,0
Odisha,Kalahandi,Th.Rampur,322,0,1,hab,1,0,2,320,321,26,5966,265,19.518895441388043,83.00323783388521,0
Odisha,Kandhamal,Balliguda,254,0,1,hab,1,0,1,253,253,26,467,429,20.225704360936955,83.82874714597172,0
Odisha,Kandhamal,Chakapad,167,0,1,hab,1,0,2,165,166,26,1112,429,20.272478052885294,84.43764931683579,0
Odisha,Kandhamal,Daringbadi,296,0,2,hab,2,0,3,293,294,26,1448,429,19.845552360799815,84.06561643239769,0
Odisha,Kandhamal,G.Udayagiri,87,0,2,hab,1,1,4,83,85,26,1791,429,20.112013129125895,84.36806827998191,0
Odisha,Kandhamal,K.Nuagaon,211,0,3,hab,3,0,6,205,208,26,2551,429,20.144419405028017,84.06288820698857,0
Odisha,Kandhamal,Khajuripada,239,0,1,hab,1,0,4,235,238,26,2926,429,20.502618373538766,84.33758651210056,0
Odisha,Kandhamal,Kotgarh,147,0,3,hab,3,0,3,144,144,26,3159,429,19.801477052266762,83.81837541747426,0
Odisha,Kandhamal,Phiringia,384,0,3,hab,3,0,8,376,381,26,4735,429,20.406047330883,83.9952726126017,0
Odisha,Kandhamal,Phulbani,128,0,1,hab,1,0,1,127,127,26,4741,429,20.474024453620125,84.15842108462164,0
Odisha,Kandhamal,Raikia,152,0,1,hab,1,0,2,150,151,26,4939,429,19.980030470813528,84.30983803151173,0
Odisha,Kandhamal,Tikabali,120,0,2,hab,2,0,5,115,118,26,6080,429,20.216961736486294,84.27472145514878,0
Odisha,Kandhamal,Tumudibandh,222,0,2,hab,2,0,3,219,220,26,6151,429,19.962591821353566,83.66445553327041,0
Odisha,Kendrapara,Aul (Ali),124,0,1,hab,1,0,5,119,123,26,308,289,20.65720780563369,86.60147871834765,0
Odisha,Kendrapara,Derabis,210,1,1,hab,1,0,6,204,209,26,1515,289,20.529916246887904,86.32232656630727,0
Odisha,Kendrapara,Garadpur,142,1,1,hab,1,0,1,141,141,26,1868,289,20.397541967183212,86.34143123771723,0
Odisha,Kendrapara,Kendrapara,148,1,2,hab,2,0,7,141,146,26,2883,289,20.533175059467982,86.4417017802815,0
Odisha,Kendrapara,Mahakalapara,208,1,3,hab,3,0,9,199,205,26,3516,289,20.40286309430306,86.64268628165533,0
Odisha,Kendrapara,Pattamundai,171,0,4,hab,4,0,9,162,167,26,4633,289,20.561984190128268,86.57930714834065,0
Odisha,Kendrapara,Rajkanika,158,0,1,hab,1,0,2,156,157,26,4984,289,20.725862489253103,86.68990358794815,0
Odisha,Kendrapara,Rajnagar,259,1,6,hab,5,1,6,253,253,26,4989,289,20.659189922314628,86.85457901922801,0
Odisha,Keonjhar,Anandapur,166,0,2,hab,0,2,0,166,164,26,172,290,21.33552801862883,86.08413656865164,0
Odisha,Keonjhar,Bansapal,172,0,2,hab,2,0,4,168,170,26,535,290,21.606464394228954,85.41465324140171,0
Odisha,Keonjhar,Champua,150,0,2,hab,2,0,3,147,148,26,1138,290,21.96544981552385,85.6753145397983,0
Odisha,Keonjhar,Ghasipura,219,0,1,hab,1,0,1,218,218,26,1923,290,21.16816351593503,86.05610620274287,0
Odisha,Keonjhar,Ghatgaon,141,0,3,hab,3,0,6,135,138,26,1929,290,21.46530471759813,85.81989331862395,0
Odisha,Keonjhar,Harichandanpur,235,0,3,hab,2,1,5,230,232,26,2145,290,21.279961862248985,85.76180335079334,0
Odisha,Keonjhar,Hatadihi,227,0,2,hab,2,0,5,222,225,26,2186,290,21.20054830234658,86.27115764307082,0
Odisha,Keonjhar,Jhumpura,168,0,1,hab,1,0,2,166,167,26,2505,290,21.857787442379863,85.55738028908576,0
Odisha,Keonjhar,Joda,121,0,11,hab,8,3,13,108,110,26,2518,290,22.015999109579383,85.40294524545321,0
Odisha,Keonjhar,Keonjhar,203,0,1,hab,1,0,1,202,202,26,2884,290,21.696019406292052,85.62278866947659,0
Odisha,Keonjhar,Patna,146,0,2,hab,2,0,9,137,144,26,4623,290,21.641370755352234,85.84801173674249,0
Odisha,Keonjhar,Saharpada,172,0,0,hab,0,0,0,172,172,26,5252,290,21.686300332271014,85.95056126567763,0
Odisha,Keonjhar,Telkoi,143,0,1,hab,1,0,1,142,142,26,5952,290,21.287430844646945,85.46467709528734,0
Odisha,Khurda,Balianta,163,0,1,hab,1,0,4,159,162,26,454,296,20.239842053773142,85.91858097231714,0
Odisha,Khurda,Balipatna,119,0,1,hab,1,0,3,116,118,26,462,296,20.152047267098478,85.97739113042884,0
Odisha,Khurda,Banapur,198,1,8,hab,8,0,24,174,190,26,491,296,19.847366870278574,85.12711877492137,0
Odisha,Khurda,Begunia,174,0,17,hab,17,0,14,160,157,26,685,296,20.167417313868057,85.47564236473086,0
Odisha,Khurda,Bhubaneswar,117,0,8,hab,7,1,19,98,109,26,887,296,20.308551503330477,85.78958175190202,0
Odisha,Khurda,Bolagarh,211,0,1,hab,1,0,4,207,210,26,1015,296,20.194802405292357,85.33514363934826,0
Odisha,Khurda,Chilika,126,0,24,hab,24,0,59,67,102,26,1286,296,19.801982088686856,85.28613726184422,0
Odisha,Khurda,Jatni,97,0,4,hab,3,1,7,90,93,26,2462,296,20.201060294091796,85.6963649916788,0
Odisha,Khurda,Khurda,118,0,10,hab,10,0,13,105,108,26,3026,296,20.15313614299271,85.58564512140994,0
Odisha,Khurda,Tangi,179,0,4,hab,4,0,15,164,175,26,5900,296,19.94857432273925,85.45521336955022,0
Odisha,Koraput,Bandhugaon,184,0,3,hab,3,0,5,179,181,26,495,309,18.945511196676172,83.29803428565202,0
Odisha,Koraput,Boipariguda,621,0,2,hab,2,0,6,615,619,26,1010,309,18.73581304944143,82.32186916840283,0
Odisha,Koraput,Boriguma,337,0,2,hab,2,0,2,335,335,26,1035,309,19.09099178622446,82.61240402199458,0
Odisha,Koraput,Dasmanthpur,396,0,1,hab,1,0,3,393,395,26,1458,309,19.004132965788553,82.86404755400685,0
Odisha,Koraput,Jeypore,316,0,0,hab,0,0,0,316,316,26,2483,309,18.912943981428107,82.55188129675744,0
Odisha,Koraput,Koraput,187,0,24,hab,22,2,27,160,163,26,3132,309,18.796152969558616,82.75849825392035,0
Odisha,Koraput,Kotpad,232,0,3,hab,2,1,3,229,229,26,3177,309,19.07645971074098,82.33663132051096,0
Odisha,Koraput,Kundra,203,0,4,hab,4,0,10,193,199,26,3261,309,18.90777541364558,82.37597646469766,0
Odisha,Koraput,Lamtaput,259,0,50,hab,46,4,57,202,209,26,3373,309,18.6098417187402,82.5762446861251,0
Odisha,Koraput,Laxmipur,230,0,19,hab,18,1,22,208,211,26,3400,309,18.977871906919322,83.0661481105072,0
Odisha,Koraput,Nandapur,521,0,26,hab,23,3,53,468,495,26,4135,309,18.448122698900356,82.69215908441087,0
Odisha,Koraput,Narayanpatna,262,0,46,hab,40,6,66,196,216,26,4173,309,18.830315573236454,83.13780337079936,0
Odisha,Koraput,Pottangi,310,3,19,hab,18,1,23,287,291,26,4817,309,18.502986924049395,82.96775999942365,0
Odisha,Koraput,Semiliguda,327,0,56,hab,53,3,78,249,271,26,5476,309,18.657035710611698,82.87097749341878,0
Odisha,Malkangiri,Kalimela,319,0,3,hab,3,0,3,316,316,26,2637,351,18.0248580934191,81.74503166258651,0
Odisha,Malkangiri,Khairput,193,0,54,hab,47,7,72,121,139,26,2920,351,18.48934600970462,82.29533161155508,0
Odisha,Malkangiri,Korukunda,372,2,8,hab,8,0,21,351,364,26,3143,351,18.245333250944263,81.9176171911597,0
Odisha,Malkangiri,Kudumuluguma,322,3,27,hab,17,10,24,298,295,26,3225,351,18.22674483091666,82.2267787821335,0
Odisha,Malkangiri,Malkangiri,248,0,5,hab,4,1,10,238,243,26,3597,351,18.41482198867275,81.96759871783784,0
Odisha,Malkangiri,Mathili,306,0,2,hab,2,0,3,303,304,26,3762,351,18.588654922340048,82.09380894947844,0
Odisha,Malkangiri,Podia,146,0,6,hab,5,1,7,139,140,26,4782,351,18.096069511264627,81.57306794017279,0
Odisha,Mayurbhanj,Badasahi,210,0,1,hab,1,0,2,208,209,26,357,360,21.745055893610168,86.73874198440323,0
Odisha,Mayurbhanj,Bahalda,113,0,3,hab,2,1,3,110,110,26,403,360,22.400314276020264,86.15548764757014,0
Odisha,Mayurbhanj,Bangiriposi,246,0,4,hab,4,0,14,232,242,26,509,360,22.066328888993567,86.4615723216917,0
Odisha,Mayurbhanj,Baripada,103,0,0,hab,0,0,0,103,103,26,604,360,21.896983001920347,86.78964233539187,0
Odisha,Mayurbhanj,Betnati,222,0,1,hab,1,0,3,219,221,26,736,360,21.688664652870973,86.91418754301759,0
Odisha,Mayurbhanj,Bijatola,167,0,1,hab,1,0,4,163,166,26,927,360,22.245747196287105,86.31533079695026,0
Odisha,Mayurbhanj,Bisoi,167,0,0,hab,0,0,0,167,167,26,987,360,22.12756484195882,86.31450260677401,0
Odisha,Mayurbhanj,Gopabandhunagar,128,1,1,hab,1,0,3,125,127,26,2002,360,21.65582202829815,86.6830457617315,0
Odisha,Mayurbhanj,Jamada,79,0,1,hab,1,0,1,78,78,26,2406,360,22.27597669593738,86.05688151876409,0
Odisha,Mayurbhanj,Jashipur,229,0,5,hab,5,0,11,218,224,26,2450,360,21.928398314587152,86.1981034018975,0
Odisha,Mayurbhanj,Kaptipada,155,0,2,hab,2,0,3,152,153,26,2748,360,21.454607655672692,86.4188768402551,0
Odisha,Mayurbhanj,Karanjia,154,0,2,hab,1,1,1,153,152,26,2764,360,21.774231101616802,86.09288492210699,0
Odisha,Mayurbhanj,Khunta,119,0,0,hab,0,0,0,119,119,26,3022,360,21.735762135046375,86.58645495389823,0
Odisha,Mayurbhanj,Kuliana,207,0,2,hab,2,0,7,200,205,26,3236,360,22.061400076433454,86.70820555118472,0
Odisha,Mayurbhanj,Kusumi,165,0,0,hab,0,0,0,165,165,26,3308,360,22.13393287193468,86.10431324324595,0
Odisha,Mayurbhanj,Morada,166,0,1,hab,1,0,2,164,165,26,3917,360,21.86022034946877,86.93075758873533,0
Odisha,Mayurbhanj,Rairanghpur,189,1,1,hab,0,1,0,189,188,26,4953,360,22.324868159576038,86.23286886146613,0
Odisha,Mayurbhanj,Raruan,104,0,2,hab,2,0,5,99,102,26,5108,360,22.010523451340646,85.8311449241998,0
Odisha,Mayurbhanj,Rasgovindpur,159,0,1,hab,1,0,4,155,158,26,5110,360,21.779975057997532,87.05905484235944,0
Odisha,Mayurbhanj,Samakhunta,122,0,1,hab,1,0,3,119,121,26,5312,360,21.852956823941597,86.51198278830329,0
Odisha,Mayurbhanj,Saraskana,179,0,5,hab,5,0,9,170,174,26,5406,360,22.235605855260992,86.57265653950938,0
Odisha,Mayurbhanj,Sukruli,90,0,1,hab,0,1,0,90,89,26,5789,360,21.90044703542578,85.88304483127291,0
Odisha,Mayurbhanj,Suliapada,185,0,1,hab,1,0,5,180,184,26,5790,360,22.02322226558963,86.90645918088714,0
Odisha,Mayurbhanj,Thakurmunda,172,0,2,hab,2,0,4,168,170,26,5974,360,21.52121169565161,86.2013769065283,0
Odisha,Mayurbhanj,Tiringi,80,0,1,hab,1,0,3,77,79,26,6093,360,22.478224665458253,86.03981489657939,0
Odisha,Mayurbhanj,Udala,87,0,1,hab,1,0,2,85,86,26,6173,360,21.613293782687034,86.4892125386689,0
Odisha,Nawarangpur,Chandahandi,191,0,12,hab,12,0,28,163,179,26,1146,396,19.835244240521437,82.49481502804808,0
Odisha,Nawarangpur,Dabugam,153,0,20,hab,20,0,33,120,133,26,1385,396,19.48236465017491,82.35024887897903,0
Odisha,Nawarangpur,Jharigam,538,0,4,hab,4,0,14,524,534,26,2500,396,19.671115229916488,82.39722233554262,0
Odisha,Nawarangpur,Kosagumuda,319,1,53,hab,52,1,82,237,266,26,3144,396,19.282706521873063,82.26158126207709,0
Odisha,Nawarangpur,Nandahandi,161,0,0,hab,0,0,0,161,161,26,4132,396,19.223250302355755,82.66327367039383,0
Odisha,Nawarangpur,Nowrangpur,213,0,0,hab,0,0,0,213,213,26,4347,396,19.256351000953444,82.48463540698863,0
Odisha,Nawarangpur,Papadahandi,380,0,5,hab,5,0,13,367,375,26,4535,396,19.419174851245778,82.5007551750588,0
Odisha,Nawarangpur,Raighar,318,0,5,hab,3,2,4,314,313,26,4937,396,19.942925232961706,82.02819537113342,0
Odisha,Nawarangpur,Tentulikhunti,267,0,2,hab,2,0,6,261,265,26,5959,396,19.30622045106204,82.7196577746599,0
Odisha,Nawarangpur,Umerkote,388,0,5,hab,4,1,7,381,383,26,6205,396,19.69793602396842,82.17605875955297,0
Odisha,Nayagarh,Bhapur,107,0,0,hab,0,0,0,107,107,26,803,398,20.29447009662127,85.26998432499335,0
Odisha,Nayagarh,Daspalla,363,0,1,hab,1,0,2,361,362,26,1460,398,20.33293760400403,84.7295320416184,0
Odisha,Nayagarh,Gania,102,0,1,hab,1,0,2,100,101,26,1860,398,20.459309210909264,84.86438480412606,0
Odisha,Nayagarh,Khandapara,167,0,2,hab,2,0,3,164,165,26,2951,398,20.30514157589736,85.11775152866564,0
Odisha,Nayagarh,Nayagarh,156,0,1,hab,1,0,1,155,155,26,4258,398,20.122948164999972,85.10883109287407,0
Odisha,Nayagarh,Nuagaon,220,0,1,hab,1,0,3,217,219,26,4350,398,20.188179314757555,84.94322230891376,0
Odisha,Nayagarh,Odagaon,214,0,2,hab,2,0,7,207,212,26,4371,398,19.99624420164207,85.0237785000269,0
Odisha,Nayagarh,Ranpur,253,0,0,hab,0,0,0,253,253,26,5104,398,20.02394088666425,85.29614698278606,0
Odisha,Nuapara,Boden,117,0,132,osm,108,24,104,13,-15,26,999,408,20.28876686900886,82.55253741368949,0
Odisha,Nuapara,Khariar,184,0,118,hab,114,4,166,18,66,26,2972,408,20.25456278100885,82.7507090495669,0
Odisha,Nuapara,Komna,210,0,205,hab,170,35,187,23,5,26,3106,408,20.569266273251586,82.55813226237926,0
Odisha,Nuapara,Nuapara,206,0,198,hab,175,23,194,12,8,26,4353,408,20.835325742464505,82.53188334403177,0
Odisha,Nuapara,Sinpalli,156,0,153,hab,138,15,134,22,3,26,5664,408,20.09348536260475,82.57617837253545,0
Odisha,Puri,Astaranga,104,0,1,hab,1,0,1,103,103,26,275,441,19.97432032674637,86.27712530868105,0
Odisha,Puri,Brahmagiri,146,0,4,hab,4,0,10,136,142,26,1045,441,19.816254022216103,85.65967785457748,0
Odisha,Puri,Delanga,127,0,4,hab,4,0,6,121,123,26,1489,441,20.055447257584717,85.73365578525329,0
Odisha,Puri,Gop,189,0,3,hab,3,0,5,184,186,26,2001,441,19.926604613069937,86.02977969722126,0
Odisha,Puri,Kakatpur,96,0,1,hab,1,0,4,92,95,26,2591,441,19.9609471834372,86.17600471473976,0
Odisha,Puri,Kanas,140,1,1,hab,1,0,6,134,139,26,2694,441,19.972408161206967,85.61913205910012,0
Odisha,Puri,Krushnaprasad,144,0,14,hab,14,0,27,117,130,26,3210,441,19.69863877203735,85.36993638620321,0
Odisha,Puri,Nimapada,222,0,1,hab,0,1,0,222,221,26,4307,441,20.055103694290455,85.98192440731486,0
Odisha,Puri,Pipili,187,0,5,hab,5,0,19,168,182,26,4763,441,20.090283615660073,85.83267395560894,0
Odisha,Puri,Puri,147,0,12,hab,12,0,21,126,135,26,4868,441,19.871096103555296,85.82547059400237,0
Odisha,Puri,Styabadi,150,0,1,hab,1,0,5,145,149,26,5775,441,19.95205712478019,85.80999144455545,0
Odisha,Rayagada,Bissam Cuttack,426,0,1,hab,1,0,6,420,425,26,990,462,19.466748825917133,83.53266772269146,0
Odisha,Rayagada,Chandrapur,169,0,1,hab,1,0,1,168,168,26,1165,462,19.574289607620894,83.794555211012,0
Odisha,Rayagada,Gudari,263,0,2,hab,1,1,2,261,261,26,2035,462,19.39479976742818,83.77532787825952,0
Odisha,Rayagada,Gunupur,143,0,2,hab,2,0,3,140,141,26,2076,462,19.09507429243119,83.8741895110234,0
Odisha,Rayagada,Kalyansinghpur,298,0,1,hab,1,0,4,294,297,26,2668,462,19.452257990234074,83.3255534685782,0
Odisha,Rayagada,Kashipur,499,0,4,hab,4,0,8,491,495,26,2810,462,19.30384227638316,83.08330586167172,0
Odisha,Rayagada,Kolnara,238,0,1,hab,1,0,1,237,237,26,3102,462,19.25649818046417,83.5136621022778,0
Odisha,Rayagada,Muniguda,497,0,3,hab,3,0,11,486,494,26,3998,462,19.75203922508745,83.50713253551454,0
Odisha,Rayagada,Padmapur,170,0,1,hab,1,0,3,167,169,26,4419,462,19.28860617322013,83.88306895352733,0
Odisha,Rayagada,Ramanguda,126,0,2,hab,2,0,2,124,124,26,5027,462,19.193085349781207,83.701467161392,0
Odisha,Rayagada,Rayagada,396,0,6,hab,5,1,16,380,390,26,5135,462,19.132833783927392,83.37384669083714,0
Odisha,Sambalpur,Bamra,155,0,3,hab,3,0,4,151,152,26,488,480,22.009756222528868,84.41969535531584,0
Odisha,Sambalpur,Dhankauda,162,0,9,hab,8,1,11,151,153,26,1560,480,21.488643316547545,83.94567952052472,0
Odisha,Sambalpur,Jamankira,240,1,6,hab,5,1,6,234,234,26,2413,480,21.554591550535683,84.32853256010787,0
Odisha,Sambalpur,Jujumura,236,0,2,hab,2,0,3,233,234,26,2535,480,21.31809616615858,84.13417474802573,0
Odisha,Sambalpur,Kuchinda,134,0,3,hab,3,0,4,130,131,26,3219,480,21.759610603907195,84.43734086635963,0
Odisha,Sambalpur,Maneswar,135,0,3,hab,3,0,6,129,132,26,3661,480,21.345865060002676,84.00813506974316,0
Odisha,Sambalpur,Naktideul,190,0,11,hab,9,2,12,178,179,26,4104,480,21.227155384650086,84.50455783596612,0
Odisha,Sambalpur,Rairakhole,207,0,1,hab,1,0,3,204,206,26,4952,480,21.088015659172793,84.23226233970533,0
Odisha,Sambalpur,Rengali,168,0,3,hab,3,0,5,163,165,26,5154,480,21.679645560394228,84.09527566610785,0
Odisha,Sonepur,Binika,97,0,0,hab,0,0,0,97,97,26,957,520,21.020033291883436,83.75241562095985,0
Odisha,Sonepur,Birmaharajpur,169,0,17,hab,16,1,18,151,152,26,969,520,20.935992391273093,84.09708633365088,0
Odisha,Sonepur,Dunguripali,137,0,1,hab,1,0,1,136,136,26,1711,520,21.046052420004767,83.59552717451498,0
Odisha,Sonepur,Sonepur,133,0,0,hab,0,0,0,133,133,26,5731,520,20.863362411955936,83.74268970690814,0
Odisha,Sonepur,Tarava,158,0,1,hab,0,1,0,158,157,26,5922,520,20.688807966453442,83.66888291044599,0
Odisha,Sonepur,Ulunda,201,0,4,hab,4,0,5,196,197,26,6197,520,21.001330554019724,83.91712244704719,0
Odisha,Sundargarh,Balisankara,161,0,37,hab,33,4,37,124,124,26,463,531,22.340468207542386,84.00657277756848,0
Odisha,Sundargarh,Bargaon,167,0,0,hab,0,0,0,167,167,26,584,531,22.21106153202496,84.26629711774355,0
Odisha,Sundargarh,Bisra,179,0,2,hab,2,0,14,165,177,26,988,531,22.253716184090486,85.01162250734552,0
Odisha,Sundargarh,Bonaigarh,134,0,2,hab,1,1,2,132,132,26,1023,531,21.72638309057661,84.86703487390271,0
Odisha,Sundargarh,Gurundia,169,0,3,hab,3,0,4,165,166,26,2088,531,21.918960864802266,84.71924128671233,0
Odisha,Sundargarh,Hemgiri,175,0,6,hab,6,0,11,164,169,26,2206,531,21.974068280775384,83.69899236997827,0
Odisha,Sundargarh,Koira,199,0,4,hab,4,0,4,195,195,26,3084,531,21.95388498555632,85.1512473023858,0
Odisha,Sundargarh,Kuanramunda,157,0,5,hab,2,3,3,154,152,26,3214,531,22.325948613052752,84.71369701508996,0
Odisha,Sundargarh,Kutra,253,0,1,hab,1,0,7,246,252,26,3313,531,22.26696838349647,84.43226192683504,0
Odisha,Sundargarh,Lahunipara,237,0,5,hab,5,0,11,226,232,26,3331,531,21.79389586706871,85.04503774304598,0
Odisha,Sundargarh,Lathikata,221,0,5,hab,2,3,5,216,216,26,3388,531,22.131115210176386,84.82842207181032,0
Odisha,Sundargarh,Lefripada,140,0,11,hab,9,2,10,130,129,26,3403,531,22.139203845198953,83.80302394172811,0
Odisha,Sundargarh,Nuagaon,191,0,1,hab,1,0,4,187,190,26,4352,531,22.385608944422195,84.94251528622398,0
Odisha,Sundargarh,Rajgangpur,230,0,0,hab,0,0,0,230,230,26,4976,531,22.165369282764953,84.60648380263144,0
Odisha,Sundargarh,Subdega,148,0,1,hab,1,0,2,146,147,26,5778,531,22.258414361306397,84.1338762427426,0
Odisha,Sundargarh,Sundargarh,151,0,2,hab,2,0,2,149,149,26,5807,531,22.049200264229604,84.12306435098806,0
Odisha,Sundargarh,Tangarpali,109,0,2,hab,2,0,2,107,107,26,5899,531,22.096880383617478,83.95845410336352,0
Punjab,Amritsar,Ajnala,135,0,93,hab,88,5,96,39,42,28,51,18,31.90080350604794,74.81896609013235,0
Punjab,Amritsar,Chogawan,107,0,79,hab,69,10,74,33,28,28,1341,18,31.731696977559203,74.62906009185278,0
Punjab,Amritsar,Harsha Chhina,60,1,57,hab,50,7,47,13,3,28,2166,18,31.763309235492528,74.78747787376246,0
Punjab,Amritsar,Jandiala,52,0,47,hab,40,7,40,12,5,28,2437,18,31.58030372845261,75.01692790635423,0
Punjab,Amritsar,Rayya,80,0,27,hab,22,5,23,57,53,28,5138,18,31.581970777329172,75.25971965462533,0
Punjab,Amritsar,Tarsika,82,0,21,hab,19,2,20,62,61,28,5931,18,31.65478180027357,75.13782332588292,0
Punjab,Amritsar,Verka,32,1,47,osm,33,14,27,5,-15,28,6347,18,31.658813110803706,74.87262554849691,0
Punjab,Barnala,Barnala,52,0,52,hab,41,11,42,10,0,28,6946,612,30.31240702159026,75.55332276494781,0
Punjab,Barnala,Mehal Kalan,36,0,38,osm,38,0,36,0,-2,28,6947,612,30.52292512960174,75.53857150043545,0
Punjab,Barnala,Sehna,35,0,37,osm,31,6,33,2,-2,28,6948,612,30.40949444702626,75.38102689696488,0
Punjab,Bathinda,Bathinda,71,0,65,hab,53,12,62,9,6,28,664,60,30.245963067432147,74.89737363102127,0
Punjab,Bathinda,Bhagta,27,0,27,hab,23,4,24,3,0,28,766,60,30.473509708415992,75.13832877870283,0
Punjab,Bathinda,Maur,33,0,32,hab,30,2,32,1,1,28,3777,60,30.072228346849343,75.19122688152959,0
Punjab,Bathinda,Nathana,38,1,29,hab,28,1,28,10,9,28,4221,60,30.27090641831702,75.08626299645533,0
Punjab,Bathinda,Phul,23,0,20,hab,18,2,20,3,3,28,4740,60,30.35884084469706,75.23036676394277,0
Punjab,Bathinda,Rampura,32,0,30,hab,29,1,30,2,2,28,5067,60,30.204996198390685,75.26683955288499,0
Punjab,Bathinda,Sangat,38,0,38,hab,36,2,36,2,0,28,5351,60,30.072327212082886,74.80225554174427,0
Punjab,Bathinda,Talwandi Sabo,47,0,48,osm,46,2,46,1,-1,28,5880,60,29.957725579036378,75.05808677626324,0
Punjab,Faridkot,Faridkot,165,3,95,hab,93,2,135,30,70,28,1762,178,30.715528943317622,74.68913368787553,0
Punjab,Faridkot,Kotkapura,117,1,83,hab,80,3,91,26,34,28,3174,178,30.51295584881316,74.86866856704697,0
Punjab,Fatehgarh Sahib,Amloh,88,0,55,hab,51,4,53,35,33,28,152,181,30.612660520243804,76.21632104378783,0
Punjab,Fatehgarh Sahib,Bassi Pathana,73,0,76,osm,72,4,71,2,-3,28,653,181,30.7001042261586,76.43591311778782,0
Punjab,Fatehgarh Sahib,Khamano,72,0,67,hab,67,0,69,3,5,28,2935,181,30.793579837182122,76.35383144307697,0
Punjab,Fatehgarh Sahib,Khera,88,2,77,hab,77,0,76,12,11,28,2996,181,30.621850679006563,76.52221580603458,0
Punjab,Fatehgarh Sahib,Sirhind,107,1,101,hab,94,7,100,7,6,28,5670,181,30.550926180248844,76.39284563812048,0
Punjab,Fazilka,Abohar,86,0,69,hab,56,13,63,23,17,28,6949,613,30.08937881796388,74.24513054538565,0
Punjab,Fazilka,Fazilka,132,1,116,hab,93,23,100,32,16,28,6950,613,30.395816574822533,74.10717808549926,0
Punjab,Fazilka,Jalalabad,145,0,129,hab,120,9,127,18,16,28,6952,613,30.53484012561937,74.22231499515247,0
Punjab,Fazilka,Khuian Sarwar,53,0,55,osm,43,12,45,8,-2,28,6951,613,30.167945766523214,74.04535477199722,0
Punjab,Firozpur,Ferozepur,102,1,177,osm,122,55,94,8,-75,28,1783,183,30.971304886657297,74.63532863386922,0
Punjab,Firozpur,Ghall Khurd,21,0,134,osm,25,109,20,1,-113,28,1911,183,30.880235879191805,74.78798254908828,0
Punjab,Firozpur,Guruharsahai,85,0,145,osm,95,50,81,4,-60,28,2087,183,30.675975291797197,74.3534174149596,0
Punjab,Firozpur,Makhu,125,0,133,osm,108,25,110,15,-8,28,3574,183,31.093148898710552,74.96034504390109,0
Punjab,Firozpur,Mamdot,85,1,133,osm,90,43,78,7,-48,28,3615,183,30.845139511296956,74.43838410121604,0
Punjab,Firozpur,Zira,93,0,112,osm,83,29,85,8,-19,28,6484,183,30.9717066019328,74.95334230021766,0
Punjab,Gurdaspur,Batala,114,0,33,hab,29,4,30,84,81,28,660,207,31.807408570582215,75.20246734460686,0
Punjab,Gurdaspur,Dera Baba Nanak,135,0,40,hab,39,1,53,82,95,28,1513,207,31.981249967212552,75.04268298673063,0
Punjab,Gurdaspur,Dhariwal,94,0,58,hab,53,5,71,23,36,28,1585,207,31.93138512762531,75.29677181702017,0
Punjab,Gurdaspur,Dinanagar,71,0,1,hab,1,0,1,70,70,28,1637,207,32.121763577623156,75.4727523997345,0
Punjab,Gurdaspur,Dorangla,46,0,20,hab,14,6,20,26,26,28,7747,207,32.11420188334433,75.33005588371547,0
Punjab,Gurdaspur,Fatehgarh Churian,85,0,18,hab,18,0,18,67,67,28,1770,207,31.869008988191254,75.02774238903594,0
Punjab,Gurdaspur,Gurdaspur,100,0,36,hab,29,7,27,73,64,28,2079,207,32.03198845409525,75.40244884207017,0
Punjab,Gurdaspur,Kahnuwan,111,0,28,hab,26,2,29,82,83,28,2580,207,31.87949711005983,75.46712452349571,0
Punjab,Gurdaspur,Kalanour,79,0,44,hab,43,1,54,25,35,28,2615,207,32.0207078881076,75.18752604948426,0
Punjab,Gurdaspur,Qadian,38,0,48,osm,32,16,26,12,-10,28,4895,207,31.786601586871747,75.3837002592456,0
Punjab,Gurdaspur,Shri Har Gobindpur,76,0,42,hab,37,5,40,36,34,28,5593,207,31.693221997895787,75.3968292875744,0
Punjab,Hoshiarpur,Bhunga,187,0,58,hab,57,1,69,118,129,28,892,225,31.714163693313523,75.84502678337222,0
Punjab,Hoshiarpur,Dasuya,158,0,11,hab,11,0,15,143,147,28,1464,225,31.825336546819226,75.68153828479907,0
Punjab,Hoshiarpur,Garhshankar,139,1,14,hab,14,0,20,119,125,28,1876,225,31.247574183273056,76.15558263345365,0
Punjab,Hoshiarpur,Hajipur,90,0,2,hab,2,0,2,88,88,28,2107,225,31.962466440516593,75.7170077762367,0
Punjab,Hoshiarpur,Hoshiarpur-1,182,1,41,hab,39,2,46,136,141,28,2245,225,31.554271670473273,75.83424710131786,0
Punjab,Hoshiarpur,Hoshiarpur-2,114,0,53,hab,50,3,51,63,61,28,2246,225,31.486287953684194,75.95035592044049,0
Punjab,Hoshiarpur,Mahilpur,149,0,8,hab,7,1,8,141,141,28,3532,225,31.37188417817771,76.0372169704677,0
Punjab,Hoshiarpur,Mukerian,129,0,18,hab,16,2,26,103,111,28,3960,225,31.982085991028107,75.61117768159254,0
Punjab,Hoshiarpur,Talwara,72,0,22,hab,17,5,24,48,50,28,5881,225,31.89632770108667,75.8661993205453,0
Punjab,Hoshiarpur,Tanda,111,0,60,hab,59,1,60,51,51,28,5893,225,31.674776164510636,75.61212654069175,0
Punjab,Jalandhar,Adampur,72,0,4,hab,3,1,4,68,68,28,16,240,31.42074164688522,75.71160726054057,0
Punjab,Jalandhar,Bhogpur,83,0,35,hab,35,0,38,45,48,28,872,240,31.5315871649619,75.63889819506947,0
Punjab,Jalandhar,Jalandhar East,86,0,9,hab,9,0,8,78,77,28,2388,240,31.288393061261452,75.62257940593858,0
Punjab,Jalandhar,Jalandhar West,155,0,18,hab,12,6,15,140,137,28,2389,240,31.39287654141602,75.52075523785093,1
Punjab,Jalandhar,Lohian,96,0,9,hab,9,0,11,85,87,28,3432,240,31.134167282960334,75.22188069583798,0
Punjab,Jalandhar,Nakodar,136,0,44,hab,43,1,49,87,92,28,4102,240,31.123206708686535,75.47217994967076,0
Punjab,Jalandhar,Nurmehal,82,0,37,hab,35,2,36,46,45,28,4357,240,31.050306484328917,75.62109823313241,0
Punjab,Jalandhar,Phillaur,102,0,11,hab,10,1,13,89,91,28,4733,240,31.079089904410647,75.83995479304822,0
Punjab,Jalandhar,Rurka,51,0,10,hab,9,1,10,41,41,28,5217,240,31.14284847837426,75.69456100470501,0
Punjab,Jalandhar,Shahkot,103,1,2,hab,2,0,6,97,101,28,5512,240,31.07578517968847,75.3397589368754,0
Punjab,Kapurthala,Dhilwan,92,0,22,hab,20,2,27,65,70,28,1609,275,31.460478120719536,75.32487964296796,0
Punjab,Kapurthala,Kapurthala,152,0,11,hab,11,0,16,136,141,28,2749,275,31.33483983149486,75.36853197902462,0
Punjab,Kapurthala,Nadala,94,0,48,hab,43,5,47,47,46,28,4045,275,31.57119613991558,75.49135405600839,0
Punjab,Kapurthala,Phagwara,105,0,6,hab,6,0,8,97,99,28,4724,275,31.272860346666267,75.77834394928784,0
Punjab,Kapurthala,Sultanpur,162,0,10,hab,10,0,10,152,152,28,5798,275,31.243217811691103,75.17492129737244,0
Punjab,Ludhiana,Dehlon,10,0,33,osm,10,23,8,2,-23,28,1486,339,30.770245833024703,75.8639855170631,0
Punjab,Ludhiana,Doraha,56,1,25,hab,21,4,22,34,31,28,1666,339,30.723402441985982,76.02920056258392,0
Punjab,Ludhiana,Jagraon,41,1,50,osm,32,18,34,7,-9,28,2347,339,30.790675648638814,75.44555862879982,0
Punjab,Ludhiana,Khanna,56,0,31,hab,26,5,30,26,25,28,2957,339,30.703341900173722,76.16996317499736,0
Punjab,Ludhiana,Ludhiana I,41,15,40,osm,27,13,25,16,1,28,3441,339,30.905092934967094,75.77848132296752,0
Punjab,Ludhiana,Ludhiana II,139,0,57,hab,54,3,66,73,82,28,3442,339,30.925961143734504,76.0050054665306,0
Punjab,Ludhiana,Machhiwara,113,1,34,hab,32,2,33,80,79,28,3458,339,30.920027508183548,76.23017950819028,0
Punjab,Ludhiana,Maloudh,46,0,36,hab,35,1,36,10,10,28,7750,339,30.652484927230027,75.95006003219675,0
Punjab,Ludhiana,Pakhowal,35,10,42,osm,30,12,27,8,-7,28,4435,339,30.720703412715796,75.7390439414814,0
Punjab,Ludhiana,Railkot,36,2,41,osm,36,5,35,1,-5,28,7749,339,30.63950520296694,75.58532767606609,0
Punjab,Ludhiana,Samrala,63,0,56,hab,55,1,56,7,7,28,5328,339,30.797372813347778,76.18341034764298,0
Punjab,Ludhiana,Sidhwan Bet,68,17,38,hab,35,3,35,33,30,28,5611,339,30.909443823339064,75.57655317011171,0
Punjab,Ludhiana,Sudhar,42,0,39,hab,38,1,38,4,3,28,5780,339,30.789747280029744,75.62399715487098,0
Punjab,Mansa,Bhikhi,39,0,33,hab,31,2,36,3,6,28,847,357,30.096193486391602,75.50210021540984,0
Punjab,Mansa,Budhlada,90,0,83,hab,79,4,84,6,7,28,1059,357,29.879544776576292,75.58640359816852,0
Punjab,Mansa,Jhunir,41,0,42,osm,42,0,41,0,-1,28,2506,357,29.868320094369874,75.30067759411928,0
Punjab,Mansa,Mansa,49,0,42,hab,39,3,43,6,7,28,3704,357,30.007349802549097,75.37341241693238,0
Punjab,Mansa,Sardulgarh,52,0,41,hab,39,2,47,5,11,28,5413,357,29.696580108959445,75.27651748755375,0
Punjab,Moga,Baghapurana,50,0,47,hab,37,10,44,6,3,28,379,365,30.639933507010806,75.05357593335938,0
Punjab,Moga,Kot  Ise Khan,149,0,155,osm,137,18,141,8,-6,28,3149,365,30.955811818134755,75.21484744502813,0
Punjab,Moga,Moga  I,38,0,52,osm,39,13,36,2,-14,28,3876,365,30.782926441095277,75.2600613865271,0
Punjab,Moga,Moga II,36,0,43,osm,38,5,36,0,-7,28,3877,365,30.813068571371588,75.04996175743992,0
Punjab,Moga,Nihal singh wala,33,0,37,osm,32,5,32,1,-4,28,4298,365,30.60479334973228,75.29309664214601,0
Punjab,Mohali,Dera Bassi,172,0,117,hab,109,8,159,13,55,28,6955,614,30.52876236335429,76.84471501227279,0
Punjab,Mohali,Kharar,148,1,139,hab,120,19,130,18,9,28,6954,614,30.71114367714458,76.67730324360173,0
Punjab,Mohali,Majri,107,0,105,hab,98,7,102,5,2,28,6953,614,30.846820672947523,76.69081789166596,0
Punjab,Mukatsar,Kot  Bhai At Gidderbaha,43,0,46,osm,41,5,41,2,-3,28,3148,372,30.309945869757126,74.64600831348376,0
Punjab,Mukatsar,Lambi,49,1,48,hab,44,4,46,3,1,28,3370,372,30.035117579875454,74.56079068164904,0
Punjab,Mukatsar,Malout,46,1,50,osm,42,8,41,5,-4,28,3606,372,30.253577294712077,74.42582280630823,0
Punjab,Mukatsar,Muktsar,82,0,87,osm,76,11,78,4,-5,28,3965,372,30.508539031313514,74.51769879025005,0
Punjab,Nawashahar,Aur,78,0,6,hab,6,0,9,69,72,28,310,397,31.076861283218662,75.99887385872002,0
Punjab,Nawashahar,Balachaur,121,0,3,hab,2,1,4,117,118,28,434,397,31.053942646844888,76.36845240621493,0
Punjab,Nawashahar,Banga,99,3,8,hab,8,0,10,89,91,28,502,397,31.206443508457127,75.95053608899863,0
Punjab,Nawashahar,Nawanshahr,99,0,18,hab,16,2,23,76,81,28,4254,397,31.08162944918346,76.14602935912842,0
Punjab,Nawashahar,Saroya,58,0,0,hab,0,0,0,58,58,28,5420,397,31.164813853206695,76.27763490527904,0
Punjab,Pathankot,Bamial,21,0,4,hab,3,1,4,17,17,28,6956,615,32.30804931437842,75.37340598266746,0
Punjab,Pathankot,Dhar Kalan,147,2,5,hab,3,2,11,136,142,28,6957,615,32.39621581139703,75.79497757535219,0
Punjab,Pathankot,Narot Jaimal Singh,76,0,8,hab,4,4,10,66,68,28,6958,615,32.2458482527334,75.4447524326794,0
Punjab,Pathankot,Pathankot,163,4,4,hab,4,0,9,154,159,28,6959,615,32.20237957101849,75.59071551920358,0
Punjab,Pathankot,Sujanpur,62,0,3,hab,2,1,9,53,59,28,6960,615,32.32579193855398,75.61717756184301,0
Punjab,Patiala,Bhunerheri,136,0,91,hab,88,3,93,43,45,28,891,423,30.187272911256418,76.52789431264335,0
Punjab,Patiala,Ghanour,120,0,115,hab,114,1,118,2,5,28,1913,423,30.381663188296578,76.63349268029697,0
Punjab,Patiala,Nabha,164,0,130,hab,126,4,134,30,34,28,4042,423,30.430527937855494,76.17650199725094,0
Punjab,Patiala,Patiala,88,0,90,osm,77,13,79,9,-2,28,4620,423,30.364123974097563,76.35656871028071,0
Punjab,Patiala,Patran,60,0,65,osm,58,7,58,2,-5,28,4628,423,29.932625559294035,76.10542775380506,0
Punjab,Patiala,Rajpura,116,0,151,osm,131,20,116,0,-35,28,5002,423,30.517530058753586,76.62594164041565,0
Punjab,Patiala,Samana,74,0,87,osm,73,14,71,3,-13,28,5315,423,30.13950334289439,76.17220997538394,0
Punjab,Patiala,Sanour,81,0,101,osm,83,18,78,3,-20,28,5379,423,30.234882110754068,76.38443372437311,0
Punjab,Ropar,Anandpur Sahib,115,2,6,hab,5,1,7,108,109,28,174,468,31.276059143177093,76.45885986838763,0
Punjab,Ropar,Chamkaur Sahib,96,0,62,hab,61,1,65,31,34,28,1134,468,30.91412026398596,76.39889877751212,0
Punjab,Ropar,Morinda,63,0,62,hab,61,1,62,1,1,28,3924,468,30.812260505427897,76.49672428101475,0
Punjab,Ropar,Nurpur Bedi,115,0,3,hab,3,0,5,110,112,28,4359,468,31.147352961927037,76.45900969334862,0
Punjab,Ropar,Roopnagar,172,0,147,hab,125,22,122,50,25,28,5197,468,30.977564247333227,76.58034905320721,0
Punjab,Sangrur,Andana,39,1,37,hab,35,2,35,4,2,28,183,482,29.811388205631886,75.97439753002006,0
Punjab,Sangrur,Bhawanigarh,62,0,74,osm,59,15,57,5,-12,28,832,482,30.24848672502152,76.04141297201649,1
Punjab,Sangrur,Dhuri,40,0,35,hab,34,1,36,4,5,28,1622,482,30.359265643248442,75.86671890932656,0
Punjab,Sangrur,Lehragaga,46,0,46,hab,45,1,45,1,0,28,3405,482,29.925886101681044,75.82994381979924,0
Punjab,Sangrur,Malerkotla-I,102,0,57,hab,55,2,57,45,45,28,3588,482,30.494851161518735,75.96464854958599,0
Punjab,Sangrur,Malerkotla-II,72,0,45,hab,39,6,37,35,27,28,3589,482,30.577574773336227,75.79952313823645,0
Punjab,Sangrur,Sangrur,57,0,57,hab,51,6,52,5,0,28,5363,482,30.230978370477825,75.78704503897073,0
Punjab,Sangrur,Sherpur,36,0,39,osm,37,2,36,0,-3,28,5561,482,30.422308086926133,75.72725969614413,0
Punjab,Sangrur,Sunam,77,0,87,osm,68,19,73,4,-10,28,5806,482,30.0810530314491,75.85496454223534,0
Punjab,Tarn Taran,Bhikhiwind,72,0,64,hab,51,13,64,8,8,28,6961,616,31.337982831714353,74.67744419269665,0
Punjab,Tarn Taran,Chohla Sahib,62,0,56,hab,48,8,56,6,6,28,6962,616,31.275037898957873,75.01836297962035,0
Punjab,Tarn Taran,Gandiwind,28,0,41,osm,26,15,26,2,-13,28,6963,616,31.49727583875875,74.71870149982219,0
Punjab,Tarn Taran,Khadoor Sahib,65,0,41,hab,35,6,38,27,24,28,6964,616,31.446500241958116,75.12641309342136,0
Punjab,Tarn Taran,Naushera Pannuan,46,0,46,hab,44,2,46,0,0,28,6965,616,31.368784698349,74.95108741730827,0
Punjab,Tarn Taran,Patti,96,0,86,hab,81,5,87,9,10,28,6966,616,31.230982289754692,74.83414808309632,0
Punjab,Tarn Taran,Tarn Taran,81,0,178,osm,88,90,80,1,-97,28,6967,616,31.391141145011257,74.85878290638158,1
Punjab,Tarn Taran,Valtoha,70,0,60,hab,55,5,61,9,10,28,6968,616,31.192313473355274,74.6170473762191,0
Rajasthan,Ajmer,Arain,125,0,128,osm,119,9,119,6,-3,29,216,6,26.23287403276094,75.05397505540118,0
Rajasthan,Ajmer,Bhinay,134,1,151,osm,125,26,123,11,-17,29,857,6,26.06208190164813,74.83178867106886,0
Rajasthan,Ajmer,Jawaja,222,1,179,hab,157,22,175,47,43,29,2468,6,25.940084409872956,74.17296781644579,0
Rajasthan,Ajmer,Kekri,103,0,127,osm,101,26,95,8,-24,29,2878,6,25.891083294687537,75.19261457991583,0
Rajasthan,Ajmer,Masooda,158,1,173,osm,139,34,138,20,-15,29,3754,6,26.058837591734303,74.51984317744173,0
Rajasthan,Ajmer,Peesangan,140,1,164,osm,122,42,119,21,-24,29,4683,6,26.34712394964929,74.52021030719297,0
Rajasthan,Ajmer,Silora (Kishangarh),116,0,120,osm,94,26,97,19,-4,29,5633,6,26.69425157453404,74.88633712816291,0
Rajasthan,Ajmer,Srinagar,98,1,99,osm,83,16,86,12,-1,29,5763,6,26.429892261593157,74.7674052781919,0
Rajasthan,Alwar,Bansur,147,1,145,hab,132,13,130,17,2,29,541,13,27.682086367684782,76.35736833705698,0
Rajasthan,Alwar,Behror,90,0,77,hab,74,3,82,8,13,29,691,13,27.911098482382197,76.27488020142725,0
Rajasthan,Alwar,Kathumar,176,0,176,hab,167,9,167,9,0,29,2834,13,27.283221834079967,77.00650267266103,0
Rajasthan,Alwar,Kishangarh Bas,137,3,144,osm,127,17,124,13,-7,29,3050,13,27.75883395592997,76.72405550656683,0
Rajasthan,Alwar,Kotkasim,116,3,123,osm,118,5,111,5,-7,29,3175,13,27.987383683864476,76.70128578944515,0
Rajasthan,Alwar,Lachhmangarh,194,3,194,osm,177,17,179,15,0,29,3320,13,27.406160927588566,76.87500072199451,0
Rajasthan,Alwar,Mundawar,146,1,149,osm,137,12,143,3,-3,29,3989,13,27.871787413549463,76.52038513796431,0
Rajasthan,Alwar,Nimrana,86,0,69,hab,66,3,73,13,17,29,4311,13,28.04455279053104,76.3749768256613,0
Rajasthan,Alwar,Rajgarh,139,0,133,hab,109,24,112,27,6,29,4979,13,27.21128464922276,76.4609664793965,0
Rajasthan,Alwar,Ramgarh,187,4,149,hab,138,11,148,39,38,29,5037,13,27.591224541998788,76.8012281793289,0
Rajasthan,Alwar,Reni,110,1,99,hab,95,4,98,12,11,29,5156,13,27.20653034351071,76.72375400335338,0
Rajasthan,Alwar,Thanagazi,163,0,110,hab,96,14,119,44,53,29,5987,13,27.355740883686973,76.28306843685324,0
Rajasthan,Alwar,Tijara,187,2,170,hab,156,14,168,19,17,29,6079,13,28.004189945348497,76.85618956401733,0
Rajasthan,Alwar,Umren,145,1,116,hab,103,13,111,34,29,29,6208,13,27.48480153971751,76.5576213926154,0
Rajasthan,Banswara,Anandpuri,136,0,118,hab,104,14,109,27,18,29,175,49,23.381729644318796,74.10170262894778,0
Rajasthan,Banswara,Bagidora,172,0,115,hab,101,14,122,50,57,29,387,49,23.347277143320724,74.25756831634365,0
Rajasthan,Banswara,Banswara,236,2,87,hab,78,9,112,124,149,29,543,49,23.497977453043305,74.44088320402588,0
Rajasthan,Banswara,Chhoti Sarwan,102,0,4,hab,4,0,6,96,98,29,1268,49,23.562351361235113,74.64454120465888,0
Rajasthan,Banswara,Garhi,206,0,111,hab,105,6,140,66,95,29,1873,49,23.59384998582023,74.17329015777835,0
Rajasthan,Banswara,Ghatol,238,0,35,hab,28,7,40,198,203,29,1934,49,23.76631958041351,74.3998658628144,0
Rajasthan,Banswara,Kushalgarh,289,1,160,hab,138,22,202,87,129,29,3300,49,23.212312066195075,74.51280860313277,0
Rajasthan,Banswara,Sajjangarh,186,0,112,hab,101,11,113,73,74,29,5282,49,23.217954690922305,74.31002846830097,0
Rajasthan,Baran,Anta,152,1,132,hab,129,3,131,21,20,29,208,52,25.222686658832373,76.38541896944318,0
Rajasthan,Baran,Atru,141,0,105,hab,101,4,103,38,36,29,302,52,24.82921757652979,76.58716042495483,0
Rajasthan,Baran,Baran,90,0,84,hab,78,6,83,7,6,29,567,52,25.100071514385988,76.50572504343154,0
Rajasthan,Baran,Chhabra,188,0,125,hab,109,16,128,60,63,29,1249,52,24.645638195779306,76.90548072646953,0
Rajasthan,Baran,Chhipabarod,176,1,120,hab,109,11,118,58,56,29,1264,52,24.566452792186638,76.67458526183886,0
Rajasthan,Baran,Kishanganj,190,0,157,hab,140,17,142,48,33,29,3048,52,25.119053778515454,76.7515786395971,0
Rajasthan,Baran,Shahbad,177,0,116,hab,104,12,121,56,61,29,5505,52,25.208741024191596,77.14254900337525,0
Rajasthan,Barmer,Balotra (Pachpadra),277,0,128,hab,118,10,131,146,149,29,474,55,25.980587481072252,72.3049531058623,0
Rajasthan,Barmer,Barmer,409,5,145,hab,123,22,131,278,264,29,611,55,25.680848252779874,71.12111162019417,0
Rajasthan,Barmer,Baytoo,347,0,51,hab,48,3,55,292,296,29,674,55,26.05590906629913,71.74462368040761,0
Rajasthan,Barmer,Chohtan,249,19,114,hab,100,14,100,149,135,29,1343,55,25.167323943676045,71.02462183501115,0
Rajasthan,Barmer,Dhorimanna (Gudha Malani),375,26,62,hab,48,14,63,312,313,29,1616,55,25.17769291402046,71.5004866216942,0
Rajasthan,Barmer,Sheo,298,3,206,hab,103,103,109,189,92,29,5553,55,26.07541536721575,70.86203399289164,0
Rajasthan,Barmer,Sindhari,370,29,57,hab,54,3,68,302,313,29,5648,55,25.575922136954166,71.78879727873763,0
Rajasthan,Barmer,Siwana,128,0,83,hab,77,6,81,47,45,29,5700,55,25.663659102442416,72.4695099427802,0
Rajasthan,Bharatpur,Bayana,182,2,191,osm,158,33,167,15,-9,29,673,69,26.892237692605278,77.29320531533956,0
Rajasthan,Bharatpur,Deeg,127,1,117,hab,111,6,121,6,10,29,1478,69,27.46229855427083,77.29312213011531,0
Rajasthan,Bharatpur,Kaman,193,9,195,osm,184,11,183,10,-2,29,2674,69,27.69675609857574,77.19317415146462,0
Rajasthan,Bharatpur,Kumher,125,0,125,hab,122,3,119,6,0,29,3250,69,27.309017531410408,77.3804282797224,0
Rajasthan,Bharatpur,Nadbai,124,4,116,hab,112,4,116,8,8,29,4047,69,27.195882846362995,77.21812068522296,0
Rajasthan,Bharatpur,Nagar (Nagar Pahari),216,3,229,osm,214,15,208,8,-13,29,4063,69,27.534011187950078,77.0782059006639,0
Rajasthan,Bharatpur,Rupbas,151,3,181,osm,155,26,140,11,-30,29,5214,69,27.010745750096536,77.501676496095,0
Rajasthan,Bharatpur,Sewar,177,5,169,hab,163,6,160,17,8,29,5498,69,27.203170326059357,77.51067137521487,0
Rajasthan,Bharatpur,Weir,148,1,170,osm,152,18,138,10,-22,29,6436,69,27.048955998014403,77.10753743954658,0
Rajasthan,Bhilwara,Asind,213,2,241,osm,176,65,169,44,-28,29,266,72,25.72973306628778,74.37323472253684,0
Rajasthan,Bhilwara,Banera,89,0,112,osm,89,23,78,11,-23,29,501,72,25.585420392285233,74.68135732034557,0
Rajasthan,Bhilwara,Hurda,82,1,88,osm,62,26,64,18,-6,29,2262,72,25.811165444577338,74.61124411460398,0
Rajasthan,Bhilwara,Jahazpur,237,0,196,hab,178,18,196,41,41,29,2352,72,25.581597501067062,75.25072236402109,0
Rajasthan,Bhilwara,Kotri,180,0,195,osm,164,31,163,17,-15,29,3180,72,25.3787024424517,74.93186654910632,0
Rajasthan,Bhilwara,Mandal,212,6,257,osm,209,48,190,22,-45,29,3635,72,25.50283597305645,74.3276303164068,0
Rajasthan,Bhilwara,Mandalgarh,297,0,273,hab,227,46,236,61,24,29,3636,72,25.216313401775107,75.2024147461265,0
Rajasthan,Bhilwara,Raipur,89,1,107,osm,93,14,83,6,-18,29,4945,72,25.367973716858277,74.1598000664078,0
Rajasthan,Bhilwara,Sahara,103,0,110,osm,96,14,91,12,-7,29,5251,72,25.20455846048261,74.24514659018735,0
Rajasthan,Bhilwara,Shahpura,162,0,158,hab,145,13,143,19,4,29,5520,72,25.68884367801246,74.90523635398102,0
Rajasthan,Bhilwara,Suwana,145,1,143,hab,123,20,114,31,2,29,5833,72,25.294960567845138,74.61289055392824,0
Rajasthan,Bikaner,Bikaner,108,1,84,hab,74,10,73,35,24,29,934,81,28.080190180344065,73.37763323673717,0
Rajasthan,Bikaner,Dungargarh,96,0,74,hab,72,2,89,7,22,29,1708,81,28.068364650072606,74.00818153814505,0
Rajasthan,Bikaner,Khajuwala,139,0,113,hab,73,40,78,61,26,29,2927,81,28.511035823590163,72.74482592709677,0
Rajasthan,Bikaner,Kolayat,210,6,174,hab,134,40,140,70,36,29,3091,81,27.91992924112032,72.54441057988129,0
Rajasthan,Bikaner,Lunkaransar,165,0,138,hab,131,7,136,29,27,29,3450,81,28.66079877617823,73.64790096839162,0
Rajasthan,Bikaner,Nokha,147,0,101,hab,92,9,108,39,46,29,4335,81,27.596927157877232,73.44959300603745,0
Rajasthan,Bundi,Bundi,159,0,141,hab,134,7,141,18,18,29,1067,93,25.36160680123386,75.63506584995676,0
Rajasthan,Bundi,Hindoli,184,1,194,osm,157,37,152,32,-10,29,2218,93,25.545981721509584,75.54283407278608,0
Rajasthan,Bundi,Keshoraipatan,228,0,210,hab,191,19,192,36,18,29,2896,93,25.52191599866781,76.09994128414861,0
Rajasthan,Bundi,Nainwa,190,0,175,hab,158,17,156,34,15,29,4095,93,25.706257760246054,75.93720332476616,0
Rajasthan,Bundi,Talera,106,0,99,hab,84,15,84,22,7,29,5870,93,25.186943123040514,75.66034701644978,0
Rajasthan,Chittaurgarh,Bari Sadri,149,12,56,hab,56,0,67,82,93,29,602,115,24.40303320901722,74.45943963148335,0
Rajasthan,Chittaurgarh,Begun,218,2,184,hab,160,24,181,37,34,29,684,115,25.012905328571573,75.00022873906339,0
Rajasthan,Chittaurgarh,Bhadesar,165,2,113,hab,101,12,111,54,52,29,752,115,24.69865594024383,74.45803932375284,0
Rajasthan,Chittaurgarh,Bhainsrorgarh,164,10,137,hab,121,16,138,26,27,29,779,115,24.841103610560143,75.50840930593849,0
Rajasthan,Chittaurgarh,Bhopalsagar,84,0,93,osm,68,25,66,18,-9,29,882,115,24.820099829489592,74.204440401923,0
Rajasthan,Chittaurgarh,Chittaurgarh,220,3,191,hab,177,14,180,40,29,29,1332,115,24.88488767904063,74.67711904104016,0
Rajasthan,Chittaurgarh,Dungla,103,0,84,hab,80,4,82,21,19,29,1710,115,24.556013209287418,74.32647653690509,0
Rajasthan,Chittaurgarh,Gangrar,131,2,123,hab,112,11,115,16,8,29,1857,115,25.07657404163169,74.63791324024847,0
Rajasthan,Chittaurgarh,Kapasan,107,15,94,osm,86,8,83,24,13,29,2743,115,24.875559742050896,74.36048277923966,0
Rajasthan,Chittaurgarh,Nimbahera,159,3,145,hab,136,9,139,20,14,29,4308,115,24.65333384633239,74.7380922280962,0
Rajasthan,Chittaurgarh,Rashmi,87,0,73,hab,70,3,76,11,14,29,5111,115,25.08160198888634,74.40842882130583,0
Rajasthan,Churu,Churu,109,1,95,hab,91,4,102,7,14,29,1365,118,28.36661974801762,74.92475096169542,0
Rajasthan,Churu,Rajgarh,217,0,209,hab,199,10,208,9,8,29,4981,118,28.64896324821322,75.38589159884152,0
Rajasthan,Churu,Ratangarh,101,0,84,hab,83,1,93,8,17,29,5116,118,28.07497005277369,74.5607961995754,0
Rajasthan,Churu,Sardarshahar,173,0,140,hab,138,2,165,8,33,29,5411,118,28.536309287459794,74.4158989728096,0
Rajasthan,Churu,Sujangarh,164,0,136,hab,132,4,150,14,28,29,5784,118,27.72964284655832,74.29769512925958,0
Rajasthan,Churu,Taranagar,113,0,99,hab,94,5,101,12,14,29,5919,118,28.703541635308014,74.96137736106726,0
Rajasthan,Dausa,Bandikui,229,0,142,hab,128,14,144,85,87,29,497,136,27.05129317039867,76.5947501050736,0
Rajasthan,Dausa,Dausa,248,2,216,hab,206,10,202,46,32,29,1470,136,26.87022804966054,76.3506100632826,0
Rajasthan,Dausa,Lalsot,302,0,266,hab,227,39,221,81,36,29,3367,136,26.5761779186079,76.31208598601533,0
Rajasthan,Dausa,Mahwa,161,0,134,hab,124,10,140,21,27,29,3549,136,27.03297483775562,76.92000955255347,0
Rajasthan,Dausa,Sikrai,139,0,141,osm,133,8,128,11,-2,29,5624,136,26.891147495443427,76.62489361071671,0
Rajasthan,Dholpur,Bari,243,3,197,hab,169,28,204,39,46,29,600,150,26.6196675852252,77.64998083719746,0
Rajasthan,Dholpur,Baseri,285,1,224,hab,178,46,201,84,61,29,639,150,26.587945298897534,77.44729746183894,0
Rajasthan,Dholpur,Dhaulpur,239,7,264,osm,235,29,204,35,-25,29,1604,150,26.780342870300828,77.82581481307743,0
Rajasthan,Dholpur,Rajakhera,243,0,277,osm,222,55,223,20,-34,29,4960,150,26.813354429460475,78.06080878331481,0
Rajasthan,Dungarpur,Aspur,174,4,83,hab,81,2,99,75,91,29,271,162,23.894981919024445,74.1211163632494,0
Rajasthan,Dungarpur,Bichhiwara,192,5,79,hab,63,16,85,107,113,29,903,162,23.784707669982392,73.59023965884495,0
Rajasthan,Dungarpur,Dungarpur,172,10,73,hab,65,8,83,89,99,29,1709,162,23.822514779545173,73.81470368470883,0
Rajasthan,Dungarpur,Sagwara,192,4,83,hab,77,6,93,99,109,29,5247,162,23.69343971677879,73.99909716436422,0
Rajasthan,Dungarpur,Simalwara,247,1,112,hab,98,14,122,125,135,29,5636,162,23.51200540875966,73.83672280004572,0
Rajasthan,Hanumangarh,Bhadra,212,0,94,hab,92,2,103,109,118,29,756,213,29.05918817379335,75.18488655973756,0
Rajasthan,Hanumangarh,Hanumangarh,401,2,81,hab,79,2,136,265,320,29,2131,213,29.550773525311698,74.28831672281014,0
Rajasthan,Hanumangarh,Nohar,213,1,101,hab,101,0,123,90,112,29,4334,213,29.090284565433752,74.72167625222465,0
Rajasthan,Hanumangarh,Pilibanga,338,1,96,hab,93,3,127,211,242,29,4752,213,29.496418412707314,74.06107775932867,0
Rajasthan,Hanumangarh,Rawatsar,335,0,106,hab,105,1,153,182,229,29,5130,213,29.077993507430456,74.31705966692611,0
Rajasthan,Hanumangarh,Sangaria,296,0,39,hab,39,0,83,213,257,29,5350,213,29.82263640577185,74.38983422287224,0
Rajasthan,Hanumangarh,Tibi,250,0,51,hab,51,0,76,174,199,29,6073,213,29.527377562170788,74.52449097404707,0
Rajasthan,Jaipur,Amber,192,0,102,hab,88,14,90,102,90,29,137,237,27.10005251564494,75.77923470009597,0
Rajasthan,Jaipur,Bassi,208,3,125,hab,118,7,148,60,83,29,652,237,26.81741376266985,76.08227538932951,0
Rajasthan,Jaipur,Chaksu,268,1,158,hab,153,5,185,83,110,29,1123,237,26.61652266621681,75.96790893398705,0
Rajasthan,Jaipur,Dudu,235,1,219,hab,190,29,190,45,16,29,1684,237,26.745262757653382,75.23123293967302,0
Rajasthan,Jaipur,Govindgarh,115,1,70,hab,63,7,70,45,45,29,2028,237,27.235132658940067,75.66953528694089,0
Rajasthan,Jaipur,Jamwa Ramgarh,235,1,192,hab,174,18,169,66,43,29,2434,237,27.060950858870058,76.08795288982567,0
Rajasthan,Jaipur,Jhotwara,73,0,27,hab,17,10,21,52,46,29,2504,237,26.928677840571716,75.69911556626703,0
Rajasthan,Jaipur,Kotputli,125,1,121,hab,104,17,100,25,4,29,3178,237,27.68254997528231,76.11104757642543,0
Rajasthan,Jaipur,Phagi,169,0,145,hab,139,6,146,23,24,29,4723,237,26.595875178453497,75.58732330850485,0
Rajasthan,Jaipur,Sambhar,151,0,100,hab,90,10,98,53,51,29,5322,237,27.057555872313674,75.35724764961131,0
Rajasthan,Jaipur,Sanganer,144,1,56,hab,50,6,59,85,88,29,5348,237,26.795111985099897,75.71846175724461,0
Rajasthan,Jaipur,Shahpura,89,1,102,osm,85,17,68,21,-13,29,5519,237,27.33861771435144,75.89393019641889,0
Rajasthan,Jaipur,Viratnagar (Bairath),131,4,94,hab,80,14,82,49,37,29,6376,237,27.44443482129389,76.10434842335273,0
Rajasthan,Jaisalmer,Jaisalmer,226,1,160,hab,101,59,107,119,66,29,2362,238,27.365185260169927,71.35432443037269,0
Rajasthan,Jaisalmer,Sam,307,3,290,hab,194,96,197,110,17,29,5311,238,26.991994905446543,70.42410919251067,0
Rajasthan,Jaisalmer,Sankra (Pokaran),223,0,150,hab,100,50,102,121,73,29,5376,238,26.78934737725238,71.77092097904031,0
Rajasthan,Jalor,Ahore,112,0,97,hab,92,5,95,17,15,29,40,244,25.51097752111556,72.84630015348611,0
Rajasthan,Jalor,Bhinmal,88,0,82,hab,69,13,69,19,6,29,860,244,25.12413429157024,72.09499428560268,0
Rajasthan,Jalor,Chitalwana,152,0,90,hab,76,14,84,68,62,29,1322,244,24.86858834300574,71.55105364567326,0
Rajasthan,Jalor,Jalor,68,0,67,hab,62,5,61,7,1,29,2401,244,25.263604231024484,72.64340934264352,0
Rajasthan,Jalor,Jaswantpura,74,3,68,hab,63,5,64,10,6,29,2457,244,24.988423095385233,72.43972761788665,0
Rajasthan,Jalor,Raniwara,95,1,82,hab,60,22,64,31,13,29,5099,244,24.806384463961294,72.17628857167611,0
Rajasthan,Jalor,Sanchore,124,0,88,hab,80,8,84,40,36,29,5336,244,24.78257501384972,71.82384450392647,0
Rajasthan,Jalor,Sayla,79,0,68,hab,64,4,65,14,11,29,5459,244,25.333068772832974,72.29517979596972,0
Rajasthan,Jhalawar,Bakani,287,2,255,hab,237,18,261,26,32,29,429,255,24.31506601229022,76.3895430473762,0
Rajasthan,Jhalawar,Dug,223,1,234,osm,209,25,204,19,-11,29,1686,255,23.975725293430674,75.74852249194346,0
Rajasthan,Jhalawar,Jhalrapatan,289,4,263,hab,242,21,246,43,26,29,2492,255,24.498266961560358,76.07869354657906,0
Rajasthan,Jhalawar,Khanpur,193,0,178,hab,177,1,181,12,15,29,2958,255,24.67276415829215,76.36374210594256,0
Rajasthan,Jhalawar,Manohar Thana,292,5,224,hab,211,13,232,60,68,29,3696,255,24.31803488494151,76.70583578958785,0
Rajasthan,Jhalawar,Pirawa (Sunel),205,2,177,hab,169,8,179,26,28,29,4772,255,24.252458896515055,76.02633341056895,0
Rajasthan,Jhunjhunun,Alsisar,182,1,129,hab,125,4,154,28,53,29,100,258,28.26434212850922,75.2400582284346,0
Rajasthan,Jhunjhunun,Buhana,139,0,138,hab,125,13,125,14,1,29,1062,258,28.179857013190666,75.87396406603168,0
Rajasthan,Jhunjhunun,Chirawa,90,0,86,hab,83,3,80,10,4,29,1319,258,28.204497024049193,75.55707570386022,0
Rajasthan,Jhunjhunun,Jhunjhunun,145,0,136,hab,126,10,133,12,9,29,2507,258,28.09163396101253,75.34856679169278,0
Rajasthan,Jhunjhunun,Khetri,105,1,125,osm,107,18,95,10,-20,29,3003,258,27.971294307643046,75.79677426663022,0
Rajasthan,Jhunjhunun,Nawalgarh,110,1,85,hab,69,16,73,37,25,29,4251,258,27.864853768581376,75.33844982880902,0
Rajasthan,Jhunjhunun,Surajgarh,124,0,128,osm,107,21,106,18,-4,29,5813,258,28.34446988629464,75.71624902876513,0
Rajasthan,Jhunjhunun,Udaipurwati,94,0,92,hab,75,17,79,15,2,29,6171,258,27.846199089869682,75.55544716117184,0
Rajasthan,Jodhpur,Balesar,271,2,65,hab,59,6,79,192,206,29,449,260,26.535625087585846,72.54048728326546,0
Rajasthan,Jodhpur,Baori,88,1,67,hab,55,12,54,34,21,29,547,260,26.68388525604929,73.1780738723689,0
Rajasthan,Jodhpur,Bap,228,0,100,hab,71,29,86,142,128,29,548,260,27.37049041441975,72.40117148690675,0
Rajasthan,Jodhpur,Bhopalgarh,116,0,107,hab,91,16,93,23,9,29,879,260,26.613008309394086,73.50440920535179,0
Rajasthan,Jodhpur,Bilara,104,0,101,hab,81,20,83,21,3,29,939,260,26.275608490744567,73.61284541055144,0
Rajasthan,Jodhpur,Luni,191,4,106,hab,98,8,102,89,85,29,3449,260,26.087876241314596,72.96124455299851,0
Rajasthan,Jodhpur,Mandor,113,0,88,hab,76,12,80,33,25,29,3652,260,26.343220743439293,73.0485708046171,0
Rajasthan,Jodhpur,Osian,220,6,89,hab,81,8,82,138,131,29,4396,260,26.785482177590275,72.85295207549115,0
Rajasthan,Jodhpur,Phalodi,272,0,89,hab,67,22,87,185,183,29,4725,260,27.061237087778583,72.50863902627904,0
Rajasthan,Jodhpur,Shergarh,236,0,48,hab,41,7,53,183,188,29,5558,260,26.521435497955903,72.24043136336763,0
Rajasthan,Karauli,Hindaun,160,1,165,osm,139,26,131,29,-5,29,2216,276,26.727729137067122,77.05482204141867,0
Rajasthan,Karauli,Karauli,206,0,292,osm,220,72,184,22,-86,29,2768,276,26.547139492066783,77.1002754505606,0
Rajasthan,Karauli,Nadoti,96,1,100,osm,92,8,92,4,-4,29,4052,276,26.709009071699267,76.69143985595322,0
Rajasthan,Karauli,Sapotra,246,1,362,osm,188,174,174,72,-116,29,5393,276,26.288707066791524,76.95453591489571,0
Rajasthan,Karauli,Todabhim,148,0,127,hab,115,12,129,19,21,29,6121,276,26.84551526306803,76.8582299145262,0
Rajasthan,Kota,Itawa,167,1,150,hab,146,4,152,15,17,29,2321,312,25.58169376204172,76.41972610300643,0
Rajasthan,Kota,Kherabad,146,0,132,hab,127,5,133,13,14,29,2997,312,24.70704235163769,75.93792409367364,0
Rajasthan,Kota,Ladpura,117,0,85,hab,67,18,74,43,32,29,3323,312,25.044610579658784,75.87672873660006,0
Rajasthan,Kota,Sangod,211,0,175,hab,171,4,181,30,36,29,5355,312,24.915731164342283,76.20816944701652,0
Rajasthan,Kota,Sultanpur,164,0,139,hab,136,3,137,27,25,29,5799,312,25.288714310985736,76.17414604744044,0
Rajasthan,Nagaur,Degana,156,1,166,osm,149,17,147,9,-10,29,1481,381,26.859498421480822,74.2210399419178,0
Rajasthan,Nagaur,Didwana,190,1,153,hab,145,8,156,34,37,29,1628,381,27.32447038297543,74.58386600359479,0
Rajasthan,Nagaur,Jayal,139,1,125,hab,118,7,119,20,14,29,2471,381,27.247341301552385,74.07586355874834,0
Rajasthan,Nagaur,Kuchaman City,220,0,158,hab,144,14,147,73,62,29,3218,381,27.133363846070015,75.0090302911749,0
Rajasthan,Nagaur,Ladnu,99,0,89,hab,82,7,88,11,10,29,3322,381,27.533210565339683,74.43916063339948,0
Rajasthan,Nagaur,Makrana,134,2,159,osm,126,33,117,17,-25,29,3577,381,27.049938443845075,74.56764014672886,0
Rajasthan,Nagaur,Merta,115,8,86,hab,81,5,88,27,29,29,3845,381,26.660105821665546,73.893553384273,0
Rajasthan,Nagaur,Mundwa,126,3,82,hab,71,11,73,53,44,29,3992,381,26.98518954921659,73.55221859198976,0
Rajasthan,Nagaur,Nagaur,158,6,94,hab,76,18,77,81,64,29,4069,381,27.275245408004523,73.57415768914467,0
Rajasthan,Nagaur,Parbatsar,117,0,139,osm,109,30,106,11,-22,29,4557,381,26.81223630144306,74.6355145697852,0
Rajasthan,Nagaur,Riyan,130,1,104,hab,101,3,110,20,26,29,5174,381,26.56500622691464,74.24669438329845,0
Rajasthan,Pali,Bali,111,0,92,hab,80,12,80,31,19,29,452,413,25.050465557972288,73.23661960310365,0
Rajasthan,Pali,Desuri,78,0,78,hab,72,6,68,10,0,29,1519,413,25.301602534362377,73.53970770302053,0
Rajasthan,Pali,Jaitaran,108,0,105,hab,90,15,91,17,3,29,2366,413,26.292164760691737,74.01925628377758,0
Rajasthan,Pali,Marwar Junction,160,1,122,hab,116,6,124,36,38,29,3747,413,25.67859618195556,73.68905064989013,0
Rajasthan,Pali,Pali,81,0,81,hab,72,9,75,6,0,29,4465,413,25.695295410115275,73.27942462717007,0
Rajasthan,Pali,Raipur,137,0,153,osm,102,51,97,40,-16,29,4946,413,26.082540104157346,74.10018121808938,0
Rajasthan,Pali,Rani,76,0,72,hab,69,3,68,8,4,29,5086,413,25.46184057162983,73.40476557708351,0
Rajasthan,Pali,Rohat,81,0,77,hab,72,5,75,6,4,29,5182,413,25.861755775983518,73.08818489207934,0
Rajasthan,Pali,Sojat,124,0,114,hab,107,7,110,14,10,29,5713,413,25.96417452340781,73.65990018065878,0
Rajasthan,Pali,Sumerpur,66,0,59,hab,57,2,61,5,7,29,5803,413,25.311403044234392,73.10631901802427,0
Rajasthan,Pratapgarh,Arnod,188,5,64,hab,58,6,76,112,124,29,247,435,23.740313778751922,74.83417722503512,0
Rajasthan,Pratapgarh,Chhoti Sadri,147,0,123,hab,107,16,120,27,24,29,1266,435,24.36801491037863,74.66179000458538,0
Rajasthan,Pratapgarh,Dhariawad,167,0,6,hab,4,2,8,159,161,29,1584,435,24.058587612358192,74.40061421139934,0
Rajasthan,Pratapgarh,Peepal Khoont,202,3,3,hab,3,0,3,199,199,29,4682,435,23.815841365478395,74.65104754481325,0
Rajasthan,Pratapgarh,Pratapgarh,272,2,137,hab,129,8,151,121,135,29,4826,435,24.097511003242072,74.72753353410297,0
Rajasthan,Rajsamand,Amet,152,6,135,hab,123,12,129,23,17,29,145,454,25.275674414147048,73.95804645217274,0
Rajasthan,Rajsamand,Bhim,141,5,149,osm,109,40,107,34,-8,29,852,454,25.71726737399552,74.0602921601964,0
Rajasthan,Rajsamand,Deogarh,133,4,137,osm,113,24,108,25,-4,29,1499,454,25.505247852068162,73.96616020319824,0
Rajasthan,Rajsamand,Khamnor,215,1,159,hab,142,17,166,49,56,29,2942,454,24.912881241709123,73.7597558839998,0
Rajasthan,Rajsamand,Kumbhalgarh,167,0,152,hab,140,12,140,27,15,29,3248,454,25.170790901182087,73.6635329304829,0
Rajasthan,Rajsamand,Railmagra,95,1,92,hab,84,8,86,9,3,29,4941,454,25.00704620585436,74.1187608232268,0
Rajasthan,Rajsamand,Rajsamand,140,3,101,hab,89,12,94,46,39,29,5004,454,25.094565211323278,73.88400077575106,0
Rajasthan,Sawaimadhopur,Bamanwas,141,0,134,hab,112,22,117,24,7,29,481,486,26.517748875637118,76.53113047167554,0
Rajasthan,Sawaimadhopur,Bonli,164,0,127,hab,119,8,123,41,37,29,1029,486,26.307148725127924,76.3093181021074,0
Rajasthan,Sawaimadhopur,Gangapur,118,0,119,osm,106,13,105,13,-1,29,1844,486,26.51080346212519,76.76211672837215,0
Rajasthan,Sawaimadhopur,Khandar,284,0,181,hab,161,20,235,49,103,29,2952,486,25.97623166354638,76.55675765594617,0
Rajasthan,Sawaimadhopur,Sawaimadhopur,443,0,188,hab,181,7,401,42,255,29,5456,486,26.092493418469086,76.27763755626377,0
Rajasthan,Sikar,Danta Ramgarh,202,8,110,hab,108,2,117,85,92,29,1434,504,27.326906391804382,75.2191419812597,0
Rajasthan,Sikar,Dhod,122,2,114,hab,102,12,103,19,8,29,1611,504,27.55453009304735,75.01898262011338,0
Rajasthan,Sikar,Fatehpur,151,0,148,hab,138,10,143,8,3,29,1773,504,28.0002316539755,74.95908716592797,0
Rajasthan,Sikar,Khandela,154,4,96,hab,86,10,97,57,58,29,2954,504,27.551506861748216,75.58496871213377,0
Rajasthan,Sikar,Lachhmangarh,146,1,146,osm,130,16,133,13,0,29,3319,504,27.724527282509836,74.92956893132744,0
Rajasthan,Sikar,Neem Ka Thana,193,0,201,osm,158,43,165,28,-8,29,4266,504,27.701916029232894,75.86159755971516,0
Rajasthan,Sikar,Piprali,126,2,82,hab,70,12,79,47,44,29,4769,504,27.615306438529416,75.27260956543718,0
Rajasthan,Sikar,Sri Madhopur,80,1,57,hab,52,5,53,27,23,29,5757,504,27.413502671838657,75.63876932031451,0
Rajasthan,Sirohi,Abu Road,495,3,46,hab,44,2,174,321,449,29,6,510,24.49913702080955,72.80374894372237,0
Rajasthan,Sirohi,Pindwara,127,0,96,hab,85,11,83,44,31,29,4757,510,24.7097264275451,72.97879639496796,0
Rajasthan,Sirohi,Reodar,175,0,129,hab,118,11,143,32,46,29,5159,510,24.626596744273293,72.50593276140108,0
Rajasthan,Sirohi,Sheoganj,91,0,64,hab,59,5,62,29,27,29,5555,510,25.09129337649556,72.90547646270576,0
Rajasthan,Sirohi,Sirohi,103,2,75,hab,69,6,77,26,28,29,5675,510,24.87292424087491,72.70734631548305,0
Rajasthan,Sri Ganganagar,Anupgarh,517,16,160,hab,158,2,248,269,357,29,214,527,29.233079308969327,73.38131492223442,0
Rajasthan,Sri Ganganagar,Ganganagar,306,8,100,hab,79,21,118,188,206,29,1843,527,29.939237699981597,73.81318742741531,0
Rajasthan,Sri Ganganagar,Gharsana,577,2,157,hab,156,1,236,341,420,29,1922,527,28.94284052051169,73.02470240000244,0
Rajasthan,Sri Ganganagar,Karanpur,206,0,133,hab,116,17,142,64,73,29,2766,527,29.86137567322758,73.51272881767979,0
Rajasthan,Sri Ganganagar,Padampur,242,2,165,hab,154,11,185,57,77,29,4411,527,29.664142605641786,73.68190911347641,0
Rajasthan,Sri Ganganagar,Raisinghnagar,379,1,228,hab,225,3,268,111,151,29,4954,527,29.496552154454477,73.43929196678691,0
Rajasthan,Sri Ganganagar,Sadulshahar,235,4,78,hab,68,10,105,130,157,29,5238,527,29.83743913838867,74.06035662726718,0
Rajasthan,Sri Ganganagar,Suratgarh,439,24,132,hab,129,3,170,269,307,29,5817,527,29.212769295793432,73.85437863375165,0
Rajasthan,Tonk,Deoli,179,1,170,hab,152,18,151,28,9,29,1504,556,25.855181281361993,75.54360857979148,0
Rajasthan,Tonk,Malpura,153,1,171,osm,136,35,136,17,-18,29,3608,556,26.348921484248883,75.35221978473747,0
Rajasthan,Tonk,Niwai,204,2,140,hab,129,11,141,63,64,29,4322,556,26.39765267020357,75.96654372143654,0
Rajasthan,Tonk,Todaraisingh,142,1,130,hab,118,12,123,19,12,29,6122,556,26.082201466334503,75.4651707623998,0
Rajasthan,Tonk,Tonk,242,1,244,osm,206,38,218,24,-2,29,6127,556,26.19777494763841,75.76631445344542,0
Rajasthan,Tonk,Uniara,209,2,189,hab,177,12,185,24,20,29,6221,556,25.942448215172792,76.04096288485076,0
Rajasthan,Udaipur,Bargaon,108,3,77,hab,61,16,77,31,31,29,583,560,24.704303862220208,73.65277774867675,0
Rajasthan,Udaipur,Bhindar,300,1,170,hab,160,10,186,114,130,29,859,560,24.54393696247537,74.1018753170099,0
Rajasthan,Udaipur,Girwa,217,6,125,hab,99,26,115,102,92,29,1959,560,24.441597310779276,73.75647173152353,0
Rajasthan,Udaipur,Gogunda,232,4,164,hab,153,11,166,66,68,29,1971,560,24.8154187647096,73.45215819200126,0
Rajasthan,Udaipur,Jhadol,283,0,301,osm,205,96,188,95,-18,29,2485,560,24.31615140321908,73.40441557878927,0
Rajasthan,Udaipur,Kherwara,291,5,139,hab,109,30,157,134,152,29,3001,560,24.035301280459382,73.5536126948981,0
Rajasthan,Udaipur,Kotra,262,2,156,hab,109,47,104,158,106,29,3179,560,24.500208400338117,73.2169078925584,0
Rajasthan,Udaipur,Lasadiya,113,21,16,hab,15,1,23,90,97,29,3383,560,24.277567172206666,74.25802020931114,0
Rajasthan,Udaipur,Mavli,178,1,168,hab,134,34,145,33,10,29,3781,560,24.768690143139967,73.9436141404537,0
Rajasthan,Udaipur,Salumbar,268,2,115,hab,96,19,141,127,153,29,5309,560,24.124065864779244,74.0903734393332,0
Rajasthan,Udaipur,Sarada,219,2,90,hab,75,15,91,128,129,29,5394,560,24.202830492691962,73.83385859536949,0
Sikkim,East,Gangtok,153,0,21,hab,13,8,18,135,132,30,1858,164,27.321527246833366,88.66226176833005,0
Sikkim,East,Pakyong,83,0,17,hab,14,3,27,56,66,30,4441,164,27.2400709371186,88.63591180639818,0
Sikkim,East,Rongli,82,0,1,hab,1,0,7,75,81,30,5194,164,27.21600345845448,88.73493233136193,0
Sikkim,North,Chungthang,33,0,33,hab,10,23,8,25,0,30,1362,403,27.806684407927165,88.53904586405658,0
Sikkim,North,Mangan,127,0,13,hab,12,1,26,101,114,30,3666,403,27.510041354413417,88.48880566973916,0
Sikkim,South,Namchi,175,0,8,hab,7,1,13,162,167,30,4123,522,27.16702461951835,88.40865970149194,0
Sikkim,South,Ravongla,95,0,1,hab,1,0,1,94,94,30,5128,522,27.372995441663033,88.36285532153684,0
Sikkim,West Sikkim,Gyalshing,155,0,12,hab,9,3,30,125,143,30,2093,588,27.405750403624985,88.17206392351538,0
Sikkim,West Sikkim,Soreng,142,0,9,hab,7,2,20,122,133,30,5746,588,27.19290638884952,88.17778744984072,0
Tamilnadu,Ariyalur,Andimadam,103,0,3,hab,3,0,8,95,100,31,187,27,11.320873923197373,79.34146651616759,0
Tamilnadu,Ariyalur,Ariyalur,127,4,20,hab,20,0,31,96,107,31,237,27,11.116752984180774,79.14004177892059,0
Tamilnadu,Ariyalur,Jayamkondam,156,0,16,hab,12,4,28,128,140,31,2472,27,11.212133674906106,79.393290583521,0
Tamilnadu,Ariyalur,Sendurai,97,0,7,hab,7,0,11,86,90,31,5480,27,11.276629762263719,79.20933299183658,0
Tamilnadu,Ariyalur,T Palur,107,0,16,hab,14,2,21,86,91,31,5840,27,11.087404047906606,79.31091998026639,0
Tamilnadu,Ariyalur,Thirumanur,97,0,25,hab,24,1,26,71,72,31,6025,27,10.982440251171344,79.08617101819253,0
Tamilnadu,CHENGALPATTU,Acharapakkam,268,0,4,hab,4,0,14,254,264,31,8003,746,12.444686233495268,79.771447993213,0
Tamilnadu,CHENGALPATTU,Chithamur,192,0,10,hab,8,2,16,176,182,31,8004,746,12.325743926110668,79.9047684664314,0
Tamilnadu,CHENGALPATTU,Kattankolathur,221,0,46,hab,44,2,102,119,175,31,8005,746,12.778549231752542,80.03065407949447,0
Tamilnadu,CHENGALPATTU,Lathur,212,0,1,hab,1,0,2,210,211,31,8006,746,12.429995788401168,80.04785736641412,0
Tamilnadu,CHENGALPATTU,Madurantakam,351,0,14,hab,14,0,41,310,337,31,8007,746,12.50908401661021,79.92278012055958,0
Tamilnadu,CHENGALPATTU,Thirukalukundram,327,0,85,hab,76,9,185,142,242,31,8010,746,12.57697656005817,80.0754360815674,0
Tamilnadu,CHENGALPATTU,Thiruporur,253,0,87,hab,78,9,161,92,166,31,8009,746,12.733777353301678,80.15410265813603,0
Tamilnadu,CHENGALPATTU,Thomas Malai,115,0,12,hab,6,6,27,88,103,31,8008,746,12.930909938996134,80.178060536658,0
Tamilnadu,Coimbatore,Anaimalai,66,0,42,hab,27,15,19,47,24,31,168,119,10.435326377755137,76.94842103207975,0
Tamilnadu,Coimbatore,Annur,157,0,8,hab,7,1,18,139,149,31,206,119,11.230189964335167,77.0850768452421,0
Tamilnadu,Coimbatore,Karamadai,233,0,60,hab,58,2,98,135,173,31,2755,119,11.26807441839704,76.90259898950129,0
Tamilnadu,Coimbatore,Kinathukadavu,85,0,5,hab,4,1,6,79,80,31,3039,119,10.802679645035399,77.05273306177287,0
Tamilnadu,Coimbatore,Madukkarai,38,0,9,hab,2,7,2,36,29,31,3497,119,10.884285842163438,76.9589955875537,0
Tamilnadu,Coimbatore,P.N.Palayam,75,0,10,hab,8,2,15,60,65,31,4404,119,11.118760911838741,76.87995339223569,0
Tamilnadu,Coimbatore,Pollachi(N),100,0,4,hab,3,1,4,96,96,31,4795,119,10.706065448667541,77.00126321839544,0
Tamilnadu,Coimbatore,Pollachi(S),83,0,11,hab,9,2,8,75,72,31,4796,119,10.621975491369852,77.06385562663867,0
Tamilnadu,Coimbatore,S.S.Kulam,54,0,7,hab,4,3,9,45,47,31,5223,119,11.127669154477866,77.01630134583698,0
Tamilnadu,Coimbatore,Sultanpet,180,0,6,hab,6,0,24,156,174,31,5797,119,10.882513445462166,77.17974524709993,0
Tamilnadu,Coimbatore,Sulur,119,1,12,hab,12,0,27,92,107,31,5800,119,11.068279028363525,77.1315272929373,0
Tamilnadu,Coimbatore,Thondamuthur,50,0,11,hab,7,4,7,43,39,31,6050,119,10.964292994538361,76.80174444973257,0
Tamilnadu,Cuddalore,Annagramam,161,0,4,hab,4,0,22,139,157,31,202,121,11.79875863542763,79.58103836840519,0
Tamilnadu,Cuddalore,Cuddalore,259,0,11,hab,6,5,21,238,248,31,1375,121,11.752662172651828,79.71903569166903,0
Tamilnadu,Cuddalore,Kammapuram,146,0,1,hab,1,0,1,145,145,31,2684,121,11.540080442147504,79.42572565026063,0
Tamilnadu,Cuddalore,Kattumannar Koil,131,0,13,hab,12,1,21,110,118,31,2854,121,11.30939720593457,79.49270786626029,0
Tamilnadu,Cuddalore,Keerapalayam,178,0,2,hab,2,0,7,171,176,31,2876,121,11.39170188795758,79.55568868118115,0
Tamilnadu,Cuddalore,Kumaratchi,133,0,6,hab,5,1,11,122,127,31,3242,121,11.32736941751501,79.64071370590469,0
Tamilnadu,Cuddalore,Kurinjipadi,212,0,10,hab,10,0,11,201,202,31,3284,121,11.592141338789549,79.62038644025273,0
Tamilnadu,Cuddalore,Mangalore,116,0,2,hab,2,0,4,112,114,31,3663,121,11.481066209110477,79.03249301674656,0
Tamilnadu,Cuddalore,Melbhuvanagiri,71,0,2,hab,1,1,3,68,69,31,3830,121,11.466853521170695,79.58465656264211,0
Tamilnadu,Cuddalore,Nallur,92,0,4,hab,4,0,8,84,88,31,4118,121,11.502095475437859,79.18684445032622,0
Tamilnadu,Cuddalore,Panruti,127,0,5,hab,5,0,9,118,122,31,4525,121,11.711064646812266,79.52326351169663,0
Tamilnadu,Cuddalore,Parangipettai,117,0,12,hab,8,4,10,107,105,31,4549,121,11.466382718702748,79.73527167812524,0
Tamilnadu,Cuddalore,Vridhachalam,149,1,4,hab,4,0,8,141,145,31,6390,121,11.551840065530863,79.30083692887378,0
Tamilnadu,Dharmapuri,Dharmapuri,252,0,0,hab,0,0,0,252,252,31,1590,148,12.110115721009892,78.19326390388876,0
Tamilnadu,Dharmapuri,Harur,290,2,43,hab,40,3,62,228,247,31,2169,148,12.044693397073068,78.57015507013924,0
Tamilnadu,Dharmapuri,Karimangalam,333,1,8,hab,8,0,21,312,325,31,2778,148,12.325631537857914,78.14970088518878,0
Tamilnadu,Dharmapuri,Morappur,207,0,4,hab,4,0,9,198,203,31,3919,148,12.12001946029959,78.33205725352768,0
Tamilnadu,Dharmapuri,Nallampalli,305,0,4,hab,4,0,11,294,301,31,4117,148,12.037053673721005,78.04836046551722,0
Tamilnadu,Dharmapuri,Palacode,264,5,6,hab,6,0,14,250,258,31,4442,148,12.340219546331266,78.0259478478945,0
Tamilnadu,Dharmapuri,Pappireddipatti,150,0,43,hab,38,5,58,92,107,31,4539,148,11.913666019057326,78.43660631206097,0
Tamilnadu,Dharmapuri,Pennagaram,299,0,4,hab,4,0,4,295,295,31,4694,148,12.095349068830844,77.87871788713521,0
Tamilnadu,Dindigul,Athoor,115,0,13,hab,9,4,22,93,102,31,288,158,10.27451082281157,77.84341938054071,0
Tamilnadu,Dindigul,Batlagundu,100,0,33,hab,32,1,37,63,67,31,667,158,10.132650405651065,77.75929989053488,0
Tamilnadu,Dindigul,Dindigul,199,0,14,hab,8,6,24,175,185,31,1639,158,10.325043941191215,77.98148012448576,0
Tamilnadu,Dindigul,Guziliamparai,280,1,247,hab,215,32,220,60,33,31,2091,158,10.691736120412195,78.08088587755384,0
Tamilnadu,Dindigul,Kodaikanal,145,0,46,hab,34,12,52,93,99,31,3060,158,10.271510245353292,77.50379463898797,0
Tamilnadu,Dindigul,Natham,237,0,128,hab,117,11,147,90,109,31,4220,158,10.26277379930346,78.23794767390541,0
Tamilnadu,Dindigul,Nilakottai,184,0,72,hab,72,0,103,81,112,31,4301,158,10.161095817268494,77.87624823622862,0
Tamilnadu,Dindigul,Oddanchatram,204,0,33,hab,33,0,46,158,171,31,4375,158,10.532803264297534,77.7611779678229,0
Tamilnadu,Dindigul,Palani,113,1,20,hab,17,3,24,89,93,31,4451,158,10.435754458368057,77.47075113047228,0
Tamilnadu,Dindigul,Reddiarchatram,238,0,2,hab,1,1,4,234,236,31,5143,158,10.39587065864901,77.82482420379762,0
Tamilnadu,Dindigul,Shanarpatti,192,0,9,hab,9,0,20,172,183,31,5536,158,10.293656836743391,78.10146438103607,0
Tamilnadu,Dindigul,Thoppampatti,173,0,11,hab,11,0,20,153,162,31,6055,158,10.583908932712694,77.56226853246187,0
Tamilnadu,Dindigul,Vadamadurai,209,0,87,hab,59,28,50,159,122,31,6252,158,10.4615298667184,78.12077454687525,0
Tamilnadu,Dindigul,Vedasandur,233,0,53,hab,52,1,56,177,180,31,6301,158,10.561461951835684,77.9864743276372,0
Tamilnadu,Erode,Ammapet,198,0,9,hab,8,1,33,165,189,31,154,173,11.620742724024405,77.67834071643091,0
Tamilnadu,Erode,Anthiyur,197,0,5,hab,5,0,8,189,192,31,211,173,11.74072571844709,77.55627417038897,0
Tamilnadu,Erode,Bhavani,210,0,2,hab,1,1,5,205,208,31,827,173,11.465507547248864,77.61436016462899,0
Tamilnadu,Erode,Bhavanisagar,146,1,3,hab,3,0,8,138,143,31,828,173,11.414396383557161,77.16999590563532,0
Tamilnadu,Erode,Chennimalai,244,1,24,hab,24,0,62,182,220,31,1235,173,11.193847451063165,77.58881361041222,0
Tamilnadu,Erode,Erode,79,6,5,hab,2,3,5,74,74,31,1747,173,11.357122978517104,77.67883849786966,0
Tamilnadu,Erode,Gobi,231,0,7,hab,7,0,22,209,224,31,1963,173,11.436007427096529,77.45285115515591,0
Tamilnadu,Erode,Kodumudi,107,0,128,osm,93,35,67,40,-21,31,3070,173,11.109122695716751,77.8238928990368,0
Tamilnadu,Erode,Modakkuruchi,288,0,43,hab,33,10,101,187,245,31,3873,173,11.206898192252037,77.74459024170191,0
Tamilnadu,Erode,Nambiyur,191,0,1,hab,1,0,3,188,190,31,4121,173,11.362607191543518,77.32370286245472,0
Tamilnadu,Erode,Perundurai,240,0,15,hab,13,2,41,199,225,31,4717,173,11.315008911955124,77.5397990742314,0
Tamilnadu,Erode,Sathy,183,0,3,hab,0,3,0,183,180,31,5440,173,11.613614224442909,77.17449973032801,0
Tamilnadu,Erode,T.N. Palayam,92,0,5,hab,5,0,17,75,87,31,5843,173,11.505764943385216,77.3792213842576,0
Tamilnadu,Erode,Talavadi,98,0,8,hab,8,0,12,86,90,31,5866,173,11.725082549424382,76.99828630721413,0
Tamilnadu,KALLAKURICHI,Chinnasalem,66,0,3,hab,1,2,1,65,63,31,8024,745,11.64660848349987,78.87687674244803,0
Tamilnadu,KALLAKURICHI,Kallakurichi,86,0,1,hab,0,1,0,86,85,31,8025,745,11.747322156361378,78.94099490779236,0
Tamilnadu,KALLAKURICHI,Kalrayanhills,158,1,109,hab,104,5,115,43,49,31,8026,745,11.841868032929494,78.7473130253173,0
Tamilnadu,KALLAKURICHI,Sankarapuram,77,0,2,hab,2,0,3,74,75,31,8027,745,11.925232129806233,78.91525647512749,0
Tamilnadu,KALLAKURICHI,Thirunavalur,168,0,8,hab,8,0,18,150,160,31,8029,745,11.742615428358205,79.3518736022405,0
Tamilnadu,KALLAKURICHI,Thiyagadurgam,130,0,5,hab,4,1,7,123,125,31,8028,745,11.680498546729313,79.09042762312495,0
Tamilnadu,KALLAKURICHI,Ulundurpet,125,1,5,hab,5,0,9,116,120,31,8030,745,11.746611246405987,79.20837351104633,0
Tamilnadu,Kanchipuram,Kancheepuram,235,1,1,hab,1,0,3,232,234,31,2695,267,12.81937486687554,79.69308159749876,0
Tamilnadu,Kanchipuram,Kundrathur,275,0,48,hab,47,1,165,110,227,31,3262,267,12.914621151638501,80.03353804222837,0
Tamilnadu,Kanchipuram,Sriperumbudur,244,1,25,hab,23,2,61,183,219,31,5767,267,12.95139134863343,79.91524432699875,0
Tamilnadu,Kanchipuram,Uthiramerur,347,0,73,hab,71,2,171,176,274,31,6241,267,12.658436887625593,79.79644724003984,0
Tamilnadu,Kanchipuram,Walajabad,243,1,4,hab,4,0,14,229,239,31,6410,267,12.871231504590842,79.78425504573535,0
Tamilnadu,Kanniyakumari,Agastheeswaram,66,0,25,hab,16,9,33,33,41,31,30,271,8.151041687845556,77.49870916444685,0
Tamilnadu,Kanniyakumari,Killiyoor,90,0,7,hab,4,3,28,62,83,31,3035,271,8.253283423468929,77.22320535443194,0
Tamilnadu,Kanniyakumari,Kurunthancode,82,0,9,hab,5,4,14,68,73,31,3295,271,8.191342211326273,77.32289838721124,0
Tamilnadu,Kanniyakumari,Melpuram,100,0,7,hab,2,5,6,94,93,31,3833,271,8.429823350427407,77.24331262961509,0
Tamilnadu,Kanniyakumari,Munchirai,96,0,9,hab,6,3,14,82,87,31,3985,271,8.288415549159566,77.15607295441097,0
Tamilnadu,Kanniyakumari,Rajakkamangalam,161,0,5,hab,4,1,24,137,156,31,4961,271,8.14550024382132,77.40917657867895,0
Tamilnadu,Kanniyakumari,Thiruvattar,131,0,13,hab,10,3,36,95,118,31,6040,271,8.413614305776182,77.34520943797504,0
Tamilnadu,Kanniyakumari,Thovalai,121,1,12,hab,7,5,27,94,109,31,6062,271,8.309803841319978,77.46806247548052,0
Tamilnadu,Kanniyakumari,Thuckalay,89,6,14,hab,5,9,22,67,75,31,6066,271,8.263711192418999,77.3193374043461,0
Tamilnadu,Karur,Aravakurichi,303,0,235,hab,219,16,283,20,68,31,227,282,10.746164931629695,77.92075157485208,0
Tamilnadu,Karur,K  Paramathi,455,0,390,hab,383,7,440,15,65,31,2548,282,10.941955581263485,77.88361640224257,0
Tamilnadu,Karur,Kadavur,285,0,316,osm,310,6,279,6,-31,31,2563,282,10.702068860514403,78.21996962949014,0
Tamilnadu,Karur,Karur,217,0,177,hab,147,30,205,12,40,31,2800,282,11.0258293742813,78.06069475127703,0
Tamilnadu,Karur,Krishnarayapuram,250,0,300,osm,266,34,243,7,-50,31,3207,282,10.86593902353982,78.30135995588745,0
Tamilnadu,Karur,Kulithalai,99,0,135,osm,101,34,97,2,-36,31,3237,282,10.880089662137996,78.45132475444635,0
Tamilnadu,Karur,Thanthoni,255,0,226,hab,186,40,217,38,29,31,5994,282,10.884067091785036,78.09604235728145,0
Tamilnadu,Karur,Thogamalai,219,0,265,osm,256,9,218,1,-46,31,6048,282,10.762298690317866,78.46335778084241,0
Tamilnadu,Krishnagiri,Bargur,321,0,11,hab,10,1,27,294,310,31,588,316,12.483778785506699,78.3470139574226,0
Tamilnadu,Krishnagiri,Hosur,152,0,17,hab,14,3,25,127,135,31,2248,316,12.750206297029072,77.84698522340186,0
Tamilnadu,Krishnagiri,Kaveripattinam,366,0,2,hab,2,0,24,342,364,31,2866,316,12.367735066004489,78.24798009295924,0
Tamilnadu,Krishnagiri,Kelamangalam,265,0,24,hab,21,3,44,221,241,31,2879,316,12.489637157859354,77.89270164645512,0
Tamilnadu,Krishnagiri,Krishnagiri,336,0,6,hab,6,0,19,317,330,31,3202,316,12.543159012937922,78.18814685171077,0
Tamilnadu,Krishnagiri,Mathur,244,0,4,hab,4,0,22,222,240,31,3763,316,12.341417636566293,78.44495068341779,0
Tamilnadu,Krishnagiri,Shoolagiri,325,3,8,hab,8,0,17,308,317,31,5589,316,12.695355192527037,78.00215420220424,0
Tamilnadu,Krishnagiri,Thally,478,0,33,hab,29,4,60,418,445,31,5984,316,12.397002508706064,77.69254986079271,0
Tamilnadu,Krishnagiri,Uthangarai,245,0,3,hab,3,0,15,230,242,31,6239,316,12.248953850005508,78.53571307959126,0
Tamilnadu,Krishnagiri,Veppanapalli,152,0,2,hab,1,1,3,149,150,31,6343,316,12.691061866009687,78.15575625253176,0
Tamilnadu,Madurai,Alanganallur,103,0,97,hab,86,11,99,4,6,31,75,343,10.103980314038354,78.08238951172332,0
Tamilnadu,Madurai,Chellampatti,220,0,148,hab,147,1,215,5,72,31,1224,343,9.958723868547153,77.88434717927979,0
Tamilnadu,Madurai,Kallikudi,79,0,81,osm,79,2,77,2,-2,31,2645,343,9.70605467798042,77.98704142461429,0
Tamilnadu,Madurai,Kottampatti,206,0,217,osm,214,3,205,1,-11,31,3181,343,10.167151352516234,78.35033515925858,0
Tamilnadu,Madurai,Madurai East,245,0,129,hab,123,6,235,10,116,31,3499,343,9.95105263803224,78.2185847666198,0
Tamilnadu,Madurai,Madurai West,93,0,52,hab,52,0,64,29,41,31,3500,343,10.001204340386392,78.11161484569386,0
Tamilnadu,Madurai,Melur,233,0,192,hab,184,8,224,9,41,31,3834,343,10.00995190877831,78.34407450861684,0
Tamilnadu,Madurai,Sedapatti,118,0,125,osm,111,14,114,4,-7,31,5463,343,9.788346191554599,77.6836018915736,0
Tamilnadu,Madurai,T.Kallupatty,115,1,102,hab,95,7,108,7,13,31,5842,343,9.71469126075752,77.82759395398142,0
Tamilnadu,Madurai,Thirumangalam,151,1,112,hab,108,4,137,14,39,31,6023,343,9.83984103600275,77.94492023840581,0
Tamilnadu,Madurai,Thirupparankundram,139,0,68,hab,65,3,94,45,71,31,6031,343,9.866704506957664,78.08130987432976,0
Tamilnadu,Madurai,Usilampatti,136,0,116,hab,115,1,132,4,20,31,6234,343,9.973990665274219,77.7735839687854,0
Tamilnadu,Madurai,Vadipatti,68,2,70,osm,55,15,64,4,-2,31,6256,343,10.059098077570145,77.96285306961764,0
Tamilnadu,Nagapattinam,Keelaiyur,136,0,5,hab,4,1,15,121,131,31,2874,380,10.624062205361975,79.79603603819167,0
Tamilnadu,Nagapattinam,Kilvelur,196,0,1,hab,1,0,5,191,195,31,3037,380,10.730094819831464,79.72707954170659,0
Tamilnadu,Nagapattinam,Kollidam,209,0,116,hab,112,4,197,12,93,31,3098,380,11.303297241903566,79.76261096000201,0
Tamilnadu,Nagapattinam,Kuthalam,190,0,142,hab,129,13,188,2,48,31,3309,380,11.033392974424492,79.59929008058803,0
Tamilnadu,Nagapattinam,Mayiladuthurai,210,0,153,hab,149,4,201,9,57,31,3794,380,11.148342641656635,79.62782347689172,0
Tamilnadu,Nagapattinam,Nagapattinam,121,0,2,hab,2,0,5,116,119,31,4059,380,10.749548258966195,79.80980960191104,0
Tamilnadu,Nagapattinam,Sembanarkoil,275,0,193,hab,186,7,262,13,82,31,5475,380,11.077605494726221,79.77543961463343,0
Tamilnadu,Nagapattinam,Sirkali,168,0,167,hab,162,5,164,4,1,31,5671,380,11.200955274677296,79.76445036662224,0
Tamilnadu,Nagapattinam,Thalainayar,57,0,6,hab,2,4,3,54,51,31,5975,380,10.54501109404135,79.7576285473271,0
Tamilnadu,Nagapattinam,Thirumarugal,209,0,4,hab,4,0,7,202,205,31,6026,380,10.864567722367005,79.73182607562475,0
Tamilnadu,Nagapattinam,Vedaranyam,232,0,9,hab,8,1,11,221,223,31,6300,380,10.381411592067595,79.76218590172178,0
Tamilnadu,Namakkal,Elacipalayam,211,0,8,hab,7,1,18,193,203,31,1733,387,11.345162166775735,78.01507125008841,0
Tamilnadu,Namakkal,Erumapatty,85,0,15,hab,12,3,31,54,70,31,1748,387,11.152752804088756,78.28592861768439,0
Tamilnadu,Namakkal,Kabilarmalai,127,0,34,hab,29,5,48,79,93,31,2554,387,11.169341432686887,77.9222399940206,0
Tamilnadu,Namakkal,Kollihills,305,0,5,hab,5,0,17,288,300,31,3099,387,11.321113952257965,78.36839406520286,0
Tamilnadu,Namakkal,Mallasamudram,167,0,1,hab,1,0,2,165,166,31,3603,387,11.460198054132258,78.03217561263716,0
Tamilnadu,Namakkal,Mohanur,161,0,97,hab,94,3,128,33,64,31,3893,387,11.112004341612701,78.1442569330073,0
Tamilnadu,Namakkal,Namagiripet,115,0,5,hab,1,4,2,113,110,31,4119,387,11.497015208864156,78.36004586814714,0
Tamilnadu,Namakkal,Namakkal,138,0,36,hab,28,8,57,81,102,31,4120,387,11.22539979299055,78.12271707352629,0
Tamilnadu,Namakkal,Pallipalayam,191,0,6,hab,5,1,19,172,185,31,4476,387,11.400799280727002,77.76273579814405,0
Tamilnadu,Namakkal,Paramathy,142,0,15,hab,12,3,34,108,127,31,4547,387,11.214021256735656,77.99062357824336,0
Tamilnadu,Namakkal,Puduchatram,150,0,7,hab,7,0,23,127,143,31,4839,387,11.3556222347554,78.159476691512,0
Tamilnadu,Namakkal,Rasipuram,91,0,4,hab,4,0,7,84,87,31,5112,387,11.45482193274113,78.18558453410529,0
Tamilnadu,Namakkal,Sendamangalam,70,0,5,hab,4,1,12,58,65,31,5477,387,11.322581912382562,78.27094052745854,0
Tamilnadu,Namakkal,Tiruchengode,190,0,18,hab,18,0,47,143,172,31,6099,387,11.361539592670882,77.87518431011509,0
Tamilnadu,Namakkal,Vennandur,88,0,1,hab,1,0,1,87,87,31,6340,387,11.519246726917876,78.17192380067917,0
Tamilnadu,Perambalur,Alathur,77,0,21,hab,21,0,25,52,56,31,78,426,11.136634532537915,78.88418198755707,0
Tamilnadu,Perambalur,Perambalur,50,0,11,hab,10,1,10,40,39,31,4703,426,11.23373361687837,78.82784818392167,0
Tamilnadu,Perambalur,Veppanthattai,91,0,8,hab,5,3,8,83,83,31,6344,426,11.388023645643703,78.82526914780088,0
Tamilnadu,Perambalur,Veppur,86,0,7,hab,6,1,7,79,79,31,6345,426,11.297468265572872,79.03772216053537,0
Tamilnadu,Pudukkottai,Annavasal,394,4,253,hab,248,5,354,40,141,31,203,437,10.470340723628434,78.69414927694231,0
Tamilnadu,Pudukkottai,Arantangi,415,2,114,hab,109,5,264,151,301,31,223,437,10.198592742641662,79.04803762218411,0
Tamilnadu,Pudukkottai,Arimalam,226,0,176,hab,163,13,220,6,50,31,236,437,10.195102751536957,78.8773216818253,0
Tamilnadu,Pudukkottai,Avudayarkoil,324,1,261,hab,241,20,291,33,63,31,324,437,9.99942058302902,79.06379080938714,0
Tamilnadu,Pudukkottai,Gandarvakottai,131,1,100,hab,79,21,121,10,31,31,1827,437,10.588613175937013,79.0440043953743,0
Tamilnadu,Pudukkottai,Karambakkudi,238,8,137,hab,125,12,212,26,101,31,2756,437,10.457817929077802,79.08998392765236,0
Tamilnadu,Pudukkottai,Kunnandarkoil,243,1,143,hab,136,7,209,34,100,31,3269,437,10.581158557068544,78.85563638176517,0
Tamilnadu,Pudukkottai,Manamelkudi,187,2,150,hab,146,4,174,13,37,31,3621,437,10.04174948147293,79.17239761396021,0
Tamilnadu,Pudukkottai,Ponnamaravathi,290,1,152,hab,151,1,255,35,138,31,4805,437,10.33115479868995,78.56961296017877,0
Tamilnadu,Pudukkottai,Pudukkottai,241,1,139,hab,131,8,212,29,102,31,4840,437,10.455102710482231,78.90848248943156,0
Tamilnadu,Pudukkottai,Thirumayam,252,1,168,hab,164,4,244,8,84,31,6027,437,10.25879924271593,78.7166630452807,0
Tamilnadu,Pudukkottai,Thiruvarankulam,319,2,118,hab,113,5,217,102,201,31,6038,437,10.330783350024914,78.9880731628263,0
Tamilnadu,Pudukkottai,Viralimalai,460,11,299,hab,293,6,422,38,161,31,6374,437,10.611329286315994,78.62484269605926,0
Tamilnadu,Ramanathapuram,Bogalur,87,3,85,osm,76,9,80,7,2,31,1005,455,9.421685566658827,78.70142106419337,0
Tamilnadu,Ramanathapuram,Kadaladi,259,0,243,hab,229,14,249,10,16,31,2558,455,9.212262305764215,78.50493394059725,0
Tamilnadu,Ramanathapuram,Kamuthi,219,8,206,hab,189,17,204,15,13,31,2688,455,9.36906887307778,78.36687646711337,0
Tamilnadu,Ramanathapuram,Mandapam,232,0,144,hab,118,26,206,26,88,31,3640,455,9.300363546015985,79.07982068167598,0
Tamilnadu,Ramanathapuram,Mudukulathur,195,0,210,osm,196,14,190,5,-15,31,3955,455,9.393128274644788,78.55826689707717,0
Tamilnadu,Ramanathapuram,Nainarkoil,98,0,128,osm,121,7,97,1,-30,31,4092,455,9.520399505674645,78.75759829613858,0
Tamilnadu,Ramanathapuram,Paramakudi,151,3,156,osm,145,11,144,7,-5,31,4546,455,9.536072176438877,78.51823341325711,0
Tamilnadu,Ramanathapuram,R.S. Mangalam,242,0,333,osm,290,43,241,1,-91,31,4904,455,9.671497671083385,78.86098219272155,0
Tamilnadu,Ramanathapuram,Ramanathapuram,117,14,110,osm,103,7,85,32,7,31,5026,455,9.419623495971502,78.85542017010843,0
Tamilnadu,Ramanathapuram,Thiruppullani,181,0,185,osm,181,4,176,5,-4,31,6033,455,9.289731121019846,78.78138686580247,0
Tamilnadu,Ramanathapuram,Thiruvadanai,217,4,408,osm,366,42,209,8,-191,31,6036,455,9.820488968681847,78.97098266173344,0
Tamilnadu,Ranipet,Arcot,145,3,15,hab,14,1,22,123,130,31,8011,747,12.870291957986105,79.34229170453303,0
Tamilnadu,Ranipet,Thimiri,164,0,73,hab,66,7,96,68,91,31,8012,747,12.781227848002853,79.33566985655128,0
Tamilnadu,Ranipet,Walajah,184,0,1,hab,0,1,0,184,183,31,8013,747,12.961075500710042,79.35082634998058,0
Tamilnadu,Ranipet,unknown,132,0,4,hab,4,0,15,117,128,31,8105,747,13.09570615219923,79.69629607299544,0
Tamilnadu,Ranipet,unknown,281,0,11,hab,10,1,24,257,270,31,8106,747,13.026359211710513,79.51889698872948,0
Tamilnadu,Salem,Attur,112,0,2,hab,2,0,5,107,110,31,306,478,11.568586642906578,78.56033306658423,0
Tamilnadu,Salem,Ayothiyapattinam,190,0,3,hab,3,0,4,186,187,31,326,478,11.719993893517533,78.31239566999265,0
Tamilnadu,Salem,Gangavalli,96,0,8,hab,4,4,7,89,88,31,1848,478,11.439349261454348,78.58376112303462,0
Tamilnadu,Salem,Idappady,148,0,1,hab,0,1,0,148,147,31,2278,478,11.642057713286917,77.8170302644462,0
Tamilnadu,Salem,Kadayampatti,182,0,3,hab,3,0,8,174,179,31,2565,478,11.889162896368685,78.10168597373742,0
Tamilnadu,Salem,Kolathur,168,0,2,hab,2,0,4,164,166,31,3090,478,11.812746914368772,77.75063719765015,0
Tamilnadu,Salem,Konganapuram,101,1,1,hab,0,1,0,101,100,31,3120,478,11.595337517774224,77.9027267671238,0
Tamilnadu,Salem,Mac. Choultry,167,0,2,hab,2,0,12,155,165,31,3453,478,11.567797496322125,77.974072722075,0
Tamilnadu,Salem,Mecheri,219,16,2,hab,0,2,0,219,217,31,3802,478,11.829028537374048,77.93730894133454,0
Tamilnadu,Salem,Nangavalli,166,0,3,hab,3,0,4,162,163,31,4154,478,11.767249496080321,77.86437004642315,0
Tamilnadu,Salem,Omalur,244,0,4,hab,3,1,12,232,240,31,4385,478,11.747835625715554,78.06690698800267,0
Tamilnadu,Salem,P.N.Palayam,217,0,50,hab,47,3,58,159,167,31,4403,478,11.726832067867166,78.54401329723815,0
Tamilnadu,Salem,Panamarathupatti,115,10,2,hab,1,1,2,113,113,31,4495,478,11.592810326668387,78.20203989608028,0
Tamilnadu,Salem,Salem,94,1,1,hab,0,1,0,94,93,31,5300,478,11.674318113111507,78.1448991773535,0
Tamilnadu,Salem,Sankari,292,0,12,hab,9,3,30,262,280,31,5372,478,11.499320569456067,77.82717748460121,0
Tamilnadu,Salem,Thalaivasal,114,0,5,hab,3,2,7,107,109,31,5976,478,11.564383871373607,78.74618192567239,0
Tamilnadu,Salem,Tharamangalam,186,0,4,hab,4,0,11,175,182,31,5997,478,11.693431098597005,77.96017757111585,0
Tamilnadu,Salem,Valapady,106,0,6,hab,6,0,9,97,100,31,6268,478,11.683897242942322,78.38617766124985,0
Tamilnadu,Salem,Veerapandy,128,0,4,hab,4,0,9,119,124,31,6306,478,11.600757855237203,78.05673009194737,0
Tamilnadu,Salem,Yercaud,71,0,1,hab,1,0,1,70,70,31,6467,478,11.828379047581032,78.24447192370816,0
Tamilnadu,Sivagangai,Devakottai,212,1,267,osm,220,47,161,51,-55,31,1522,514,9.876277763611593,78.79325195493044,0
Tamilnadu,Sivagangai,Ilayangudi,232,0,177,hab,168,9,172,60,55,31,2284,514,9.63382672015349,78.6614965430827,0
Tamilnadu,Sivagangai,Kalaiyarkoil,268,0,158,hab,144,14,124,144,110,31,2604,514,9.827817221630308,78.61046429536424,0
Tamilnadu,Sivagangai,Kallal,180,8,10,hab,10,0,26,154,170,31,2643,514,10.014403676699065,78.67722981679395,0
Tamilnadu,Sivagangai,Kannangudi,151,0,98,hab,84,14,75,76,53,31,2731,514,9.968908345408565,78.89887972940912,0
Tamilnadu,Sivagangai,Manamadurai,155,0,73,hab,69,4,88,67,82,31,3620,514,9.695654589262663,78.43911249447136,0
Tamilnadu,Sivagangai,S.Pudur,97,0,44,hab,43,1,49,48,53,31,5222,514,10.324767807431442,78.45722849203922,0
Tamilnadu,Sivagangai,Sakkottai,141,1,46,hab,41,5,46,95,95,31,5287,514,10.098290799630135,78.830951354378,0
Tamilnadu,Sivagangai,Singampunari,112,0,86,hab,82,4,84,28,26,31,5651,514,10.138340720451211,78.46671444187746,0
Tamilnadu,Sivagangai,Sivagangai,215,1,87,hab,86,1,128,87,128,31,5696,514,9.893124415775816,78.44956269762991,0
Tamilnadu,Sivagangai,Thiruppathur,134,1,14,hab,13,1,21,113,120,31,6032,514,10.161587059092877,78.58414095011156,0
Tamilnadu,Sivagangai,Thiruppuvanam,113,0,99,hab,88,11,90,23,14,31,6034,514,9.806802619748236,78.26179638498915,0
Tamilnadu,TENKASI,Kadayam,139,0,41,hab,40,1,94,45,98,31,8017,749,8.807800122992852,77.38632539016112,0
Tamilnadu,TENKASI,Kadayanallur,54,0,13,hab,13,0,20,34,41,31,8018,749,9.092535051263201,77.3410142863725,0
Tamilnadu,TENKASI,Keelapavoor,169,0,56,hab,48,8,122,47,113,31,8019,749,8.916953987418193,77.41098615663817,0
Tamilnadu,TENKASI,Sankarankoil,122,0,12,hab,11,1,24,98,110,31,8020,749,9.209498396683378,77.51432534281813,0
Tamilnadu,TENKASI,Shencottai,20,0,6,hab,3,3,10,10,14,31,8021,749,9.005894884892879,77.25086930692888,0
Tamilnadu,TENKASI,Tenkasi,44,0,16,hab,11,5,24,20,28,31,8022,749,8.970465747702262,77.28402088681828,0
Tamilnadu,TENKASI,Vasudevanallur,58,0,17,hab,13,4,22,36,41,31,8023,749,9.272542508289295,77.39509676919864,0
Tamilnadu,Thanjavur,Ammapet,147,0,12,hab,10,2,27,120,135,31,153,541,10.806034233607663,79.26213380054097,0
Tamilnadu,Thanjavur,Budalur,162,0,29,hab,26,3,60,102,133,31,1053,541,10.772448815387136,78.92752560888869,0
Tamilnadu,Thanjavur,Kumbakonam,179,0,6,hab,5,1,13,166,173,31,3247,541,10.983216064582903,79.37780764650272,0
Tamilnadu,Thanjavur,Madukkur,61,0,1,hab,0,1,0,61,60,31,3498,541,10.47629583302622,79.41180040911934,0
Tamilnadu,Thanjavur,Orathanadu,169,0,14,hab,9,5,6,163,155,31,4391,541,10.622177655589365,79.2660718406023,0
Tamilnadu,Thanjavur,Papanasam,112,0,14,hab,13,1,34,78,98,31,4536,541,10.93865765606727,79.24120380997796,0
Tamilnadu,Thanjavur,Pattukkottai,104,3,21,hab,21,0,20,84,83,31,4639,541,10.39391202629786,79.36013475753849,0
Tamilnadu,Thanjavur,Peravurani,118,1,7,hab,5,2,16,102,111,31,4708,541,10.335241821406736,79.19223496011861,0
Tamilnadu,Thanjavur,Sethubavachatram,121,0,33,hab,28,5,24,97,88,31,5495,541,10.255048383424842,79.24668901521763,0
Tamilnadu,Thanjavur,Thanjavur,154,1,21,hab,18,3,28,126,133,31,5992,541,10.753677293843904,79.10787372620557,0
Tamilnadu,Thanjavur,Thiruvaiyaru,81,0,4,hab,4,0,6,75,77,31,6037,541,10.867373952005266,79.05885967369525,0
Tamilnadu,Thanjavur,Thiruvidaimarudur,130,0,7,hab,4,3,12,118,123,31,6043,541,10.959792984074483,79.46411878030848,0
Tamilnadu,Thanjavur,Thiruvonam,109,1,11,hab,8,3,8,101,98,31,6044,541,10.494520712339913,79.21067407396691,0
Tamilnadu,Thanjavur,Tiruppanandal,144,0,8,hab,8,0,24,120,136,31,6102,541,11.106337015102351,79.49500742303961,0
Tamilnadu,The Nilgiris,Coonoor,114,0,60,hab,20,40,47,67,54,31,1373,542,11.323988910708062,76.76577410786633,0
Tamilnadu,The Nilgiris,Gudalur,179,9,7,hab,3,4,7,172,172,31,2034,542,11.54268478370436,76.4300377895491,0
Tamilnadu,The Nilgiris,Kotagiri,157,0,29,hab,27,2,45,112,128,31,3154,542,11.465862690569192,76.90670979116733,0
Tamilnadu,The Nilgiris,Udhagai,276,0,100,hab,83,17,173,103,176,31,6179,542,11.427230638207066,76.65518114849702,0
Tamilnadu,Theni,Andipatti,165,8,43,hab,43,0,75,90,122,31,189,543,9.991754351134912,77.61297934671553,0
Tamilnadu,Theni,Bodinaickanur,82,0,17,hab,16,1,15,67,65,31,1003,543,10.046077370274213,77.35198157177857,0
Tamilnadu,Theni,Chinnamanur,51,0,2,hab,0,2,0,51,49,31,1302,543,9.826510333253344,77.38854781389031,0
Tamilnadu,Theni,Cumbum,12,0,2,hab,0,2,0,12,10,31,1377,543,9.674725209346901,77.28118638144471,0
Tamilnadu,Theni,Myladumparai,152,1,32,hab,21,11,32,120,120,31,4034,543,9.740303879490947,77.4943511034259,0
Tamilnadu,Theni,Periyakulam,89,0,5,hab,3,2,5,84,84,31,4711,543,10.120844079686698,77.59367835256595,0
Tamilnadu,Theni,Theni,46,0,17,hab,16,1,24,22,29,31,6007,543,9.958899518626723,77.45868677804309,0
Tamilnadu,Theni,Uthamapalayam,27,0,3,hab,2,1,3,24,24,31,6238,543,9.842479712824092,77.2882881917124,0
Tamilnadu,Tiruchirappalli,Andanallur,108,1,82,hab,77,5,81,27,26,31,184,550,10.854971454880468,78.60206252227889,0
Tamilnadu,Tiruchirappalli,Lalgudi,101,0,87,hab,82,5,84,17,14,31,3365,550,10.89299341996157,78.828524674461,0
Tamilnadu,Tiruchirappalli,Manachanallur,155,0,43,hab,36,7,35,120,112,31,3618,550,10.980042660118679,78.71358309975918,0
Tamilnadu,Tiruchirappalli,Manapparai,233,0,291,osm,274,17,229,4,-58,31,3623,550,10.579245032451869,78.4113080285401,0
Tamilnadu,Tiruchirappalli,Manikandam,166,0,103,hab,100,3,134,32,63,31,3679,550,10.732334033367854,78.60965850000808,0
Tamilnadu,Tiruchirappalli,Marungapuri,344,11,232,hab,228,4,284,60,112,31,3743,550,10.42986800378526,78.41644601914764,0
Tamilnadu,Tiruchirappalli,Musiri,160,0,67,hab,58,9,61,99,93,31,4020,550,10.998199106184266,78.57763867030647,0
Tamilnadu,Tiruchirappalli,Pullampady,69,0,60,hab,56,4,65,4,9,31,4850,550,11.003421840034713,78.90668877613172,0
Tamilnadu,Tiruchirappalli,T.Pet,112,0,99,hab,90,9,100,12,13,31,5845,550,11.083692608109173,78.4333874200147,0
Tamilnadu,Tiruchirappalli,Thiruverambur,89,0,41,hab,30,11,40,49,48,31,6042,550,10.766420274137479,78.7584441076889,0
Tamilnadu,Tiruchirappalli,Thottiam,139,0,158,osm,148,10,132,7,-19,31,6060,550,11.013663750497932,78.28872748655473,0
Tamilnadu,Tiruchirappalli,Thuraiyur,148,0,117,hab,106,11,129,19,31,31,6069,550,11.17269078090107,78.60677005729275,0
Tamilnadu,Tiruchirappalli,Uppiliyapuram,71,0,79,osm,72,7,67,4,-8,31,6226,550,11.281186498906441,78.53473684300035,0
Tamilnadu,Tiruchirappalli,Vaiyampatty,175,0,298,osm,284,14,173,2,-123,31,6263,550,10.59844345431962,78.30162683160879,0
Tamilnadu,Tirunelveli,Alankulam,95,0,33,hab,33,0,50,45,62,31,77,551,8.949126064312694,77.53853224624527,0
Tamilnadu,Tirunelveli,Ambasamudram,59,0,8,hab,5,3,10,49,51,31,133,551,8.688211445206647,77.40551841642306,0
Tamilnadu,Tirunelveli,Cheranmahadevi,54,0,8,hab,5,3,13,41,46,31,1238,551,8.649205455793405,77.5519658147487,0
Tamilnadu,Tirunelveli,Kalakadu,135,0,25,hab,23,2,74,61,110,31,2606,551,8.505714975723945,77.53374107584146,0
Tamilnadu,Tirunelveli,Kuruvikulam,153,0,16,hab,13,3,18,135,137,31,3297,551,9.198847647691698,77.68851674998741,0
Tamilnadu,Tirunelveli,Manur,199,1,28,hab,26,2,48,151,171,31,3716,551,8.829729695082126,77.6715745136445,0
Tamilnadu,Tirunelveli,Melaneelithanallur,92,0,24,hab,23,1,30,62,68,31,3829,551,9.049580666978628,77.57988175463797,0
Tamilnadu,Tirunelveli,Nanguneri,251,0,25,hab,23,2,39,212,226,31,4155,551,8.490915913333428,77.73769049669811,0
Tamilnadu,Tirunelveli,Palayamkottai,132,0,7,hab,7,0,21,111,125,31,4457,551,8.698073449412481,77.74359732370849,0
Tamilnadu,Tirunelveli,Pappakudi,76,1,36,hab,35,1,52,24,40,31,4538,551,8.77665795628279,77.5072878119567,0
Tamilnadu,Tirunelveli,Radhapuram,170,1,24,hab,23,1,52,118,146,31,4909,551,8.289934691317569,77.76834523750033,0
Tamilnadu,Tirunelveli,Valliyoor,161,0,9,hab,9,0,32,129,152,31,6273,551,8.292773787760042,77.61966213600674,0
Tamilnadu,Tirupathur,Kandhili,274,11,22,hab,21,1,41,233,252,31,8014,748,12.437232237640808,78.52481770823496,0
Tamilnadu,Tirupathur,Natrampalli,290,0,7,hab,7,0,28,262,283,31,8015,748,12.641169255246687,78.51012599572823,0
Tamilnadu,Tirupathur,Thirupathur,275,0,71,hab,70,1,175,100,204,31,8016,748,12.506754890269951,78.64346988943086,0
Tamilnadu,Tiruppur,Avinashi,255,0,7,hab,5,2,13,242,248,31,322,552,11.22962692708469,77.23424536065454,0
Tamilnadu,Tiruppur,Dharapuram,107,1,17,hab,10,7,15,92,90,31,1578,552,10.72273860536804,77.49226593082257,0
Tamilnadu,Tiruppur,Gudimangalam,94,2,3,hab,3,0,7,87,91,31,2042,552,10.710469277537632,77.22815116108193,0
Tamilnadu,Tiruppur,Kangayam,247,1,11,hab,11,0,51,196,236,31,2711,552,11.044975731169014,77.57972972086183,0
Tamilnadu,Tiruppur,Kundadam,219,2,15,hab,12,3,21,198,204,31,3256,552,10.852142226539556,77.45711804380161,0
Tamilnadu,Tiruppur,Madathukulam,44,0,1,hab,0,1,0,44,43,31,3470,552,10.574764140697445,77.34846803915451,0
Tamilnadu,Tiruppur,Mulanur,132,4,89,hab,71,18,65,67,43,31,3970,552,10.768720070370223,77.72861009759471,0
Tamilnadu,Tiruppur,Palladam,136,0,6,hab,5,1,6,130,130,31,4472,552,11.009064458847629,77.25198726532005,0
Tamilnadu,Tiruppur,Pongalur,159,0,4,hab,4,0,14,145,155,31,4802,552,10.965648719013874,77.38005889578817,0
Tamilnadu,Tiruppur,Tiruppur,101,1,9,hab,2,7,5,96,92,31,6103,552,11.146501276120631,77.35708788475276,0
Tamilnadu,Tiruppur,Udumalpet,133,0,28,hab,27,1,25,108,105,31,6183,552,10.450301582652193,77.20835231213486,0
Tamilnadu,Tiruppur,Uthukuli,274,3,6,hab,6,0,27,247,268,31,6242,552,11.21751340429688,77.43485707215837,0
Tamilnadu,Tiruppur,Vellakoil,138,0,94,hab,68,26,58,80,44,31,6318,552,10.958585144377293,77.6945865682265,0
Tamilnadu,Tiruvallur,Ellapuram,278,0,9,hab,8,1,57,221,269,31,1739,553,13.276773132311893,80.02638962117629,0
Tamilnadu,Tiruvallur,Gummidipoondi,277,0,8,hab,8,0,36,241,269,31,2065,553,13.421660129198468,80.0655551462276,0
Tamilnadu,Tiruvallur,Kadambathur,221,0,14,hab,13,1,38,183,207,31,2559,553,13.043060181427869,79.87990882044076,0
Tamilnadu,Tiruvallur,Minjur,435,0,23,hab,19,4,74,361,412,31,3861,553,13.372653298838669,80.2565576608442,0
Tamilnadu,Tiruvallur,Pallipet,231,0,8,hab,6,2,29,202,223,31,4477,553,13.282522279994218,79.47619077662831,0
Tamilnadu,Tiruvallur,Poonamallee,155,0,35,hab,33,2,108,47,120,31,4808,553,13.07908143536119,80.05823699680904,0
Tamilnadu,Tiruvallur,Poondi,271,1,5,hab,5,0,19,252,266,31,4810,553,13.234628544361701,79.85963296212803,0
Tamilnadu,Tiruvallur,Puzhal,53,0,14,hab,9,5,37,16,39,31,4893,553,13.183571433432931,80.24582640163567,0
Tamilnadu,Tiruvallur,R.K.Pet,287,0,8,hab,8,0,46,241,279,31,4903,553,13.135939394203502,79.40157817415627,0
Tamilnadu,Tiruvallur,Sholavaram,219,0,46,hab,46,0,126,93,173,31,5587,553,13.258858767386684,80.16900875390336,0
Tamilnadu,Tiruvallur,Tiruttani,225,0,6,hab,6,0,32,193,219,31,6107,553,13.188114744550418,79.56293813728038,0
Tamilnadu,Tiruvallur,Tiruvalangadu,201,0,3,hab,3,0,8,193,198,31,6108,553,13.174382189802056,79.72176220341764,0
Tamilnadu,Tiruvallur,Tiruvallur,230,0,9,hab,9,0,21,209,221,31,6109,553,13.15469589996112,79.96431662734547,0
Tamilnadu,Tiruvallur,Villivakkam,111,0,24,hab,21,3,62,49,87,31,6370,553,13.126597960172477,80.12662403752914,0
Tamilnadu,Tiruvannamalai,Anakkavoor,183,0,33,hab,33,0,65,118,150,31,170,554,12.617124639583057,79.58970193337912,0
Tamilnadu,Tiruvannamalai,Arni,166,0,68,hab,67,1,133,33,98,31,245,554,12.711650220287579,79.28637576773093,0
Tamilnadu,Tiruvannamalai,Chengam,101,0,27,hab,19,8,22,79,74,31,1230,554,12.250787234883559,78.78069164649995,0
Tamilnadu,Tiruvannamalai,Chetpet,111,0,0,hab,0,0,0,111,111,31,1245,554,12.499755133129982,79.23904427755579,0
Tamilnadu,Tiruvannamalai,Cheyyar,192,1,22,hab,19,3,46,146,170,31,1248,554,12.66638904341193,79.4844580735703,0
Tamilnadu,Tiruvannamalai,Jawadumalai,174,1,129,hab,102,27,129,45,45,31,2467,554,12.567988640500117,78.94002601886167,0
Tamilnadu,Tiruvannamalai,Kalasapakkam,178,0,1,hab,1,0,7,171,177,31,2619,554,12.45202347308481,79.00184713457713,0
Tamilnadu,Tiruvannamalai,Kilpenathur,114,0,2,hab,0,2,0,114,112,31,3036,554,12.202228410607162,79.19872934619403,0
Tamilnadu,Tiruvannamalai,Peranamallur,177,0,26,hab,23,3,46,131,151,31,4705,554,12.525088046664393,79.4120905947043,0
Tamilnadu,Tiruvannamalai,Polur,234,0,29,hab,25,4,54,180,205,31,4797,554,12.59132914439413,79.12571522464083,0
Tamilnadu,Tiruvannamalai,Pudupalayam,118,0,35,hab,34,1,60,58,83,31,4841,554,12.338623312999209,78.92663628744229,0
Tamilnadu,Tiruvannamalai,Thandrampet,120,0,9,hab,9,0,14,106,111,31,5989,554,12.11268056071151,78.86749573930422,0
Tamilnadu,Tiruvannamalai,Thellar,235,0,5,hab,5,0,15,220,230,31,6006,554,12.426288657615437,79.53851688179721,0
Tamilnadu,Tiruvannamalai,Thurinjapuram,117,0,3,hab,3,0,1,116,114,31,6070,554,12.345807704899588,79.11868407747802,0
Tamilnadu,Tiruvannamalai,Tiruvannamalai,180,0,15,hab,15,0,26,154,165,31,6110,554,12.14542819942268,79.09203300949673,0
Tamilnadu,Tiruvannamalai,Vandavasi,183,0,21,hab,21,0,43,140,162,31,6280,554,12.49475006059517,79.64642282782916,0
Tamilnadu,Tiruvannamalai,Vembakkam,190,0,4,hab,4,0,10,180,186,31,6325,554,12.776532572652583,79.58628224228259,0
Tamilnadu,Tiruvannamalai,West Arni,204,0,50,hab,49,1,125,79,154,31,6437,554,12.637734192727784,79.23549017407898,0
Tamilnadu,Tiruvarur,Kodavasal,169,0,7,hab,7,0,18,151,162,31,3066,555,10.907217817802442,79.54765281433838,0
Tamilnadu,Tiruvarur,Koradacheri,162,0,1,hab,1,0,2,160,161,31,3130,555,10.791756251504186,79.54225534658919,0
Tamilnadu,Tiruvarur,Kottur,231,0,0,hab,0,0,0,231,231,31,3183,555,10.560386827534376,79.52664825956172,0
Tamilnadu,Tiruvarur,Mannargudi,194,0,4,hab,4,0,7,187,190,31,3694,555,10.655735038535285,79.48463831141933,0
Tamilnadu,Tiruvarur,Muthupettai,109,0,26,hab,25,1,27,82,83,31,4029,555,10.392660753811112,79.57533825969253,0
Tamilnadu,Tiruvarur,Nannilam,160,0,7,hab,7,0,17,143,153,31,4157,555,10.924599076325006,79.65270247543775,0
Tamilnadu,Tiruvarur,Needamangalam,159,0,3,hab,3,0,5,154,156,31,4265,555,10.70944101187189,79.39588196407077,0
Tamilnadu,Tiruvarur,Thiruthuraipoondi,137,0,17,hab,14,3,11,126,120,31,6035,555,10.558961521411979,79.63790151115509,0
Tamilnadu,Tiruvarur,Thiruvarur,120,1,16,hab,16,0,12,108,104,31,6039,555,10.748623710739603,79.65598324434698,0
Tamilnadu,Tiruvarur,Valangaiman,183,0,25,hab,24,1,28,155,158,31,6267,555,10.854112532043755,79.36604773353353,0
Tamilnadu,Tuticorin,Alwarthirunageri,208,0,16,hab,12,4,36,172,192,31,103,559,8.568014632186737,77.97111759587357,0
Tamilnadu,Tuticorin,Karungulam,115,0,8,hab,7,1,14,101,107,31,2799,559,8.708363793065782,77.87501253437422,0
Tamilnadu,Tuticorin,Kayathar,132,0,25,hab,24,1,28,104,107,31,2870,559,9.032976138516757,77.81297827085244,0
Tamilnadu,Tuticorin,Kovilpatti,123,0,30,hab,28,2,42,81,93,31,3188,559,9.137633118348296,77.92123772002356,0
Tamilnadu,Tuticorin,Ottapidaram,174,0,16,hab,16,0,21,153,158,31,4398,559,8.923452730326895,78.00680344215687,0
Tamilnadu,Tuticorin,Pudur,110,0,56,hab,54,2,70,40,54,31,4842,559,9.262285922287193,78.14043434192988,0
Tamilnadu,Tuticorin,Sattankulam,191,0,13,hab,13,0,46,145,178,31,5442,559,8.420241300322338,77.92041734519665,0
Tamilnadu,Tuticorin,Srivaikuntam,162,0,5,hab,5,0,16,146,157,31,5772,559,8.660629620612701,78.00148043960422,0
Tamilnadu,Tuticorin,Thoothukudi,157,0,4,hab,4,0,47,110,153,31,6054,559,8.770018306900461,78.06202888602611,0
Tamilnadu,Tuticorin,Tiruchendur,73,1,4,hab,0,4,0,73,69,31,6098,559,8.523329055753972,78.0812791423173,0
Tamilnadu,Tuticorin,Udangudi,153,0,10,hab,10,0,46,107,143,31,6175,559,8.464458089037489,78.01833139425179,0
Tamilnadu,Tuticorin,Vilathikulam,140,1,47,hab,43,4,52,88,93,31,6369,559,9.097019702656185,78.18256576828537,0
Tamilnadu,Vellore,Alangayam,177,1,74,hab,56,18,89,88,103,31,76,578,12.514141745348361,78.70790671537938,0
Tamilnadu,Vellore,Anaicut,329,2,133,hab,121,12,230,99,196,31,167,578,12.793271137700188,78.93958598719804,0
Tamilnadu,Vellore,Arakonam,132,0,4,hab,4,0,15,117,128,31,218,578,13.095703984977815,79.69627334052196,0
Tamilnadu,Vellore,Gudiyatham,351,0,5,hab,5,0,11,340,346,31,2045,578,12.998397307274814,78.87703795532406,0
Tamilnadu,Vellore,Jolarpet,335,0,26,hab,24,2,52,283,309,31,2522,578,12.56840896314716,78.56790472280025,0
Tamilnadu,Vellore,K.V. Kuppam,288,0,3,hab,3,0,14,274,285,31,2552,578,12.979930748733878,79.00214283628172,0
Tamilnadu,Vellore,Kaniyambadi,109,0,8,hab,2,6,12,97,101,31,2720,578,12.782961641163652,79.08500889425439,0
Tamilnadu,Vellore,Katpadi,143,1,0,hab,0,0,0,143,143,31,2843,578,12.988566678227663,79.17757707172437,0
Tamilnadu,Vellore,Kaveripakkam,285,0,11,hab,10,1,24,261,274,31,2864,578,13.026348559556455,79.51887963114933,0
Tamilnadu,Vellore,Madhanur,224,0,78,hab,77,1,191,33,146,31,3479,578,12.764850995577543,78.79198414407769,0
Tamilnadu,Vellore,Nemili,222,0,1,hab,1,0,4,218,221,31,4275,578,12.983457318463675,79.6082676597829,0
Tamilnadu,Vellore,Pernambet,343,0,26,hab,26,0,62,281,317,31,4713,578,12.898306944959137,78.70255855256069,0
Tamilnadu,Vellore,Sholinghur,235,0,11,hab,11,0,27,208,224,31,5588,578,13.054084434170791,79.33537317291228,0
Tamilnadu,Vellore,Vellore,99,0,4,hab,2,2,20,79,95,31,6322,578,12.87695242925704,79.08940002739885,0
Tamilnadu,Villupuram,Gingee,141,0,11,hab,8,3,18,123,130,31,1956,580,12.186977457485678,79.33978739679812,0
Tamilnadu,Villupuram,Kanai,153,0,8,hab,8,0,20,133,145,31,2690,580,12.026706189314657,79.392963857649,0
Tamilnadu,Villupuram,Kandamangalam,224,1,1,hab,1,0,3,221,223,31,2700,580,11.898260304985062,79.64235890707229,0
Tamilnadu,Villupuram,Koliyanur,237,0,3,hab,3,0,18,219,234,31,3094,580,11.920438871701093,79.51059420402603,0
Tamilnadu,Villupuram,Mailam,85,0,8,hab,8,0,9,76,77,31,3551,580,12.174762834874915,79.58345167812149,0
Tamilnadu,Villupuram,Melmalayanur,258,0,2,hab,2,0,7,251,256,31,3832,580,12.35715559031223,79.32530404807784,0
Tamilnadu,Villupuram,Merkanam,194,0,1,hab,1,0,5,189,193,31,3844,580,12.187182268175698,79.81309548581595,0
Tamilnadu,Villupuram,Mugaiyur,203,0,9,hab,8,1,16,187,194,31,3957,580,12.00451804362699,79.2280737284338,0
Tamilnadu,Villupuram,Olakkur,150,0,2,hab,2,0,6,144,148,31,4381,580,12.292117772115336,79.6955612600444,0
Tamilnadu,Villupuram,Rishivandiyam,88,0,0,hab,0,0,0,88,88,31,5169,580,11.899532667854812,79.03323801075288,0
Tamilnadu,Villupuram,Thirukoilur,170,0,14,hab,13,1,26,144,156,31,6020,580,11.915064877076283,79.16549464150609,0
Tamilnadu,Villupuram,Thiruvennainallur,165,0,6,hab,5,1,12,153,159,31,6041,580,11.859839121181466,79.36573217947272,0
Tamilnadu,Villupuram,Vallam,178,0,2,hab,2,0,2,176,176,31,6271,580,12.2726612691184,79.48197272305946,0
Tamilnadu,Villupuram,Vanur,228,0,16,hab,14,2,33,195,212,31,6285,580,12.068886000297177,79.75217881769709,0
Tamilnadu,Villupuram,Vikravandi,164,0,11,hab,11,0,42,122,153,31,6368,580,12.044618862247512,79.51785667216625,0
Tamilnadu,Virudhunagar,Aruppukottai,63,0,44,hab,38,6,40,23,19,31,250,581,9.482731377980267,78.0741716842036,0
Tamilnadu,Virudhunagar,Kariapatti,137,0,68,hab,61,7,68,69,69,31,2777,581,9.651232006293423,78.124764374732,0
Tamilnadu,Virudhunagar,Narikudi,162,0,75,hab,62,13,82,80,87,31,4186,581,9.60740030768918,78.2943785178462,0
Tamilnadu,Virudhunagar,Rajapalayam,179,0,35,hab,35,0,76,103,144,31,4966,581,9.41577183127577,77.50802899197166,0
Tamilnadu,Virudhunagar,Sattur,136,0,52,hab,46,6,70,66,84,31,5445,581,9.322587580914302,77.94099497005578,0
Tamilnadu,Virudhunagar,Sivakasi,233,0,45,hab,43,2,78,155,188,31,5697,581,9.509145491120577,77.79670289812002,0
Tamilnadu,Virudhunagar,Srivilliputhur,140,0,67,hab,64,3,107,33,73,31,5773,581,9.520351349438956,77.59719567850804,0
Tamilnadu,Virudhunagar,Thiruchuli,125,0,71,hab,69,2,78,47,54,31,6018,581,9.435016195008838,78.22578361304537,0
Tamilnadu,Virudhunagar,Vembakottai,170,0,33,hab,30,3,63,107,137,31,6326,581,9.343146806852003,77.755953823171,0
Tamilnadu,Virudhunagar,Virudhunagar,182,0,86,hab,85,1,120,62,96,31,6378,581,9.516788735701917,77.93381460286068,0
Tamilnadu,Virudhunagar,Watrap,78,0,39,hab,30,9,48,30,39,31,6429,581,9.637751991014675,77.66968155455599,0
Telangana,Adilabad,Adilabad Rural,90,0,68,hab,67,1,68,22,22,36,7453,602,19.620878963082053,78.6119437032716,0
Telangana,Adilabad,Bazarhathnoor,66,1,44,hab,44,0,52,14,22,36,6491,602,19.49325982763548,78.37197796462603,0
Telangana,Adilabad,Bela,87,1,69,hab,69,0,80,7,18,36,6494,602,19.68774602619513,78.76710650106527,0
Telangana,Adilabad,Bheempur,44,0,41,hab,41,0,38,6,3,36,7470,602,19.806132158302656,78.39210297292918,0
Telangana,Adilabad,Gadiguda,90,1,77,hab,76,1,81,9,13,36,7486,602,19.60515196838643,78.87129626624665,0
Telangana,Adilabad,Gudihathnur,79,0,51,hab,48,3,72,7,28,36,6503,602,19.523733572837955,78.51283628331653,0
Telangana,Adilabad,Ichoda,67,2,58,hab,56,2,58,9,9,36,6504,602,19.378596129095467,78.49487742563251,0
Telangana,Adilabad,Inderavelly,119,1,92,hab,91,1,112,7,27,36,6505,602,19.48852056039111,78.65222105403716,0
Telangana,Adilabad,Jainad,60,0,53,hab,53,0,57,3,7,36,6506,602,19.741486774662675,78.61886123654581,0
Telangana,Adilabad,Mavala,6,2,1,hab,1,0,1,5,5,36,7529,602,19.638858365760008,78.51376758691296,0
Telangana,Adilabad,Narnoor,71,0,65,hab,62,3,67,4,6,36,6526,602,19.502396881704883,78.8517048637343,0
Telangana,Adilabad,Neradigonda,75,0,63,hab,59,4,64,11,12,36,6528,602,19.26935530075354,78.41433698134863,0
Telangana,Adilabad,Sirikonda,57,1,46,hab,41,5,52,5,11,36,7569,602,19.374384289402613,78.60438871667732,0
Telangana,Adilabad,Talamadugu,50,0,45,hab,45,0,49,1,5,36,6534,602,19.630106284088736,78.38328413891999,0
Telangana,Adilabad,Tamsi,17,0,13,hab,13,0,13,4,4,36,6535,602,19.70683371259743,78.4394346735553,0
Telangana,Adilabad,Utnur,176,0,85,hab,85,0,117,59,91,36,6539,602,19.369822298658857,78.76764088910882,0
Telangana,Bhadradri Kothagudem,Annapureddypalli,36,0,10,hab,10,0,13,23,26,36,7463,652,17.355354588367867,80.74644829339921,0
Telangana,Bhadradri Kothagudem,Aswapuram,75,0,14,hab,13,1,23,52,61,36,7233,652,17.818921712144057,80.79404465178312,0
Telangana,Bhadradri Kothagudem,Aswaraopeta,91,1,78,hab,75,3,81,10,13,36,7224,652,17.3632886382483,81.13482805994613,0
Telangana,Bhadradri Kothagudem,Burgampadu,40,0,31,hab,31,0,31,9,9,36,7232,652,17.67755204467116,80.8184677820713,0
Telangana,Bhadradri Kothagudem,Chandrugonda,36,0,1,hab,1,0,1,35,35,36,7223,652,17.384946259256257,80.62234328843928,0
Telangana,Bhadradri Kothagudem,Cherla,127,0,61,hab,60,1,86,41,66,36,7231,652,18.07569129349751,80.8681658066399,0
Telangana,Bhadradri Kothagudem,Chunchupally,32,0,1,hab,1,0,3,29,31,36,7481,652,17.475244886931687,80.67561137949808,0
Telangana,Bhadradri Kothagudem,Dammapeta,96,0,98,osm,97,1,91,5,-2,36,7226,652,17.331693261768528,80.96932810141622,0
Telangana,Bhadradri Kothagudem,Dummugudem,104,0,90,hab,88,2,94,10,14,36,7230,652,17.83138789970057,80.9582765294058,0
Telangana,Bhadradri Kothagudem,Julurpad,66,0,2,hab,2,0,7,59,64,36,7228,652,17.42164560289873,80.49796198932741,0
Telangana,Bhadradri Kothagudem,Karakagudem,44,0,26,hab,26,0,32,12,18,36,7511,652,18.03641837041171,80.55619853525955,0
Telangana,Bhadradri Kothagudem,Laxmidevipally,72,7,23,hab,22,1,33,39,49,36,7520,652,17.67520343250886,80.6004271248246,0
Telangana,Bhadradri Kothagudem,Manuguru,65,0,1,hab,1,0,1,64,64,36,7234,652,17.9522752128646,80.7761111368474,0
Telangana,Bhadradri Kothagudem,Mulakalapalle,104,0,76,hab,75,1,81,23,28,36,7225,652,17.488218651528715,80.83942624427559,0
Telangana,Bhadradri Kothagudem,Palawancha,68,0,26,hab,22,4,25,43,42,36,7220,652,17.70834165641312,80.69109869368486,0
Telangana,Bhadradri Kothagudem,Pinapaka,73,0,16,hab,16,0,27,46,57,36,7235,652,18.048505035890233,80.68296307278828,0
Telangana,Bhadradri Kothagudem,Sujathanagar,2,0,0,hab,0,0,0,2,2,36,7572,652,17.5262464684895,80.59484556294206,1
Telangana,Bhadradri Kothagudem,Tekulapalle,135,0,130,hab,126,4,135,0,5,36,7221,652,17.635701309188256,80.49167216015873,0
Telangana,Bhadradri Kothagudem,Yellandu,122,2,47,hab,45,2,52,70,75,36,7222,652,17.655561601708836,80.32087113635872,0
Telangana,Jagitial,Buggaram,13,0,1,hab,1,0,1,12,12,36,7472,649,18.87000697099538,79.0660727303872,0
Telangana,Jagitial,Dharmapuri,35,0,3,hab,3,0,2,33,32,36,7207,649,18.96266406430288,79.06356769842563,0
Telangana,Jagitial,Ibrahimpatnam,20,0,3,hab,3,0,3,17,17,36,7216,649,18.92240856738132,78.58304250449574,0
Telangana,Jagitial,Jagtial Rural,35,0,12,hab,12,0,10,25,23,36,7504,649,18.81660961617611,78.93523682691439,0
Telangana,Jagitial,Kathlapur,22,0,17,hab,16,1,16,6,5,36,7218,649,18.707070624953268,78.69420995897289,0
Telangana,Jagitial,Kodimial,32,0,13,hab,12,1,19,13,19,36,7211,649,18.629232035957756,78.89275451535958,0
Telangana,Jagitial,Koratla,19,0,10,hab,9,1,11,8,9,36,7213,649,18.839584344258697,78.73453128114939,0
Telangana,Jagitial,Mallapur,31,0,12,hab,11,1,15,16,19,36,7215,649,18.960238546086075,78.71216340809802,0
Telangana,Jagitial,Mallial,28,0,14,hab,14,0,20,8,14,36,7210,649,18.70975857092355,78.92831110550269,0
Telangana,Jagitial,Medipalle,27,0,25,hab,25,0,23,4,2,36,7217,649,18.745928376937105,78.79693386768459,0
Telangana,Jagitial,Pegadapalle,36,0,1,hab,1,0,1,35,35,36,7208,649,18.705688003988318,79.06553087983359,0
Telangana,Jagitial,Raikal,51,1,18,hab,18,0,25,26,33,36,7205,649,18.95163311717641,78.84084584757554,0
Telangana,Jagitial,Sarangapur,25,0,1,hab,1,0,2,23,24,36,7206,649,18.92641550143775,78.9443526981507,0
Telangana,Jagitial,Velgatoor,37,0,6,hab,4,2,5,32,31,36,7212,649,18.808287640848885,79.19906979282288,0
Telangana,Jangoan,Bachannapeta,35,0,8,hab,8,0,10,25,27,36,7239,658,17.81193402776539,79.00621714925987,0
Telangana,Jangoan,Chilpur,50,0,13,hab,13,0,16,34,37,36,7475,658,17.914981470799052,79.30949046064885,0
Telangana,Jangoan,Devaruppula,68,0,3,hab,2,1,2,66,65,36,7240,658,17.592989726781887,79.32408942781862,0
Telangana,Jangoan,Ghanpur(Stn),36,0,0,hab,0,0,0,36,36,36,7243,658,17.82056459904276,79.3519049373266,0
Telangana,Jangoan,Gundala,23,0,3,hab,3,0,4,19,20,36,7236,658,17.528078130209263,79.26613754358844,0
Telangana,Jangoan,Jangaon,52,0,1,hab,1,0,1,51,51,36,7237,658,17.75798779796987,79.13109115548913,0
Telangana,Jangoan,Kodakandla,58,0,1,hab,1,0,1,57,57,36,7246,658,17.54486067264317,79.46791231957734,0
Telangana,Jangoan,Lingala Ghanpur,38,0,9,hab,9,0,10,28,29,36,7238,658,17.657738711632202,79.21485798485314,0
Telangana,Jangoan,Palakurthi,84,0,7,hab,7,0,8,76,77,36,7245,658,17.65068257665169,79.4359520112186,0
Telangana,Jangoan,Raghunathapally,70,1,1,hab,1,0,1,69,69,36,7242,658,17.768013686049265,79.27103916173425,0
Telangana,Jangoan,Tharigoppula,46,2,8,hab,8,0,17,29,38,36,7575,658,17.950072869013425,79.18021477049308,0
Telangana,Jangoan,Zaffergadh,42,0,19,hab,19,0,19,23,23,36,7244,658,17.796354629236482,79.46275343557353,0
Telangana,Jayashankar Bhoopalapally,Kataram,56,0,64,osm,63,1,55,1,-8,36,7248,664,18.649444890625773,79.91467509306491,0
Telangana,Jayashankar Bhoopalapally,Regonda,51,0,26,hab,26,0,28,23,25,36,7255,664,18.244978760229774,79.7831523779252,0
Telangana,Jogulamba Gadwal,Aiza,35,0,33,hab,33,0,33,2,2,36,7597,653,15.981805748871304,77.64197782584442,0
Telangana,Jogulamba Gadwal,Alampur,17,1,12,hab,12,0,12,5,5,36,7269,653,15.919812242142294,78.12862771526699,0
Telangana,Jogulamba Gadwal,Dharur,37,0,37,hab,36,1,35,2,0,36,7265,653,16.27735718992621,77.66785583345158,0
Telangana,Jogulamba Gadwal,Gadwal,37,0,34,hab,34,0,34,3,3,36,7264,653,16.21036665162187,77.81156618435604,0
Telangana,Jogulamba Gadwal,Ghattu,32,0,32,hab,30,2,30,2,0,36,7266,653,16.091578394808586,77.57240695306342,0
Telangana,Jogulamba Gadwal,Itikyal,35,0,36,osm,35,1,34,1,-1,36,7267,653,16.075481398456553,77.8740226607537,0
Telangana,Jogulamba Gadwal,Kaloor Thimmandoddi,33,0,31,hab,31,0,32,1,2,36,7506,653,16.218792328059212,77.5468852457852,0
Telangana,Jogulamba Gadwal,Maldakal,31,0,31,hab,31,0,31,0,0,36,7271,653,16.118058008797426,77.71394152081506,0
Telangana,Jogulamba Gadwal,Manopadu,22,0,15,hab,15,0,16,6,7,36,7268,653,15.980031731774817,77.9526152975254,0
Telangana,Jogulamba Gadwal,Rajoli,16,1,14,hab,14,0,15,1,2,36,7560,653,15.911799891698006,77.7531982191664,0
Telangana,Jogulamba Gadwal,Undavelly,18,0,15,hab,14,1,15,3,3,36,7578,653,15.949157647572093,78.01365273170825,0
Telangana,Jogulamba Gadwal,Waddepalle,13,0,13,hab,11,2,11,2,0,36,7270,653,15.966709430860737,77.82096083981337,0
Telangana,Kamareddy,Banswada,48,0,34,hab,34,0,42,6,14,36,7278,661,18.39296770138379,77.9215694144063,0
Telangana,Kamareddy,Bhiknur,22,0,17,hab,17,0,18,4,5,36,7273,661,18.18650442809519,78.4143978268028,0
Telangana,Kamareddy,Bibipet,12,0,13,osm,13,0,12,0,-1,36,7471,661,18.22041125844027,78.52253448152862,0
Telangana,Kamareddy,Bichkunda,32,0,30,hab,30,0,31,1,2,36,7280,661,18.389936720243483,77.74661908881477,0
Telangana,Kamareddy,Birkoor,16,1,16,osm,14,2,16,0,0,36,7279,661,18.450284067539716,77.80882381495918,0
Telangana,Kamareddy,Gandhari,78,0,39,hab,39,0,50,28,39,36,7288,661,18.397407896805472,78.0729950368854,0
Telangana,Kamareddy,Jukkal,45,0,38,hab,38,0,43,2,7,36,7281,661,18.359037644515404,77.60805084543077,0
Telangana,Kamareddy,Lingampet,86,0,37,hab,37,0,69,17,49,36,7287,661,18.25297207662143,78.1243349158043,0
Telangana,Kamareddy,Machareddy,53,0,24,hab,24,0,33,20,29,36,7276,661,18.35276880104238,78.48319179165013,0
Telangana,Kamareddy,Madnur,39,0,39,hab,39,0,39,0,0,36,7283,661,18.486212574351814,77.66467674685269,0
Telangana,Kamareddy,Nagireddipet,44,0,28,hab,28,0,37,7,16,36,7286,661,18.122046259795102,78.0983157929101,0
Telangana,Kamareddy,Nasurullabad,25,0,24,hab,23,1,25,0,1,36,7542,661,18.463761723938394,77.89243017124143,0
Telangana,Kamareddy,Nizam Sagar,45,0,45,hab,42,3,41,4,0,36,7284,661,18.232502787808635,77.93034965626222,0
Telangana,Kamareddy,Pedda Kodapgal,35,0,30,hab,30,0,34,1,5,36,7551,661,18.290219849063206,77.7275960436233,0
Telangana,Kamareddy,Pitlam,49,0,45,hab,45,0,47,2,4,36,7282,661,18.272385816319407,77.81983603127387,0
Telangana,Kamareddy,Rajampet,31,0,14,hab,14,0,17,14,17,36,7558,661,18.21179644288437,78.29293987530104,0
Telangana,Kamareddy,Ramareddy,27,0,17,hab,17,0,20,7,10,36,7562,661,18.424456760550488,78.39855934933611,0
Telangana,Kamareddy,Tadwai,22,0,18,hab,18,0,19,3,4,36,7274,661,18.306989259919426,78.23617424330075,0
Telangana,Kamareddy,Yellareddy,64,3,40,hab,40,0,60,4,24,36,7285,661,18.217726304902975,78.01891230016521,0
Telangana,Karimnagar,Gangadhara,46,0,7,hab,7,0,10,36,39,36,6554,603,18.56881467865545,79.00506899148976,0
Telangana,Karimnagar,Huzurabad,28,0,6,hab,6,0,6,22,22,36,6557,603,18.217104374340046,79.41594768790654,0
Telangana,Karimnagar,Karimnagar Rural,21,0,5,hab,5,0,5,16,16,36,7512,603,18.481327244718802,79.17486079008074,0
Telangana,Karimnagar,Kothapally,24,0,2,hab,1,1,1,23,22,36,7518,603,18.452763987409316,79.05283162932113,0
Telangana,Karimnagar,Manakondur,41,0,10,hab,10,0,13,28,31,36,6575,603,18.404009709869193,79.26037442360021,0
Telangana,Karimnagar,Shankerpatnam,29,0,5,hab,5,0,5,24,24,36,6590,603,18.305878949544475,79.33166664778535,0
Telangana,Karimnagar,Thimmapur,39,1,2,hab,2,0,3,36,37,36,6594,603,18.322221515055368,79.181883545937,0
Telangana,Khammam,Bonakal,22,0,22,hab,22,0,22,0,0,36,6900,604,17.035862937687043,80.28911388933834,0
Telangana,Khammam,Chinthakani,26,0,32,osm,32,0,26,0,-6,36,6903,604,17.12613974211395,80.21382473531776,0
Telangana,Khammam,Enkuru,46,0,10,hab,10,0,13,33,36,36,6906,604,17.353690462971205,80.4127835895939,0
Telangana,Khammam,Kalluru,51,0,42,hab,42,0,42,9,9,36,6911,604,17.20798379851824,80.5414165854328,0
Telangana,Khammam,Khammam Rural,67,0,25,hab,25,0,35,32,42,36,6914,604,17.28416498169146,80.09589260476147,0
Telangana,Khammam,Konijerla,112,0,30,hab,30,0,68,44,82,36,6916,604,17.23623478941764,80.31361185081644,0
Telangana,Khammam,Kusumanchi,83,0,44,hab,44,0,51,32,39,36,6918,604,17.21570359179024,79.95312011744508,0
Telangana,Khammam,Madhira,35,0,39,osm,36,3,33,2,-4,36,6919,604,16.931009823819263,80.38327375427868,0
Telangana,Khammam,Mudigonda,32,0,29,hab,29,0,30,2,3,36,6921,604,17.114473301640626,80.11102650756509,0
Telangana,Khammam,Nelakondapalle,39,0,36,hab,36,0,38,1,3,36,6923,604,17.085518501581827,80.04731541649181,0
Telangana,Khammam,Penuballi,56,0,52,hab,52,0,51,5,4,36,6925,604,17.217781558872204,80.68438835058147,0
Telangana,Khammam,Raghunadhapalem,58,1,12,hab,12,0,20,38,46,36,7556,604,17.324564529549054,80.23373373190307,0
Telangana,Khammam,Sathupalle,33,0,33,hab,32,1,25,8,0,36,6927,604,17.234404941691707,80.83323592315669,0
Telangana,Khammam,Thallada,42,0,26,hab,26,0,27,15,16,36,6930,604,17.207560169790927,80.44459916232341,0
Telangana,Khammam,Thirumalayapalem,82,0,2,hab,2,0,4,78,80,36,6931,604,17.325685599393772,79.9418096453938,0
Telangana,Khammam,Vemsoor,36,0,35,hab,33,2,34,2,1,36,6932,604,17.110577868426,80.77284626315544,0
Telangana,Khammam,Wyra,30,0,27,hab,26,1,29,1,3,36,6935,604,17.124455084561504,80.36510153487218,0
Telangana,Khammam,Yerrupalem,42,0,45,osm,45,0,39,3,-3,36,6937,604,16.864936867611448,80.51799036975542,0
Telangana,Komrambheem Asifabad,Asifabad,129,0,78,hab,77,1,83,46,51,36,7195,646,19.34592462671267,79.25037005341126,0
Telangana,Komrambheem Asifabad,Bejjur,62,0,45,hab,44,1,49,13,17,36,7199,646,19.358276260073293,79.85393774532551,0
Telangana,Komrambheem Asifabad,Chintalamanepally,45,0,33,hab,33,0,39,6,12,36,7478,646,19.45383791173886,79.84041584156584,0
Telangana,Komrambheem Asifabad,Dahegaon,63,0,40,hab,40,0,44,19,23,36,7202,646,19.2284838413261,79.75397896215063,0
Telangana,Komrambheem Asifabad,Jainoor,70,1,16,hab,13,3,13,57,54,36,7193,646,19.41655747577337,78.92085927319937,0
Telangana,Komrambheem Asifabad,Kagaz Nagar,111,0,67,hab,67,0,71,40,44,36,7200,646,19.383002145475388,79.52466206865179,0
Telangana,Komrambheem Asifabad,Kerameri,108,1,99,hab,91,8,83,25,9,36,7196,646,19.457635192503258,79.08514621340896,0
Telangana,Komrambheem Asifabad,Kouthala,50,0,38,hab,38,0,44,6,12,36,7201,646,19.53738228758102,79.7296218249629,0
Telangana,Komrambheem Asifabad,Lingapur,60,0,26,hab,26,0,36,24,34,36,7521,646,19.26467084983315,79.02750544540612,0
Telangana,Komrambheem Asifabad,Rebbana,72,0,53,hab,53,0,58,14,19,36,7198,646,19.260104832234674,79.43773793063923,0
Telangana,Komrambheem Asifabad,Sirpur (T),54,0,33,hab,33,0,37,17,21,36,7203,646,19.468998304400934,79.58345898276353,0
Telangana,Komrambheem Asifabad,Sirpur (U),86,1,38,hab,38,0,47,39,48,36,7192,646,19.33976513497264,78.97156495165439,0
Telangana,Komrambheem Asifabad,Tiryani,183,0,63,hab,60,3,71,112,120,36,7194,646,19.193045006689864,79.20344181439809,0
Telangana,Komrambheem Asifabad,Wankdi,97,0,65,hab,62,3,64,33,32,36,7197,646,19.494900987731203,79.31183316391294,0
Telangana,Mahaboobnagar,Addakal,1,0,0,hab,0,0,0,1,1,36,6600,605,16.5820914183016,77.9011072509681,1
Telangana,Mahaboobnagar,Bhoothpur,114,0,23,hab,23,0,72,42,91,36,6608,605,16.67036609385913,78.06685302700825,0
Telangana,Mahaboobnagar,Chinna Chinta Kunta,33,1,2,hab,2,0,2,31,31,36,6611,605,16.4866072746095,77.79834317807445,0
Telangana,Mahaboobnagar,Gandeed,103,0,76,hab,75,1,97,6,27,36,7496,605,16.917310929578324,77.83350250866644,0
Telangana,Mahaboobnagar,Hanwada,168,0,30,hab,30,0,86,82,138,36,6622,605,16.824352237172853,77.88978709408731,0
Telangana,Mahaboobnagar,Jadcherla,95,0,17,hab,17,0,24,71,78,36,6624,605,16.790589388571547,78.17132311409372,0
Telangana,Mahaboobnagar,Mahabubnagar,1,0,0,hab,0,0,0,1,1,36,6639,605,16.6879112671106,77.8690734772664,1
Telangana,Mahaboobnagar,Mahabubnagar Rural ,41,3,3,hab,3,0,3,38,38,36,7525,605,16.707578897961316,77.92207733170804,0
Telangana,Mahaboobnagar,Midjil,34,0,21,hab,21,0,24,10,13,36,6643,605,16.75592231743618,78.29834281563863,0
Telangana,Mahaboobnagar,Moosapet,17,0,19,osm,19,0,16,1,-2,36,7533,605,16.60870635516015,77.96465705392325,0
Telangana,Mahaboobnagar,Nawabpet,1,0,0,hab,0,0,0,1,1,36,6647,605,16.841582710177,78.0716791341263,1
Telangana,Mahabubabad,Chinnagudur,46,0,1,hab,1,0,2,44,45,36,7476,665,17.496449143628013,79.89159041938737,0
Telangana,Mahabubabad,Danthalapalle,34,0,5,hab,5,0,8,26,29,36,7483,665,17.4827608722889,79.72675611983418,0
Telangana,Mahabubabad,Dornakal,96,0,6,hab,6,0,10,86,90,36,7293,665,17.414846024127566,80.09085220318049,0
Telangana,Mahabubabad,Gangaram,30,0,6,hab,5,1,5,25,24,36,7497,665,17.862198331779553,80.21102697875726,0
Telangana,Mahabubabad,Kothaguda,55,1,4,hab,3,1,4,51,51,36,7295,665,17.948884658446474,80.08879329859758,0
Telangana,Mahabubabad,Maripeda,140,0,19,hab,19,0,31,109,121,36,7298,665,17.404965667541568,79.86696192787026,0
Telangana,Mahabubabad,Narsimhulapet,78,0,5,hab,5,0,15,63,73,36,7299,665,17.50089693360722,79.81068215812593,0
Telangana,Mahabubabad,Peddavangara,54,1,1,hab,1,0,2,52,53,36,7552,665,17.55398799480891,79.57714160395415,0
Telangana,Mancherial,Bellampalle,35,0,9,hab,9,0,9,26,26,36,7176,647,19.06791291704927,79.51026734924682,0
Telangana,Mancherial,Bheemaram,19,0,15,hab,15,0,17,2,4,36,7469,647,18.864299488727642,79.66224575165874,0
Telangana,Mancherial,Chennur,60,0,51,hab,51,0,52,8,9,36,7167,647,18.821262465847614,79.7621177950167,0
Telangana,Mancherial,Dandepalle,74,0,44,hab,43,1,58,16,30,36,7173,647,19.003722069934298,79.1551247311862,0
Telangana,Mancherial,Jaipur,32,0,26,hab,26,0,29,3,6,36,7168,647,18.797113419898725,79.60577581133505,0
Telangana,Mancherial,Jannaram,84,0,41,hab,40,1,71,13,43,36,7174,647,19.136180151984743,79.0020845438263,0
Telangana,Mancherial,Kasipet,66,0,4,hab,4,0,8,58,62,36,7175,647,19.05838353747084,79.34347252797271,0
Telangana,Mancherial,Kotapalle,49,0,20,hab,20,0,17,32,29,36,7169,647,18.951086400378735,79.84902340264897,0
Telangana,Mancherial,Luxettipet,42,0,27,hab,25,2,34,8,15,36,7170,647,18.92344316055429,79.23839805267457,0
Telangana,Mancherial,Mandamarri,27,0,1,hab,1,0,1,26,26,36,7172,647,18.94934051167944,79.48957248127468,0
Telangana,Mancherial,Nennal,43,0,23,hab,23,0,25,18,20,36,7178,647,19.02130128774084,79.6362665458368,0
Telangana,Mancherial,Tandur,44,2,9,hab,9,0,16,28,35,36,7179,647,19.162285394471592,79.45681790976305,0
Telangana,Mancherial,Vemanpalle,37,0,19,hab,19,0,20,17,18,36,7177,647,19.093830441884048,79.80684870115371,0
Telangana,Medak,Alladurg,27,0,26,hab,26,0,27,0,1,36,6663,606,17.950562579753576,77.94798262727359,0
Telangana,Medak,Chegunta,51,1,42,hab,42,0,42,9,9,36,6665,606,17.97880958096529,78.50635968918517,0
Telangana,Medak,Chilipched,36,0,30,hab,28,2,35,1,6,36,7474,606,17.8575730868771,78.1291099527596,0
Telangana,Medak,Havelighanpur,44,0,32,hab,30,2,33,11,12,36,7501,606,18.1248471767459,78.24007665414098,0
Telangana,Medak,Kowdipalle,63,5,58,hab,55,3,58,5,5,36,6679,606,17.873801369636862,78.2120330545593,0
Telangana,Medak,Kulcharam,38,0,30,hab,30,0,34,4,8,36,6680,606,17.954612254067584,78.17932031523172,0
Telangana,Medak,Manoharabad,23,0,23,hab,23,0,21,2,0,36,7526,606,17.75216860707029,78.47235964103353,0
Telangana,Medak,Medak,30,0,25,hab,23,2,25,5,5,36,6682,606,18.038421887282638,78.29032190305313,0
Telangana,Medak,Narsapur,90,0,76,hab,76,0,85,5,14,36,6688,606,17.75962299320388,78.26237652108193,0
Telangana,Medak,Nizampet,26,0,21,hab,21,0,24,2,5,36,7546,606,18.120428621270957,78.53249778092493,0
Telangana,Medak,Papannapet,58,0,50,hab,50,0,55,3,8,36,6690,606,18.036267221817543,78.11096453812775,0
Telangana,Medak,Ramayampet,37,0,34,hab,34,0,35,2,3,36,6695,606,18.109535635219522,78.41772144651026,0
Telangana,Medak,Regode,28,0,25,hab,25,0,26,2,3,36,6696,606,17.96005046889478,77.85248170926796,0
Telangana,Medak,Shankarampet (A),41,0,39,hab,36,3,41,0,2,36,6699,606,18.056036875463924,77.93066181655844,0
Telangana,Medak,Shankarampet (R),51,1,38,hab,38,0,46,5,13,36,6700,606,17.9940253122845,78.38618262202182,0
Telangana,Medak,Shivampet,75,2,67,hab,66,1,71,4,8,36,6701,606,17.795585128599015,78.37699369848801,0
Telangana,Medak,Tekmal,69,0,40,hab,40,0,62,7,29,36,6703,606,17.975004545022554,78.02370403354922,0
Telangana,Medak,Tupran,37,1,30,hab,29,1,32,5,7,36,6704,606,17.845752098820142,78.49377529405349,0
Telangana,Medak,Yeldurthy,48,0,42,hab,41,1,42,6,6,36,6706,606,17.90937636816598,78.35523643474208,0
Telangana,Medchal Malkajgiri,Dundigal Gandimaisamma,21,0,5,hab,5,0,5,16,16,36,7485,662,17.576278399302407,78.4235337355281,0
Telangana,Medchal Malkajgiri,Kapra,5,0,1,hab,1,0,1,4,4,36,7510,662,17.49375774502,78.57936808822446,0
Telangana,Medchal Malkajgiri,Medchal,46,0,25,hab,25,0,30,16,21,36,7300,662,17.63668022028639,78.48066155729977,0
Telangana,Mulugu,Eturnagaram,33,0,24,hab,23,1,25,8,9,36,7692,687,18.342870243902198,80.38606526255077,0
Telangana,Mulugu,Govindaraopet,40,0,41,osm,39,2,40,0,-1,36,7715,687,18.205617069978853,80.13585614949044,0
Telangana,Mulugu,Kannaigudem,23,0,13,hab,13,0,17,6,10,36,7716,687,18.486417431110613,80.30942252207053,0
Telangana,Mulugu,Mangapet,62,0,25,hab,25,0,36,26,37,36,7717,687,18.188492285605836,80.54178956874074,0
Telangana,Mulugu,Tadvai,52,0,46,hab,40,6,44,8,6,36,7719,687,18.172529584039474,80.2871798547342,0
Telangana,Mulugu,Venkatapur,44,0,41,hab,40,1,38,6,3,36,7720,687,18.3027928000275,80.00108164043858,0
Telangana,Mulugu,Venkatapuram,72,0,33,hab,29,4,38,34,39,36,7721,687,18.30028261601179,80.64739084314368,0
Telangana,Mulugu,Wazeed,65,0,21,hab,21,0,36,29,44,36,7722,687,18.496753267368504,80.51339957732048,0
Telangana,Nagarkurnool,Achampeta,64,1,17,hab,17,0,23,41,47,36,7320,654,16.44856367769813,78.80796911629773,0
Telangana,Nagarkurnool,Amrabad,48,0,6,hab,6,0,8,40,42,36,7321,654,16.22135408534816,78.77988204910216,0
Telangana,Nagarkurnool,Balmoor,35,0,14,hab,14,0,17,18,21,36,7322,654,16.338202952257337,78.58397366038244,0
Telangana,Nagarkurnool,Bijinapalle,64,0,23,hab,23,0,34,30,41,36,7308,654,16.52816358219732,78.1904499278283,0
Telangana,Nagarkurnool,Charakonda ,30,1,16,hab,14,2,12,18,14,36,7473,654,16.703427963626574,78.6778671707152,0
Telangana,Nagarkurnool,Kodair,45,7,25,hab,25,0,32,13,20,36,7315,654,16.253243829789373,78.25268487505954,0
Telangana,Nagarkurnool,Kollapur,32,1,23,hab,22,1,24,8,9,36,7314,654,16.121658879312033,78.43321636796105,0
Telangana,Nagarkurnool,Lingal,38,2,9,hab,9,0,13,25,29,36,7323,654,16.270083770140058,78.50633117135378,0
Telangana,Nagarkurnool,Nagarkurnool,26,0,18,hab,17,1,17,9,8,36,7309,654,16.449065484490404,78.31600856153386,0
Telangana,Nagarkurnool,Padara,22,1,4,hab,4,0,5,17,18,36,7547,654,16.33267073913611,79.06520317955474,0
Telangana,Nagarkurnool,Peddakothapalle,35,0,22,hab,22,0,23,12,13,36,7310,654,16.263863758067625,78.36727101365982,0
Telangana,Nagarkurnool,Pentlavelli,12,0,7,hab,7,0,7,5,5,36,7555,654,16.057803769760795,78.2443653079248,0
Telangana,Nagarkurnool,Tadoor,35,0,20,hab,20,0,21,14,15,36,7313,654,16.575010260973023,78.34675059055805,0
Telangana,Nagarkurnool,Telkapalle,34,0,15,hab,15,0,15,19,19,36,7311,654,16.415360172513125,78.44042138768003,0
Telangana,Nagarkurnool,Thimmajipeta,56,0,20,hab,20,0,23,33,36,36,7312,654,16.658751596876712,78.21851247593648,0
Telangana,Nagarkurnool,Uppununthala,38,1,10,hab,10,0,11,27,28,36,7324,654,16.486124025409655,78.62847315752508,0
Telangana,Nagarkurnool,Urkonda,25,0,5,hab,5,0,5,20,20,36,7579,654,16.728575137165453,78.40074563059966,0
Telangana,Nagarkurnool,Vangoor,35,1,14,hab,14,0,14,21,21,36,7319,654,16.576649299136754,78.59906102555495,0
Telangana,Nagarkurnool,Veldanda,74,2,21,hab,21,0,26,48,53,36,7318,654,16.753219640839138,78.56069544227107,0
Telangana,Nalgonda,Adavidevulapally,29,0,30,osm,30,0,29,0,-1,36,7455,607,16.667174360669144,79.49281592578637,0
Telangana,Nalgonda,Anumula,42,1,6,hab,6,0,5,37,36,36,6709,607,16.82216011803195,79.29236367155288,0
Telangana,Nalgonda,Chandam Pet,72,2,25,hab,25,0,28,44,47,36,6716,607,16.50473742928241,79.03215512231836,0
Telangana,Nalgonda,Chandur,48,0,1,hab,1,0,3,45,47,36,6717,607,17.000046232092604,79.00889463339881,0
Telangana,Nalgonda,Chintha Pally,60,0,15,hab,14,1,14,46,45,36,6719,607,16.855706492668734,78.81429067595079,0
Telangana,Nalgonda,Chityal,30,0,31,osm,30,1,30,0,-1,36,6720,607,17.21248862923869,79.06887435509618,0
Telangana,Nalgonda,Dameracherla,66,0,48,hab,48,0,55,11,18,36,6723,607,16.734430808511185,79.60827679045973,0
Telangana,Nalgonda,Devarakonda,103,1,0,hab,0,0,0,103,103,36,6724,607,16.69284299967776,78.86295364375867,0
Telangana,Nalgonda,Gundla Pally,69,0,2,hab,2,0,3,66,67,36,6727,607,16.603759256508944,78.76027429799292,0
Telangana,Nalgonda,Gurrampode,65,1,7,hab,6,1,8,57,58,36,6728,607,16.84929293976143,79.10099650643731,0
Telangana,Nalgonda,Kangal,79,0,3,hab,3,0,4,75,76,36,6730,607,16.955919892724047,79.20713654165398,0
Telangana,Nalgonda,Kattangoor,45,0,8,hab,8,0,10,35,37,36,6731,607,17.19292019180905,79.31443571279104,0
Telangana,Nalgonda,Kethepally,27,0,10,hab,10,0,14,13,17,36,6732,607,17.149500344814676,79.51048822633179,0
Telangana,Nalgonda,Kondamallepally,1,0,0,hab,0,0,0,1,1,36,7516,607,16.7471412630001,78.9494950530001,1
Telangana,Nalgonda,Madugulapally,59,0,12,hab,12,0,22,37,47,36,7524,607,16.98226571100718,79.46804089886544,0
Telangana,Nalgonda,Marri Guda,48,0,3,hab,3,0,5,43,45,36,6734,607,16.98431013615134,78.87042258124292,0
Telangana,Nalgonda,Miryalaguda,104,1,51,hab,51,0,63,41,53,36,6737,607,16.86642914439883,79.57679452375801,0
Telangana,Nalgonda,Munugode,65,0,26,hab,26,0,31,34,39,36,6741,607,17.09469359398947,79.04768104282591,0
Telangana,Nalgonda,Nampalle,62,1,1,hab,1,0,3,59,61,36,6745,607,16.86147525437958,78.9524917098912,0
Telangana,Nalgonda,Narketpally,59,0,28,hab,28,0,30,29,31,36,6747,607,17.232375566677046,79.22020420554176,0
Telangana,Nalgonda,Neredugommu,40,0,4,hab,2,2,2,38,36,36,7543,607,16.574473342047085,79.03201019947043,0
Telangana,Nalgonda,Nidamanoor,55,0,12,hab,12,0,12,43,43,36,6749,607,16.83181327406756,79.38636972471971,0
Telangana,Nalgonda,Pedda Adiserlapalle,81,0,8,hab,8,0,9,72,73,36,6751,607,16.62874935268337,79.1508221753693,0
Telangana,Nalgonda,Peddavoora,55,0,13,hab,9,4,9,46,42,36,6752,607,16.703668382072237,79.22853058451967,0
Telangana,Nalgonda,Thipparthy,49,0,14,hab,14,0,24,25,35,36,6759,607,17.040286085717973,79.39890958445511,0
Telangana,Nalgonda,Thripuraram,69,0,29,hab,28,1,45,24,40,36,6761,607,16.825196828752514,79.4715874959644,0
Telangana,Nalgonda,Tirumalagiri Sagar,50,3,43,hab,40,3,38,12,7,36,7577,607,16.67487696291918,79.36721839653565,0
Telangana,Nalgonda,Vemulapally,19,0,3,hab,3,0,4,15,16,36,6765,607,16.98191823693389,79.55678344401973,0
Telangana,Narayanpet,Dhanwada,36,0,1,hab,1,0,1,35,35,36,7724,688,16.671088395872978,77.69205506120285,0
Telangana,Narayanpet,Kosgi,42,0,47,osm,43,4,40,2,-5,36,7725,688,16.967865586249903,77.70376820730958,0
Telangana,Narayanpet,Krishna,15,0,2,hab,2,0,2,13,13,36,7726,688,16.432245022754447,77.35098957016051,0
Telangana,Narayanpet,Maganoor,21,1,1,hab,1,0,1,20,20,36,7728,688,16.474746552740527,77.4463252801174,0
Telangana,Narayanpet,Makthal,45,0,0,hab,0,0,0,45,45,36,7729,688,16.472985006970795,77.56220479367778,0
Telangana,Narayanpet,Marikal,22,0,1,hab,1,0,1,21,21,36,7730,688,16.588436035715304,77.72974158269555,0
Telangana,Narayanpet,Narva,20,0,1,hab,1,0,1,19,19,36,7732,688,16.467314076539918,77.67320690635707,0
Telangana,Narayanpet,Utkoor,29,1,1,hab,1,0,1,28,28,36,7733,688,16.637806964357026,77.53225534554112,0
Telangana,Nirmal,Basar,17,0,11,hab,11,0,14,3,6,36,7467,648,18.901317298013367,77.94894588861453,0
Telangana,Nirmal,Bhainsa,34,0,38,osm,37,1,33,1,-4,36,7189,648,19.111012690428197,77.97716868174328,0
Telangana,Nirmal,Dasturabad,22,0,15,hab,15,0,16,6,7,36,7484,648,19.082760600502017,78.88958027649092,0
Telangana,Nirmal,Dilawarpur,19,0,20,osm,19,1,19,0,-1,36,7181,648,19.06417614516,78.25048631858667,0
Telangana,Nirmal,Kaddampeddur,87,6,59,hab,59,0,69,18,28,36,7182,648,19.16662458325417,78.80081523691294,0
Telangana,Nirmal,Khanapur,86,0,43,hab,42,1,80,6,43,36,7183,648,19.101662484489324,78.63739815339679,0
Telangana,Nirmal,Kubeer,69,0,57,hab,57,0,66,3,12,36,7187,648,19.240436890439994,77.94425497949138,0
Telangana,Nirmal,Kuntala,24,0,20,hab,19,1,20,4,4,36,7188,648,19.181219882786145,78.08848820866557,0
Telangana,Nirmal,Laxmanchanda,24,0,24,hab,24,0,24,0,0,36,7185,648,19.026669721277283,78.45561718597428,0
Telangana,Nirmal,Lokeshwaram,39,1,21,hab,21,0,27,12,18,36,7594,648,19.013803442989865,78.09763834440746,0
Telangana,Nirmal,Mamda,52,0,50,hab,50,0,51,1,2,36,7184,648,19.087478112781206,78.51324428754107,0
Telangana,Nirmal,Mudhole,31,0,22,hab,21,1,22,9,9,36,7190,648,18.984431635656225,77.96147810342049,0
Telangana,Nirmal,Narsapur G,25,0,24,hab,24,0,25,0,1,36,7539,648,19.134569937630893,78.16073414840066,0
Telangana,Nirmal,Nirmal Rural,24,1,23,hab,22,1,23,1,1,36,7544,648,19.104879432525347,78.35851480172855,0
Telangana,Nirmal,Pembi,55,2,45,hab,45,0,47,8,10,36,7553,648,19.222670050798133,78.62081090320828,0
Telangana,Nirmal,Sarangapur,56,0,57,osm,57,0,56,0,-1,36,7186,648,19.206970780359192,78.25905467726973,0
Telangana,Nirmal,Soan,15,0,14,hab,14,0,14,1,1,36,7570,648,19.011222888438695,78.34830885920705,0
Telangana,Nirmal,Tanur,36,0,36,hab,36,0,36,0,0,36,7191,648,19.0348236751557,77.84216076562569,0
Telangana,Nizamabad,Armur,22,0,18,hab,17,1,17,5,4,36,6767,608,18.829726198126803,78.26461819031793,0
Telangana,Nizamabad,Balkonda,10,0,10,hab,10,0,10,0,0,36,6768,608,18.891618841765492,78.3335040160601,0
Telangana,Nizamabad,Bheemgal,45,0,41,hab,40,1,43,2,4,36,6770,608,18.67869070510017,78.4755894268136,0
Telangana,Nizamabad,Bodhan,49,0,24,hab,24,0,24,25,25,36,6774,608,18.688320781396303,77.86390946609298,0
Telangana,Nizamabad,Dhar Pally,104,0,14,hab,11,3,64,40,90,36,6775,608,18.578445530399286,78.35998612407786,0
Telangana,Nizamabad,Dich Pally,54,0,30,hab,29,1,37,17,24,36,6776,608,18.620581736632182,78.22611446947032,0
Telangana,Nizamabad,Indalwai,42,4,21,hab,21,0,28,14,21,36,7503,608,18.5224322681988,78.26988915467558,0
Telangana,Nizamabad,Jakranpalle,29,0,13,hab,13,0,13,16,16,36,6779,608,18.710690931810845,78.27853093784171,0
Telangana,Nizamabad,Kammar Palle,23,0,12,hab,12,0,17,6,11,36,6782,608,18.772714089481983,78.54161842478989,0
Telangana,Nizamabad,Kotgiri,50,0,39,hab,39,0,48,2,11,36,6783,608,18.57960423812795,77.79494585130067,0
Telangana,Nizamabad,Makloor,63,0,6,hab,6,0,6,57,57,36,6787,608,18.75828698729501,78.14940840125351,0
Telangana,Nizamabad,Mendora,13,0,8,hab,8,0,9,4,5,36,7531,608,18.95843388662138,78.4003185991499,0
Telangana,Nizamabad,Mortad,16,1,10,hab,10,0,10,6,6,36,6788,608,18.83163100089125,78.45370215808836,0
Telangana,Nizamabad,Mugpal,40,0,23,hab,22,1,31,9,17,36,7535,608,18.55834927680846,78.11249363706159,0
Telangana,Nizamabad,Mupkal,7,0,7,hab,7,0,7,0,0,36,7536,608,18.911634871453657,78.38479043223361,0
Telangana,Nizamabad,Nandipet,40,0,31,hab,31,0,32,8,9,36,6790,608,18.916510908480426,78.17359754133108,0
Telangana,Nizamabad,Navipet,60,0,34,hab,33,1,41,19,26,36,6791,608,18.827476883488917,78.02269926341236,0
Telangana,Nizamabad,Nizamabad,1,0,1,hab,1,0,1,0,0,36,6793,608,18.605375704,78.1712271430001,1
Telangana,Nizamabad,Nizamabad Rural,34,0,3,hab,3,0,3,31,31,36,7545,608,18.673679492193017,78.06445469531863,0
Telangana,Nizamabad,Ranjal,19,0,10,hab,10,0,10,9,9,36,6795,608,18.770864522141267,77.93689346388275,0
Telangana,Nizamabad,Rudrur,17,0,14,hab,14,0,14,3,3,36,7565,608,18.582775877217557,77.87091347241866,0
Telangana,Nizamabad,Sirkonda,115,40,23,hab,22,1,36,79,92,36,6797,608,18.551356397820012,78.49172257646212,0
Telangana,Nizamabad,Varni,1,0,0,hab,0,0,0,1,1,36,6799,608,18.6273425769441,77.9415740343408,1
Telangana,Nizamabad,Velpur,20,0,21,osm,20,1,20,0,-1,36,6800,608,18.76907121677966,78.39021797866975,0
Telangana,Nizamabad,Yeda Palle,25,1,1,hab,1,0,2,23,24,36,6801,608,18.67869974692901,77.98573170288523,0
Telangana,Nizamabad,Yergatla,12,0,7,hab,7,0,9,3,5,36,7584,608,18.92461953228755,78.48329803025001,0
Telangana,Peddapalli,Anthergoan,21,0,18,hab,18,0,21,0,3,36,7464,650,18.798650246830174,79.39279128086525,0
Telangana,Peddapalli,Dharmaram,44,0,39,hab,38,1,42,2,5,36,7330,650,18.700033375353826,79.21827839294743,0
Telangana,Peddapalli,Eligaid,16,0,13,hab,13,0,14,2,3,36,7329,650,18.56056510911788,79.27040256122623,0
Telangana,Peddapalli,Julapalle,16,0,16,hab,16,0,16,0,0,36,7328,650,18.62811915466034,79.2559300278092,0
Telangana,Peddapalli,Kamanpur,22,0,14,hab,14,0,18,4,8,36,7333,650,18.658980993358895,79.49689051004495,0
Telangana,Peddapalli,Manthani,51,0,51,hab,48,3,49,2,0,36,7334,650,18.64502457729727,79.69931410471234,0
Telangana,Peddapalli,Mutharam Manthani,25,0,24,hab,23,1,23,2,1,36,7335,650,18.532467073525968,79.64171652402494,0
Telangana,Peddapalli,Odela,32,0,26,hab,26,0,28,4,6,36,7326,650,18.45187469723483,79.44879172266974,0
Telangana,Peddapalli,Peddapalle,47,0,37,hab,37,0,38,9,10,36,7325,650,18.619611843080964,79.39772783167835,0
Telangana,Peddapalli,Ramagiri,24,0,19,hab,19,0,20,4,5,36,7561,650,18.64369344068833,79.56110980567789,0
Telangana,Peddapalli,Srirampur,36,0,34,hab,34,0,36,0,2,36,7332,650,18.50260176910502,79.5213116581426,0
Telangana,Peddapalli,Sultanabad,44,0,39,hab,38,1,38,6,5,36,7327,650,18.510918700140373,79.31940031933256,0
Telangana,Rajanna Sircilla,Boinpalle,31,0,14,hab,13,1,18,13,17,36,7340,651,18.47994805946453,78.94068004971757,0
Telangana,Rajanna Sircilla,Chandurthi,25,0,5,hab,5,0,7,18,20,36,7339,651,18.570586663474185,78.75337296392851,0
Telangana,Rajanna Sircilla,Gambhiraopet,34,0,11,hab,11,0,13,21,23,36,7337,651,18.317544383925224,78.58076157959222,0
Telangana,Rajanna Sircilla,Konaraopeta,44,0,2,hab,2,0,2,42,42,36,7343,651,18.49027338566699,78.70862029846798,0
Telangana,Rajanna Sircilla,Mustabad,29,0,7,hab,7,0,7,22,22,36,7342,651,18.288069865550902,78.70383984767757,0
Telangana,Rajanna Sircilla,Thangallapalli,41,0,1,hab,1,0,1,40,40,36,7574,651,18.337064544520857,78.82860597309667,0
Telangana,Rajanna Sircilla,Veernapalli,30,1,1,hab,1,0,3,27,29,36,7581,651,18.487727586021403,78.58959618730144,0
Telangana,Rajanna Sircilla,Vemulawada,41,1,7,hab,6,1,16,25,34,36,7338,651,18.471476564667537,78.86347624397767,0
Telangana,Rajanna Sircilla,Vemulawada Rural,21,0,3,hab,2,1,3,18,18,36,7583,651,18.51590660608039,78.85026735850943,0
Telangana,Rajanna Sircilla,Yella Reddi Peta,35,0,18,hab,18,0,29,6,17,36,7341,651,18.39701870392107,78.65743941375703,0
Telangana,Ranga Reddy,Abdullapurmet,54,0,27,hab,26,1,24,30,27,36,7454,609,17.31526466971867,78.66137018224583,0
Telangana,Ranga Reddy,Amangal,42,1,22,hab,22,0,28,14,20,36,7489,609,16.858282976040872,78.5561285662035,0
Telangana,Ranga Reddy,Chevella,52,0,49,hab,49,0,50,2,3,36,6806,609,17.319313848617025,78.11596568241782,0
Telangana,Ranga Reddy,Chowdergudem,33,0,10,hab,9,1,9,24,23,36,7480,609,17.060094211091286,77.9859329061873,0
Telangana,Ranga Reddy,Farooqnagar,111,1,22,hab,22,0,30,81,89,36,7490,609,17.036491944581794,78.18807067056913,0
Telangana,Ranga Reddy,Gandipet,19,0,10,hab,9,1,10,9,9,36,7487,609,17.383529103019317,78.33851614339285,0
Telangana,Ranga Reddy,Ibrahimpatam,35,1,31,hab,30,1,26,9,4,36,6812,609,17.20315414738648,78.65062316518888,0
Telangana,Ranga Reddy,Kadthal,1,0,0,hab,0,0,0,1,1,36,7505,609,16.8787676100001,78.3826059680001,1
Telangana,Ranga Reddy,Kandukur,63,2,45,hab,42,3,45,18,18,36,6813,609,17.074794681264414,78.50253719858128,0
Telangana,Ranga Reddy,Keshampeta,58,0,26,hab,26,0,31,27,32,36,7491,609,16.9634871627004,78.33490274583623,0
Telangana,Ranga Reddy,Kondurg,46,12,20,hab,20,0,21,25,26,36,7492,609,17.097110972293695,78.05469054672172,0
Telangana,Ranga Reddy,Madgul,66,6,30,hab,28,2,42,24,36,36,7494,609,16.838795261699794,78.699470190762,0
Telangana,Ranga Reddy,Maheswaram,63,1,45,hab,43,2,45,18,18,36,6816,609,17.151304678785376,78.41985007736491,0
Telangana,Ranga Reddy,Manchal,36,1,32,hab,32,0,35,1,4,36,6818,609,17.107406162135156,78.75433681599296,0
Telangana,Ranga Reddy,Moinabad,40,0,37,hab,37,0,39,1,3,36,6821,609,17.318442385920527,78.2693650836965,0
Telangana,Ranga Reddy,Nandigama,37,0,26,hab,26,0,27,10,11,36,7538,609,17.134478745323023,78.23743679385517,0
Telangana,Ranga Reddy,Shabad,71,0,68,hab,68,0,70,1,3,36,6831,609,17.184533003229145,78.14158546005903,0
Telangana,Ranga Reddy,Shamshabad,64,0,36,hab,36,0,39,25,28,36,6833,609,17.232816156532905,78.34633110667431,0
Telangana,Ranga Reddy,Shankarpalle,51,0,41,hab,41,0,44,7,10,36,6834,609,17.43169747715578,78.14616334163178,0
Telangana,Ranga Reddy,Talakondapalle,61,0,22,hab,22,0,25,36,39,36,7495,609,16.859728647541974,78.41751581413108,0
Telangana,Ranga Reddy,Yacharam,45,0,40,hab,37,3,39,6,5,36,6838,609,17.025667290512754,78.66265360649255,0
Telangana,Sangareddy,Ameenpur,17,0,12,hab,12,0,13,4,5,36,7461,656,17.541941062484113,78.3138494964668,0
Telangana,Sangareddy,Andole,35,0,33,hab,33,0,33,2,2,36,7352,656,17.833237265544156,78.0355037246453,0
Telangana,Sangareddy,Gummadidala,20,1,10,hab,10,0,10,10,10,36,7499,656,17.69005655687226,78.37356000292871,0
Telangana,Sangareddy,Jharasangam,39,0,39,hab,39,0,39,0,0,36,7356,656,17.746948090904105,77.71069689720801,0
Telangana,Sangareddy,Kalher,44,1,30,hab,30,0,39,5,14,36,7361,656,18.148737935536893,77.84742873082259,0
Telangana,Sangareddy,Kangti,59,2,30,hab,30,0,37,22,29,36,7360,656,18.215189748375636,77.64669751689021,0
Telangana,Sangareddy,Kohir,30,0,27,hab,26,1,26,4,3,36,7357,656,17.5972776458658,77.69815962135421,0
Telangana,Sangareddy,Kondapur,38,0,37,hab,37,0,38,0,1,36,7345,656,17.538066325842134,78.01527167324808,0
Telangana,Sangareddy,Manoor,29,0,27,hab,24,3,25,4,2,36,7362,656,17.959922658851273,77.74298150392822,0
Telangana,Sangareddy,Munpalle,31,0,33,osm,33,0,31,0,-2,36,7349,656,17.714115108652276,77.84709459217396,0
Telangana,Sangareddy,Nagiligidda,63,3,20,hab,20,0,23,40,43,36,7604,656,18.050829066595444,77.63347026369071,0
Telangana,Sangareddy,Nyalkal,41,0,40,hab,39,1,39,2,1,36,7355,656,17.846276939259383,77.62209838281017,0
Telangana,Sangareddy,Pulkal,45,0,43,hab,43,0,42,3,2,36,7351,656,17.732039380161293,78.03275249648826,0
Telangana,Sangareddy,Raikode,35,0,36,osm,35,1,33,2,-1,36,7358,656,17.84478419789055,77.77861219703613,0
Telangana,Sangareddy,Ramachandrapuram,14,3,9,hab,9,0,8,6,5,36,7348,656,17.47094145518403,78.26201063351562,0
Telangana,Sangareddy,Sadasivpet,34,0,36,osm,36,0,32,2,-2,36,7346,656,17.645617154175348,77.95282827051365,0
Telangana,Sangareddy,Sangareddy,25,0,22,hab,22,0,25,0,3,36,7344,656,17.62199013684866,78.09757384577972,0
Telangana,Sangareddy,Sirgapoor,48,0,21,hab,20,1,27,21,27,36,7568,656,18.14322509186467,77.72149633264803,0
Telangana,Sangareddy,Vatpally,60,2,24,hab,24,0,54,6,36,36,7580,656,17.875539729170985,77.90144499856846,0
Telangana,Sangareddy,Zahirabad,33,0,33,hab,32,1,32,1,0,36,7354,656,17.66871686070311,77.59355666971096,0
Telangana,Siddipet,Akkannapet,95,0,63,hab,62,1,85,10,32,36,7457,657,18.048551913041486,79.18880627914237,0
Telangana,Siddipet,Bejjenki,39,0,30,hab,28,2,29,10,9,36,7365,657,18.26010871309948,79.03186457246659,0
Telangana,Siddipet,Cheriyal,40,1,24,hab,24,0,34,6,16,36,7377,657,17.924599339132385,78.96601269980728,0
Telangana,Siddipet,Chinna Kodur,198,0,36,hab,32,4,180,18,162,36,7368,657,18.18158688010921,78.92155249375004,0
Telangana,Siddipet,Doultabad,26,1,28,osm,23,5,22,4,-2,36,7369,657,17.97001794564606,78.5809358171893,0
Telangana,Siddipet,Dubbak,44,0,41,hab,40,1,39,5,3,36,7371,657,18.176795867478752,78.6501168263575,0
Telangana,Siddipet,Gajwel,40,1,34,hab,34,0,35,5,6,36,7372,657,17.869969600123827,78.6923349310545,0
Telangana,Siddipet,Husnabad,32,0,20,hab,20,0,23,9,12,36,7363,657,18.129716216943784,79.22048350013053,0
Telangana,Siddipet,Jagdevpur,33,0,30,hab,27,3,30,3,3,36,7373,657,17.80291246775169,78.81305954266803,0
Telangana,Siddipet,Koheda,50,0,35,hab,35,0,35,15,15,36,7364,657,18.160614231426766,79.08377666409469,0
Telangana,Siddipet,Komuravelli,13,0,9,hab,9,0,10,3,4,36,7515,657,17.921214286683533,78.8885750536805,0
Telangana,Siddipet,Kondapak,50,0,41,hab,41,0,41,9,9,36,7374,657,17.970917625507855,78.84060431792275,0
Telangana,Siddipet,Maddur,50,1,48,hab,47,1,46,4,2,36,7378,657,17.953751223106746,79.07027309071024,0
Telangana,Siddipet,Mirdoddi,25,0,23,hab,23,0,22,3,2,36,7370,657,18.074152382979868,78.64623829837585,0
Telangana,Siddipet,Mulug,35,0,29,hab,29,0,30,5,6,36,7375,657,17.71665973511074,78.6172102667134,0
Telangana,Siddipet,Nanganur,40,6,29,hab,29,0,30,10,11,36,7367,657,18.06812947645469,79.01224352287032,0
Telangana,Siddipet,Raipole,145,0,25,hab,24,1,138,7,120,36,7557,657,17.908662492519138,78.61781045645073,0
Telangana,Siddipet,Siddipet Rural,19,0,19,hab,18,1,18,1,0,36,7566,657,18.144747640293577,78.77362343307512,0
Telangana,Siddipet,Siddipet Urban,1,0,0,hab,0,0,0,1,1,36,7567,657,18.173830847,78.7289921080001,1
Telangana,Siddipet,Thoguta,29,0,33,osm,28,5,28,1,-4,36,7576,657,18.008893470845145,78.73923042082326,0
Telangana,Siddipet,Wargal,41,0,34,hab,34,0,35,6,7,36,7376,657,17.787125967534426,78.5857533576813,0
Telangana,Suryapet,Ananthagiri,24,0,23,hab,23,0,22,2,1,36,7462,659,17.054794732448464,79.97625331863804,0
Telangana,Suryapet,Atmakur  (S),61,0,21,hab,21,0,24,37,40,36,7379,659,17.256691502726483,79.70136868486537,0
Telangana,Suryapet,Chilkur,20,0,18,hab,17,1,19,1,2,36,7389,659,16.969626370105864,79.87178164259599,0
Telangana,Suryapet,Chinthalapalem,19,0,17,hab,10,7,11,8,2,36,7479,659,16.73328479242224,79.9851035881964,0
Telangana,Suryapet,Garide Pally,51,0,53,osm,53,0,51,0,-2,36,7387,659,16.90610445161233,79.76043703675093,0
Telangana,Suryapet,Huzurnagar,20,0,18,hab,18,0,18,2,2,36,7390,659,16.880549870285105,79.85345081268451,0
Telangana,Suryapet,Kodad,28,0,22,hab,21,1,20,8,6,36,7391,659,16.953704564513885,79.98423459708643,0
Telangana,Suryapet,Maddirala,31,0,7,hab,7,0,7,24,24,36,7523,659,17.407078859076908,79.70088224772154,0
Telangana,Suryapet,Mattampally,46,1,29,hab,27,2,29,17,17,36,7392,659,16.75922073287889,79.85189192427433,0
Telangana,Suryapet,Mellachervu,20,0,20,hab,19,1,18,2,0,36,7393,659,16.829451378515472,79.95112350485913,0
Telangana,Suryapet,Mothey,45,0,35,hab,35,0,35,10,10,36,7381,659,17.20214767585671,79.81315121901979,0
Telangana,Suryapet,Munagala,32,0,27,hab,27,0,27,5,5,36,7394,659,17.06288041638116,79.82092183960084,0
Telangana,Suryapet,Nadigudem,19,0,21,osm,20,1,19,0,-2,36,7395,659,17.108740476793496,79.88305484571767,0
Telangana,Suryapet,Nered Cherla,49,0,39,hab,37,2,39,10,10,36,7388,659,16.9077247384954,79.669986562713,0
Telangana,Suryapet,Nuthankal,35,1,6,hab,6,0,6,29,29,36,7382,659,17.332211116315694,79.71388714162907,0
Telangana,Suryapet,Palakeedu,29,0,29,hab,28,1,27,2,0,36,7548,659,16.763250052672614,79.71905254118204,0
Telangana,Suryapet,Penpahad,49,0,28,hab,28,0,31,18,21,36,7383,659,17.024966754897186,79.69076859519366,0
Telangana,Suryapet,Suryapet,60,0,9,hab,9,0,11,49,51,36,7384,659,17.175611005038384,79.58738907845915,0
Telangana,Suryapet,Thirumalagiri,41,0,1,hab,0,1,0,41,40,36,7385,659,17.48003248465756,79.4752555435872,0
Telangana,Suryapet,Thunga Thurthy,55,0,2,hab,2,0,2,53,53,36,7386,659,17.42048079326107,79.59960438729567,0
Telangana,Vikarabad,Bantaram,14,0,14,hab,12,2,14,0,0,36,7407,663,17.43959845225934,77.68851658693896,0
Telangana,Vikarabad,Basheerabad,58,0,41,hab,41,0,52,6,17,36,7410,663,17.19483944283026,77.45101448740633,0
Telangana,Vikarabad,Bomraspeta,98,0,33,hab,32,1,53,45,65,36,7397,663,17.134623455897493,77.71310664299526,0
Telangana,Vikarabad,Dharur,55,4,43,hab,43,0,45,10,12,36,7406,663,17.303539066037647,77.7831007888839,0
Telangana,Vikarabad,Doma,91,1,35,hab,35,0,61,30,56,36,7404,663,17.084275939679912,77.82617180604313,0
Telangana,Vikarabad,Doulatabad,59,0,57,hab,54,3,58,1,2,36,7598,663,16.98846156503729,77.56161437554557,0
Telangana,Vikarabad,Kodangal,47,1,46,hab,44,2,45,2,1,36,7396,663,17.097041962393074,77.57202874305642,0
Telangana,Vikarabad,Kotepally,21,0,19,hab,17,2,18,3,2,36,7517,663,17.413472691204287,77.7739849646127,0
Telangana,Vikarabad,Kulkacharla,120,1,90,hab,90,0,106,14,30,36,7403,663,17.00305617840303,77.89884222848494,0
Telangana,Vikarabad,Marpalle,35,1,37,osm,37,0,34,1,-2,36,7398,663,17.54088208850442,77.78585875143172,0
Telangana,Vikarabad,Mominpet,36,0,32,hab,32,0,35,1,4,36,7399,663,17.505379163676963,77.90096176526,0
Telangana,Vikarabad,Nawabpet,36,2,31,hab,31,0,32,4,5,36,7400,663,17.42353644510702,77.97771650739858,0
Telangana,Vikarabad,Peddemul,48,0,50,osm,50,0,48,0,-2,36,7408,663,17.360558526502246,77.62875398815883,0
Telangana,Vikarabad,Pudur,45,0,42,hab,42,0,44,1,3,36,7402,663,17.235391378564938,77.99211914795774,0
Telangana,Vikarabad,Tandur,42,0,45,osm,43,2,42,0,-3,36,7411,663,17.303612061608305,77.53964942681709,0
Telangana,Vikarabad,Vikarabad,33,0,37,osm,32,5,30,3,-4,36,7401,663,17.337417515686187,77.90041817149523,0
Telangana,Vikarabad,Yelal,51,2,43,hab,42,1,46,5,8,36,7409,663,17.210797126435,77.63726831992572,0
Telangana,Wanaparthy,Amarchintha,18,0,8,hab,8,0,7,11,10,36,7460,655,16.381308854687365,77.73524098662578,0
Telangana,Wanaparthy,Chinnambavi,19,0,12,hab,11,1,12,7,7,36,7477,655,16.02257017461784,78.15735432464571,0
Telangana,Wanaparthy,Ghanpur,49,4,33,hab,33,0,42,7,16,36,7415,655,16.55517778394098,78.05452329311397,0
Telangana,Wanaparthy,Gopalpeta,20,0,18,hab,17,1,17,3,2,36,7413,655,16.394896110371068,78.14937737057187,0
Telangana,Wanaparthy,Kothakota,34,0,22,hab,21,1,25,9,12,36,7419,655,16.33926096094395,77.93858071592528,0
Telangana,Wanaparthy,Pangal,34,0,32,hab,29,3,33,1,2,36,7416,655,16.248207831343965,78.13467245031069,0
Telangana,Wanaparthy,Pebbair,24,0,20,hab,19,1,19,5,4,36,7417,655,16.154360596351733,77.99183590578126,0
Telangana,Wanaparthy,Peddamandadi,41,0,26,hab,22,4,34,7,15,36,7414,655,16.448876121627166,78.02153246351703,0
Telangana,Wanaparthy,Revally,4,0,8,osm,3,5,2,2,-4,36,7563,655,16.416400833104742,78.14588631621048,1
Telangana,Wanaparthy,Srirangapur,10,0,11,osm,11,0,10,0,-1,36,7571,655,16.19507041860201,78.0386672708827,0
Telangana,Wanaparthy,Wanaparthy,58,0,55,hab,51,4,51,7,3,36,7412,655,16.33955629550068,78.04934723359597,0
Telangana,Wanaparthy,Weepangandla,1,0,1,hab,1,0,1,0,0,36,7418,655,16.0505995926392,78.1600152536994,1
Telangana,Warangal,Atmakur,20,0,18,hab,18,0,19,1,2,36,6840,610,18.06260551246568,79.74028467149563,0
Telangana,Warangal,Chennaraopet,80,1,48,hab,48,0,58,22,32,36,6843,610,17.850876506366358,79.85658096110531,0
Telangana,Warangal,Damera,15,0,14,hab,14,0,15,0,1,36,7482,610,18.079653999561323,79.6547246802856,0
Telangana,Warangal,Duggondi,53,0,46,hab,46,0,51,2,7,36,6849,610,17.99917141703979,79.80639448702546,0
Telangana,Warangal,Geesugonda,42,0,42,hab,39,3,39,3,0,36,6851,610,17.966169459278383,79.70417210593673,0
Telangana,Warangal,Khanapur,38,3,29,hab,28,1,34,4,9,36,6860,610,17.922356847159396,79.95131687062597,0
Telangana,Warangal,Nadikuda,19,0,19,hab,19,0,19,0,0,36,7603,610,18.20420448064821,79.62879118404281,0
Telangana,Warangal,Nallabelly,56,0,41,hab,40,1,47,9,15,36,6871,610,18.05593799637675,79.9175321764859,0
Telangana,Warangal,Nekkonda,109,1,43,hab,39,4,53,56,66,36,6875,610,17.780529657557853,79.81768620081881,0
Telangana,Warangal,Parkal,13,0,13,hab,13,0,13,0,0,36,6878,610,18.200381907925486,79.68986180189935,0
Telangana,Warangal,Parvathagiri,106,0,63,hab,62,1,78,28,43,36,6879,610,17.768688237957452,79.7198088554163,0
Telangana,Warangal,Raiparthy,108,0,78,hab,78,0,92,16,30,36,6881,610,17.684671492731795,79.59842945854089,0
Telangana,Warangal,Sangem,61,2,56,hab,56,0,57,4,5,36,6883,610,17.879197659686334,79.70760548204035,0
Telangana,Warangal,Shayampet,26,0,25,hab,24,1,26,0,1,36,6884,610,18.13649174340553,79.75716585814688,0
Telangana,Warangal,Wardhannapet,40,0,33,hab,33,0,33,7,7,36,6888,610,17.7730807103206,79.58472003882618,0
Telangana,Warangal Urban,Bheemadevarpalle,41,0,33,hab,33,0,33,8,8,36,7434,666,18.08110498154049,79.3310318542912,0
Telangana,Warangal Urban,Dharmasagar,32,0,27,hab,27,0,28,4,5,36,7437,666,17.972050545426228,79.41597724854344,0
Telangana,Warangal Urban,Elkathurthi,23,0,21,hab,20,1,19,4,2,36,7433,666,18.113284382375028,79.44974218025713,0
Telangana,Warangal Urban,Inavolu,60,0,29,hab,29,0,55,5,31,36,7502,666,17.86262174950628,79.547156866011,0
Telangana,Warangal Urban,Kamalapur,333,0,35,hab,35,0,324,9,298,36,7435,666,18.187414627008053,79.53980426800034,0
Telangana,Warangal Urban,Velair,28,0,26,hab,25,1,27,1,2,36,7582,666,17.990617210921233,79.31914441535946,0
Telangana,Yadadri Bhongiri,Adda Gudur,18,0,2,hab,2,0,2,16,16,36,7456,660,17.4019662039414,79.37292262835231,0
Telangana,Yadadri Bhongiri,Alair,24,0,23,hab,22,1,21,3,1,36,7421,660,17.648442972172557,79.076153320292,0
Telangana,Yadadri Bhongiri,Atmakur (M),44,0,5,hab,5,0,5,39,39,36,7428,660,17.469517080764078,79.16535294528937,0
Telangana,Yadadri Bhongiri,Bhuvanagiri,65,0,30,hab,28,2,28,37,35,36,7600,660,17.49970191323705,78.92281828865877,0
Telangana,Yadadri Bhongiri,Bibinagar,69,0,33,hab,33,0,33,36,36,36,7426,660,17.459750888241093,78.80207826145404,0
Telangana,Yadadri Bhongiri,Bommalaramaram,53,0,5,hab,5,0,5,48,48,36,7427,660,17.57655909755422,78.75439707266239,0
Telangana,Yadadri Bhongiri,Choutuppal,47,0,58,osm,47,11,39,8,-11,36,7431,660,17.26800877141976,78.88554782708349,0
Telangana,Yadadri Bhongiri,Mothkur,1,0,0,hab,0,0,0,1,1,36,7423,660,17.3635944100001,79.4212945950001,1
Telangana,Yadadri Bhongiri,Narayanapur,55,0,71,osm,62,9,52,3,-16,36,7432,660,17.146385728433234,78.87891143545272,0
Telangana,Yadadri Bhongiri,Pochampally,43,0,43,hab,43,0,41,2,0,36,7601,660,17.353523766597267,78.81553020275818,0
Telangana,Yadadri Bhongiri,Rajapet,32,0,23,hab,23,0,29,3,9,36,7422,660,17.736391749028233,78.93228269589109,0
Telangana,Yadadri Bhongiri,Ramannapeta,39,0,40,osm,39,1,38,1,-1,36,7429,660,17.308785523726296,79.11994842985732,0
Telangana,Yadadri Bhongiri,Thurkapally,57,0,6,hab,6,0,6,51,51,36,7424,660,17.66181898443368,78.82378466463577,0
Telangana,Yadadri Bhongiri,Valigonda,85,0,26,hab,25,1,23,62,59,36,7430,660,17.390128623241697,79.04210883345593,0
Telangana,Yadadri Bhongiri,Yadagirigutta,35,0,26,hab,25,1,24,11,9,36,7425,660,17.61210738955916,78.95979329660548,0
Tripura,Dhalai,Ambassa,134,1,1,hab,1,0,2,132,133,32,134,144,23.894900159241846,91.86280221996925,0
Tripura,Dhalai,Chawmanu,131,4,1,hab,1,0,7,124,130,32,1212,144,23.79260244767158,92.05583639762341,0
Tripura,Dhalai,Dumburnagar,141,1,1,hab,1,0,6,135,140,32,1698,144,23.612765706296475,91.8513959127766,0
Tripura,Dhalai,Durga Chowmuhani,177,0,2,hab,2,0,12,165,175,32,7607,144,24.154809253499874,91.81913932160549,0
Tripura,Dhalai,Ganganagar,64,0,1,hab,1,0,7,57,63,32,7605,144,23.75599271665972,91.86923662280411,0
Tripura,Dhalai,Manu,252,0,1,hab,1,0,7,245,251,32,3713,144,23.995954416931795,92.0195661348128,0
Tripura,Dhalai,Raisyabari,78,0,1,hab,1,0,11,67,77,32,7606,144,23.4921852254574,91.88845081150755,0
Tripura,Dhalai,Salema,116,0,1,hab,1,0,6,110,115,32,5301,144,24.03328745655407,91.83121005437097,0
Tripura,Gomati,Amarpur,201,0,1,hab,1,0,6,195,200,32,7621,669,23.50778122219811,91.7034513072302,0
Tripura,Gomati,Kakraban,128,0,1,hab,1,0,8,120,127,32,7623,669,23.45781981036474,91.42305749505326,0
Tripura,Gomati,Karbook,228,0,1,hab,1,0,7,221,227,32,7624,669,23.37529324885615,91.76401604391798,0
Tripura,Gomati,Killa,92,2,1,hab,1,0,6,86,91,32,7620,669,23.615853857813487,91.53090726414445,0
Tripura,Gomati,Matarbari,184,1,0,hab,0,0,0,184,184,32,7618,669,23.47024498618216,91.53252030587221,0
Tripura,Gomati,Ompi,161,0,1,hab,1,0,9,152,160,32,7622,669,23.678800496165294,91.65791648649785,0
Tripura,Gomati,Shilachari,58,1,1,hab,1,0,9,49,57,32,7625,669,23.17948559019713,91.77967219286352,0
Tripura,Gomati,Tepania,100,1,0,hab,0,0,0,100,100,32,7619,669,23.550803777358503,91.44219990704866,0
Tripura,Khowai,Kalyanpur,159,2,1,hab,1,0,9,150,158,32,7629,670,23.92855485763184,91.61177019639511,0
Tripura,Khowai,Khowai,170,3,1,hab,1,0,11,159,169,32,7628,670,24.042020091136195,91.62229759865015,0
Tripura,Khowai,Mungiakami,187,0,1,hab,1,0,6,181,186,32,7627,670,23.84223227484553,91.72463846817875,0
Tripura,Khowai,Padmabil,224,0,0,hab,0,0,0,224,224,32,7630,670,24.012335689225157,91.54608298444712,0
Tripura,Khowai,Teliamura,230,2,0,hab,0,0,0,230,230,32,7626,670,23.82169930675367,91.61523032756638,0
Tripura,Khowai,Tulasikhar,196,0,1,hab,1,0,10,186,195,32,7631,670,24.071641520926843,91.70018653457241,0
Tripura,North Tripura,Damcherra,87,0,1,hab,1,0,10,77,86,32,1413,406,24.180406944568563,92.26644426058641,0
Tripura,North Tripura,Dasda,144,3,5,hab,5,0,23,121,139,32,1457,406,23.864895229393184,92.20284952950757,0
Tripura,North Tripura,Jampuihill,27,6,4,hab,4,0,4,23,23,32,2427,406,23.96425550595942,92.2832347761481,0
Tripura,North Tripura,Jubarajnagar,126,0,0,hab,0,0,0,126,126,32,7610,406,24.33110872357642,92.14493080468912,0
Tripura,North Tripura,Kadamtala,86,0,2,hab,2,0,8,78,84,32,2560,406,24.466966541873283,92.19798254456148,0
Tripura,North Tripura,Kalachara,76,1,0,hab,0,0,0,76,76,32,7609,406,24.393270178661737,92.19568085945184,0
Tripura,North Tripura,Laljuri,82,1,7,hab,6,1,9,73,75,32,7608,406,24.078446852102164,92.19613585342229,0
Tripura,North Tripura,Panisagar,77,0,0,hab,0,0,0,77,77,32,4520,406,24.272410301422457,92.17918384200189,0
Tripura,Sepahijala,Bishalghar,249,4,0,hab,0,0,0,249,249,32,7636,671,23.698166229664153,91.24671543497612,0
Tripura,Sepahijala,Boxanagar,112,1,1,hab,1,0,9,103,111,32,7641,671,23.567232256755194,91.21981564070083,0
Tripura,Sepahijala,Charilam,125,3,0,hab,0,0,0,125,125,32,7637,671,23.613396210648688,91.2925662489285,0
Tripura,Sepahijala,Jampaijala,421,5,1,hab,1,0,11,410,420,32,7638,671,23.691169205027933,91.43142674261539,0
Tripura,Sepahijala,Kathalia,161,4,1,hab,1,0,7,154,160,32,7639,671,23.37509737695236,91.32752304227232,0
Tripura,Sepahijala,Mohanbhog,82,0,0,hab,0,0,0,82,82,32,7643,671,23.454082806609282,91.34768149514271,0
Tripura,Sepahijala,Nalchar,145,0,0,hab,0,0,0,145,145,32,7642,671,23.538645689819393,91.32856323311121,0
Tripura,South Tripura,Bagafa,213,0,1,hab,1,0,15,198,212,32,370,526,23.34689542357619,91.59107150933497,0
Tripura,South Tripura,Bharat chandranagar,95,2,0,hab,0,0,0,95,95,32,7616,526,23.31002143518351,91.46102001278511,0
Tripura,South Tripura,Hrishyamukh,154,0,1,hab,1,0,4,150,153,32,2251,526,23.16712696993738,91.53600634513843,0
Tripura,South Tripura,Jolaibari,240,0,1,hab,1,0,11,229,239,32,7615,526,23.23445155551723,91.65395167418815,0
Tripura,South Tripura,Poyangbari,53,4,0,hab,0,0,0,53,53,32,7617,526,23.02793350630186,91.583270073355,0
Tripura,South Tripura,Rajnagar,150,0,1,hab,1,0,9,141,149,32,4988,526,23.215333148069444,91.36989801898204,0
Tripura,South Tripura,Rupaichari,159,0,1,hab,1,0,7,152,158,32,5211,526,23.10706650530963,91.73088472173387,0
Tripura,South Tripura,Satchand,265,0,2,hab,2,0,9,256,263,32,5436,526,23.060373746392106,91.650421224306,0
Tripura,Unakoti,Chandipur,92,0,0,hab,0,0,0,92,92,32,7612,668,24.266765283880005,91.96918146735439,0
Tripura,Unakoti,Gournagar,120,1,0,hab,0,0,0,120,120,32,7611,668,24.316126889858786,92.03629614031964,0
Tripura,Unakoti,Kumarghat,174,0,0,hab,0,0,0,174,174,32,7613,668,24.150669723250495,92.0069658394795,0
Tripura,Unakoti,Pencharthal,82,0,2,hab,1,1,4,78,80,32,7614,668,24.167770974060904,92.12839009359338,0
Tripura,West Tripura,Bamutia,110,2,1,hab,1,0,7,103,109,32,7632,596,23.917821200562038,91.2833900393473,0
Tripura,West Tripura,Belbari,199,1,1,hab,1,0,10,189,198,32,7634,596,23.78311003164857,91.48330161087183,0
Tripura,West Tripura,Dukli,195,3,1,hab,1,0,2,193,194,32,1690,596,23.79863693068625,91.28902276425023,0
Tripura,West Tripura,Hezamara,306,2,1,hab,1,0,9,297,305,32,2209,596,24.00298247901728,91.46052566233196,0
Tripura,West Tripura,Jirania,131,1,1,hab,1,0,3,128,130,32,2512,596,23.831927547279207,91.43443298552177,0
Tripura,West Tripura,Lefunga,84,0,0,hab,0,0,0,84,84,32,7633,596,23.9125721288898,91.36777767266818,0
Tripura,West Tripura,Mandai,261,0,1,hab,1,0,10,251,260,32,3633,596,23.876584268206724,91.4763953473607,0
Tripura,West Tripura,Mohanpur,128,2,1,hab,1,0,5,123,127,32,3890,596,23.99695522467703,91.37057604323616,0
Tripura,West Tripura,Old Agartala,101,0,1,hab,1,0,9,92,100,32,7635,596,23.81976010125542,91.36207042542772,0
Uttar Pradesh,Agra,Achhnera,103,1,106,osm,100,6,102,1,-3,33,14,2,27.200175281650395,77.79358958365101,0
Uttar Pradesh,Agra,Akola,95,8,71,hab,70,1,86,9,24,33,63,2,27.083811036516884,77.8741564576729,0
Uttar Pradesh,Agra,Bah,220,11,156,hab,148,8,203,17,64,33,394,2,26.85877092878673,78.5411768733178,0
Uttar Pradesh,Agra,Barauli Ahir,218,16,149,hab,141,8,189,29,69,33,574,2,27.116022833274155,78.09819925500996,0
Uttar Pradesh,Agra,Bichpuri,65,1,41,hab,32,9,52,13,24,33,908,2,27.17866448639691,77.96900618574178,0
Uttar Pradesh,Agra,Etmadpur,209,39,147,hab,136,11,183,26,62,33,1752,2,27.296793429697974,78.18816747789188,0
Uttar Pradesh,Agra,Fatehabad,427,12,259,hab,250,9,411,16,168,33,1768,2,27.01691402213766,78.30794431269648,0
Uttar Pradesh,Agra,Fatehpur Sikri,131,0,110,hab,104,6,125,6,21,33,1777,2,27.085703348575766,77.6706957640501,0
Uttar Pradesh,Agra,Jagner,145,1,98,hab,98,0,137,8,47,33,2346,2,26.871870010521587,77.57281079766167,0
Uttar Pradesh,Agra,Jaitpur Kalan,181,16,128,hab,124,4,157,24,53,33,2370,2,26.83400337528979,78.7126124503301,0
Uttar Pradesh,Agra,Khandauli,186,10,168,hab,145,23,172,14,18,33,2953,2,27.28160552342386,78.082282583415,0
Uttar Pradesh,Agra,Kheragarh,163,12,104,hab,101,3,147,16,59,33,2998,2,26.96795975075625,77.81874033114225,0
Uttar Pradesh,Agra,Pinahat,200,9,153,hab,141,12,186,14,47,33,4754,2,26.895819115564677,78.36631939645522,0
Uttar Pradesh,Agra,Saiyan,157,1,153,hab,141,12,153,4,4,33,5280,2,26.957250329403326,77.98707869222521,0
Uttar Pradesh,Agra,Shamsabad,295,24,191,hab,189,2,272,23,104,33,5534,2,27.013948713449324,78.10934536377344,0
Uttar Pradesh,Aligarh,Akrabad,182,21,162,osm,153,9,167,15,20,33,66,9,27.779162765422974,78.27351803701119,0
Uttar Pradesh,Aligarh,Atrauli,147,3,139,hab,135,4,143,4,8,33,298,9,28.045916683272644,78.30428813363534,0
Uttar Pradesh,Aligarh,Bijauli,168,16,149,hab,145,4,156,12,19,33,928,9,28.012078036640624,78.45993749956513,0
Uttar Pradesh,Aligarh,Chandosh,141,5,146,osm,132,14,137,4,-5,33,1160,9,28.066335218150673,77.86113224327934,0
Uttar Pradesh,Aligarh,Dhanipur,163,1,169,osm,156,13,152,11,-6,33,1559,9,27.874968629389205,78.17791580291222,0
Uttar Pradesh,Aligarh,Gangiri,243,6,220,hab,216,4,237,6,23,33,1854,9,27.9134839784537,78.42714701580283,0
Uttar Pradesh,Aligarh,Gonda,249,2,224,hab,212,12,244,5,25,33,1992,9,27.770158775068424,77.87255387071767,0
Uttar Pradesh,Aligarh,Iglas,186,13,175,osm,173,2,173,13,11,33,2282,9,27.694007103678803,77.9590228325258,0
Uttar Pradesh,Aligarh,Jawan,174,19,151,hab,147,4,154,20,23,33,2469,9,28.032482441543333,78.10788059410335,0
Uttar Pradesh,Aligarh,Khair,155,24,135,osm,124,11,130,25,20,33,2913,9,27.944893599875684,77.8452343837835,0
Uttar Pradesh,Aligarh,Lodha,161,4,130,hab,126,4,129,32,31,33,3422,9,27.885492147832572,78.02677362356292,0
Uttar Pradesh,Aligarh,Tappal,119,0,131,osm,115,16,116,3,-12,33,5914,9,28.018313683835753,77.61892135385922,0
Uttar Pradesh,Allahabad,Bahadurpur,487,19,0,hab,0,0,0,487,487,33,399,11,25.405647238401063,81.99360027310182,0
Uttar Pradesh,Allahabad,Baharia,392,13,2,hab,2,0,5,387,390,33,405,11,25.611228631525805,81.97776831401885,0
Uttar Pradesh,Allahabad,Chaka,197,24,4,hab,0,4,0,197,193,33,1110,11,25.41526220646602,81.7947621975917,0
Uttar Pradesh,Allahabad,Dhanupur,465,24,0,hab,0,0,0,465,465,33,1566,11,25.42258723769086,82.25460603428104,0
Uttar Pradesh,Allahabad,Handia,440,12,2,hab,2,0,16,424,438,33,2122,11,25.343837167321382,82.22050381309059,0
Uttar Pradesh,Allahabad,Holagarh,377,9,14,hab,12,2,19,358,363,33,2235,11,25.656883778845444,81.77446490736429,0
Uttar Pradesh,Allahabad,Jasra,221,13,1,hab,1,0,2,219,220,33,2454,11,25.265650719537096,81.75186500711057,0
Uttar Pradesh,Allahabad,Karchhana,322,7,2,hab,2,0,11,311,320,33,2770,11,25.26063768916908,81.986305322273,0
Uttar Pradesh,Allahabad,Kaudihar,424,75,47,hab,43,4,38,386,377,33,2858,11,25.55667564553315,81.71915349532908,0
Uttar Pradesh,Allahabad,Kaundhiyara,154,2,0,hab,0,0,0,154,154,33,2859,11,25.220441384911645,81.86727646621206,0
Uttar Pradesh,Allahabad,Koraon,372,32,1,hab,0,1,0,372,371,33,3131,11,24.97085730060115,82.03242695990963,0
Uttar Pradesh,Allahabad,Manda,179,20,66,hab,33,33,26,153,113,33,3632,11,25.04117171777648,82.22276190453796,0
Uttar Pradesh,Allahabad,Mau Aima,282,5,1,hab,1,0,50,232,281,33,3774,11,25.680042253190777,81.89037544252663,0
Uttar Pradesh,Allahabad,Meza,310,19,1,hab,1,0,4,306,309,33,3848,11,25.11040534436284,81.98760761096848,0
Uttar Pradesh,Allahabad,Phoolpur,335,3,1,hab,1,0,139,196,334,33,4738,11,25.566455794738182,82.07201937403067,0
Uttar Pradesh,Allahabad,Pratappur,291,4,0,hab,0,0,0,291,291,33,4828,11,25.522859005605174,82.21826654392252,0
Uttar Pradesh,Allahabad,Saidabad,236,8,1,hab,1,0,16,220,235,33,5266,11,25.405082159585742,82.10918828642619,0
Uttar Pradesh,Allahabad,Shankergarh,261,8,3,hab,2,1,4,257,258,33,5543,11,25.17740137057659,81.66674014661264,0
Uttar Pradesh,Allahabad,Soraon,256,13,2,hab,2,0,63,193,254,33,5745,11,25.557896626592722,81.86440504517039,0
Uttar Pradesh,Allahabad,Urua,194,1,1,hab,1,0,1,193,193,33,6231,11,25.243203529064992,82.1444671750852,0
Uttar Pradesh,Ambedkarnagar,Akbarpur,956,14,24,hab,24,0,88,868,932,33,54,15,26.39866778265838,82.56953400844277,0
Uttar Pradesh,Ambedkarnagar,Baskhari,554,11,15,hab,15,0,81,473,539,33,645,15,26.50158048721772,82.79101989281548,0
Uttar Pradesh,Ambedkarnagar,Bhiti,323,12,8,hab,8,0,13,310,315,33,865,15,26.46403550791301,82.34093852977831,0
Uttar Pradesh,Ambedkarnagar,Bhiyaun,724,8,1,hab,1,0,5,719,723,33,869,15,26.27530105914686,82.8219954678045,0
Uttar Pradesh,Ambedkarnagar,Jahagirganj,705,50,3,hab,3,0,50,655,702,33,2349,15,26.36748131844447,83.04482238698995,0
Uttar Pradesh,Ambedkarnagar,Jalalpur,712,9,1,hab,1,0,14,698,711,33,2387,15,26.32338339858045,82.6942436900637,0
Uttar Pradesh,Ambedkarnagar,Katehari,686,52,18,hab,18,0,60,626,668,33,2825,15,26.452502960654588,82.44886875810255,0
Uttar Pradesh,Ambedkarnagar,Ramnagar,660,29,4,hab,4,0,38,622,656,33,5052,15,26.43610547727213,82.89668610259038,0
Uttar Pradesh,Ambedkarnagar,Tanda,743,25,47,hab,39,8,170,573,696,33,5894,15,26.55897135784134,82.59981769086556,0
Uttar Pradesh,Amethi,Amethi,487,0,0,hab,0,0,0,487,487,33,7051,632,26.13433418434124,81.77408111767842,0
Uttar Pradesh,Amethi,Bahadurpur,414,24,1,hab,1,0,17,397,413,33,7062,632,26.26767392416305,81.46551057325817,0
Uttar Pradesh,Amethi,Bazar Shukla,560,0,31,hab,31,0,131,429,529,33,7059,632,26.565162647190952,81.62070645071083,0
Uttar Pradesh,Amethi,Bhadar,364,0,0,hab,0,0,0,364,364,33,7053,632,26.116868690564953,81.98064737761698,0
Uttar Pradesh,Amethi,Bhetua,334,8,0,hab,0,0,0,334,334,33,7052,632,26.203623612511212,81.88296883317678,0
Uttar Pradesh,Amethi,Gauriganj,549,13,1,hab,1,0,4,545,548,33,7055,632,26.207656954041976,81.68378401585788,0
Uttar Pradesh,Amethi,Jagdishpur,490,27,14,hab,14,0,34,456,476,33,7058,632,26.458040080634127,81.6486925710322,0
Uttar Pradesh,Amethi,Jamo,743,15,0,hab,0,0,0,743,743,33,7056,632,26.33965404260606,81.64513012873063,0
Uttar Pradesh,Amethi,Musafirkhana,555,0,25,hab,21,4,65,490,530,33,7060,632,26.389295604222667,81.79865468515162,0
Uttar Pradesh,Amethi,Sangrampur,425,30,0,hab,0,0,0,425,425,33,7054,632,26.079391722990298,81.8443986992187,0
Uttar Pradesh,Amethi,Shahgarh,361,12,0,hab,0,0,0,361,361,33,7057,632,26.269541846030748,81.76883932968803,0
Uttar Pradesh,Amethi,Singhpur,697,28,6,hab,6,0,30,667,691,33,7063,632,26.493756876034432,81.46337654591451,0
Uttar Pradesh,Amethi,Tiloi,599,36,3,hab,3,0,28,571,596,33,7061,632,26.367826264504206,81.47662054175221,0
Uttar Pradesh,Auraiya,Achalda,312,38,92,hab,90,2,151,161,220,33,8,30,26.711370215582633,79.42600626153289,0
Uttar Pradesh,Auraiya,Ajit Mal,186,5,1,hab,1,0,1,185,185,33,50,30,26.574985740629316,79.3223744365704,0
Uttar Pradesh,Auraiya,Arwa Katra,249,18,43,hab,43,0,91,158,206,33,252,30,26.86128901731918,79.40943669253188,0
Uttar Pradesh,Auraiya,Auraiya,287,6,33,hab,20,13,39,248,254,33,314,30,26.471341056805624,79.36036967681974,0
Uttar Pradesh,Auraiya,Bhagaya Nagar,202,12,1,hab,1,0,2,200,201,33,765,30,26.587300488171255,79.52152400665956,0
Uttar Pradesh,Auraiya,Bidhuna,272,29,35,hab,33,2,54,218,237,33,910,30,26.81324733982259,79.5694995129093,0
Uttar Pradesh,Auraiya,Sahar,224,13,1,hab,1,0,4,220,223,33,5249,30,26.702843633725386,79.63804934286182,0
Uttar Pradesh,Azamgarh,Ahiraula,319,11,1,hab,1,0,27,292,318,33,37,33,26.18130819422822,82.9181471446581,0
Uttar Pradesh,Azamgarh,Atrauliya,333,2,1,hab,1,0,10,323,332,33,299,33,26.33096565650613,82.93112317073647,0
Uttar Pradesh,Azamgarh,Azamatgarh,158,14,2,hab,2,0,3,155,156,33,327,33,26.16603477747836,83.37077798042627,0
Uttar Pradesh,Azamgarh,Bilariyaganj,485,27,0,hab,0,0,0,485,485,33,941,33,26.16975201241245,83.20393832338424,0
Uttar Pradesh,Azamgarh,Haraya,181,9,0,hab,0,0,0,181,181,33,2140,33,26.273894164274715,83.33023448975375,0
Uttar Pradesh,Azamgarh,Jahanaganj,201,6,1,hab,1,0,2,199,200,33,2351,33,25.918839205077774,83.26896367430345,0
Uttar Pradesh,Azamgarh,Koyalasa,327,10,1,hab,1,0,5,322,326,33,3193,33,26.256485795101284,83.02028679760103,0
Uttar Pradesh,Azamgarh,Lalganj,279,3,1,hab,1,0,10,269,278,33,3361,33,25.771635437457924,82.99940375392654,0
Uttar Pradesh,Azamgarh,Mahrajganj,329,21,2,hab,1,1,5,324,327,33,3539,33,26.2920539316675,83.17193980102371,0
Uttar Pradesh,Azamgarh,Martinganj,102,7,0,hab,0,0,0,102,102,33,3741,33,25.92506604151784,82.8226682972156,0
Uttar Pradesh,Azamgarh,Mehnagar,488,10,1,hab,1,0,12,476,487,33,3821,33,25.865629452423356,83.16091701277847,0
Uttar Pradesh,Azamgarh,Mirzapur,154,2,0,hab,0,0,0,154,154,33,3866,33,26.048479354629237,82.94266640681472,0
Uttar Pradesh,Azamgarh,Mohammadpur,138,14,0,hab,0,0,0,138,138,33,3882,33,25.953628442472237,83.0094427923316,0
Uttar Pradesh,Azamgarh,Palhani,226,8,0,hab,0,0,0,226,226,33,4460,33,26.055387527191147,83.1877979091011,0
Uttar Pradesh,Azamgarh,Palhna,191,4,0,hab,0,0,0,191,191,33,4461,33,25.783283593931483,83.11047459971559,0
Uttar Pradesh,Azamgarh,Pawai,228,3,0,hab,0,0,0,228,228,33,4646,33,26.160613175876424,82.74611805502781,0
Uttar Pradesh,Azamgarh,Phoolpur,257,15,1,hab,1,0,1,256,256,33,4739,33,26.049650496334312,82.79621036488548,0
Uttar Pradesh,Azamgarh,Rani Ki Sarai,240,11,2,hab,2,0,18,222,238,33,5088,33,25.999726403253078,83.11354752316537,0
Uttar Pradesh,Azamgarh,Sathiyaon,203,21,0,hab,0,0,0,203,203,33,5438,33,26.047762601181628,83.28816475577753,0
Uttar Pradesh,Azamgarh,Tahbarpur,421,7,0,hab,0,0,0,421,421,33,5854,33,26.120948389127182,83.04836199731956,0
Uttar Pradesh,Azamgarh,Tarwa,166,6,0,hab,0,0,0,166,166,33,5933,33,25.746276208921554,83.20110083716645,0
Uttar Pradesh,Azamgarh,Thekma,179,4,2,hab,2,0,6,173,177,33,6005,33,25.853651059581843,82.92138391102192,0
Uttar Pradesh,Badaun,Ambiapur,115,27,1,hab,0,1,0,115,114,33,139,34,28.14442096841867,78.93560006588872,0
Uttar Pradesh,Badaun,Asafpur,94,2,13,hab,13,0,13,81,81,33,256,34,28.392721935481962,78.9213398280141,0
Uttar Pradesh,Badaun,Bisauli,112,15,1,hab,0,1,0,112,111,33,977,34,28.29203967628047,78.90390935861481,0
Uttar Pradesh,Badaun,Dataganj,134,43,1,hab,0,1,0,134,133,33,1465,34,27.98263006602321,79.40938282182584,0
Uttar Pradesh,Badaun,Dehagawan,133,33,61,hab,20,41,20,113,72,33,1484,34,28.15732187652811,78.65863812727382,0
Uttar Pradesh,Badaun,Islamnagar,97,10,18,hab,18,0,19,78,79,33,2312,34,28.31690230704793,78.74352515160712,0
Uttar Pradesh,Badaun,Jagat,136,6,3,hab,1,2,1,135,133,33,2334,34,28.002052075866338,79.22927419062272,0
Uttar Pradesh,Badaun,Miaon,161,48,2,hab,0,2,0,161,159,33,3851,34,27.86781050184812,79.3315132830466,0
Uttar Pradesh,Badaun,Quaderchowk,174,9,0,hab,0,0,0,174,174,33,4898,34,27.902672090870798,79.06158956803971,0
Uttar Pradesh,Badaun,Sahaswan,239,96,3,hab,2,1,5,234,236,33,5255,34,28.083069421409444,78.77161278051098,0
Uttar Pradesh,Badaun,Salarpur,144,3,1,hab,1,0,2,142,143,33,5295,34,28.136950952324508,79.1971823860476,0
Uttar Pradesh,Badaun,Samrer,166,28,7,hab,6,1,9,157,159,33,5329,34,28.093656510540647,79.4020977983057,0
Uttar Pradesh,Badaun,Ujhani,213,24,2,hab,2,0,6,207,211,33,6188,34,28.00373592644224,78.95687029207346,0
Uttar Pradesh,Badaun,Usawan,169,40,1,hab,0,1,0,169,168,33,6233,34,27.761072541351822,79.26528430336242,0
Uttar Pradesh,Badaun,Wazirganj,94,13,2,hab,1,1,1,93,92,33,6433,34,28.238879943166378,79.03702389809735,0
Uttar Pradesh,Baghpat,Baghpat,52,0,47,hab,47,0,52,0,5,33,384,37,28.997311492868516,77.25810792736513,0
Uttar Pradesh,Baghpat,Baraut,57,0,43,hab,43,0,53,4,14,33,576,37,29.121527443967494,77.25243104430426,0
Uttar Pradesh,Baghpat,Binauli,64,0,65,osm,62,3,63,1,-1,33,955,37,29.138409511735016,77.39684975099969,0
Uttar Pradesh,Baghpat,Chhaprauli,28,0,27,hab,26,1,27,1,1,33,1255,37,29.224246320499116,77.21772096126857,0
Uttar Pradesh,Baghpat,Khekra,48,0,41,hab,41,0,45,3,7,33,2995,37,28.853152831394375,77.30897146451751,0
Uttar Pradesh,Baghpat,Pilana,54,0,48,hab,48,0,51,3,6,33,4750,37,28.95028887798741,77.38791922781607,0
Uttar Pradesh,Bahraich,Balha,428,12,245,hab,242,3,417,11,183,33,451,38,27.916957248940705,81.42911372305153,0
Uttar Pradesh,Bahraich,Chittaura,533,59,321,hab,296,25,487,46,212,33,1331,38,27.603416769258175,81.61526150136012,0
Uttar Pradesh,Bahraich,Fakharpur,785,78,390,hab,390,0,761,24,395,33,1755,38,27.39968089277453,81.48850437581362,0
Uttar Pradesh,Bahraich,Huzoorpur,783,62,419,hab,412,7,736,47,364,33,2266,38,27.39893830762267,81.65116599218061,0
Uttar Pradesh,Bahraich,Jarwal,774,18,311,hab,309,2,773,1,463,33,2448,38,27.182177443037983,81.56540804243097,0
Uttar Pradesh,Bahraich,Kaisarganj,695,52,328,hab,328,0,689,6,367,33,2587,38,27.274195526317932,81.52540739733176,0
Uttar Pradesh,Bahraich,Mahasi,615,38,321,hab,318,3,593,22,294,33,3524,38,27.61139724353492,81.36664729737082,0
Uttar Pradesh,Bahraich,Mihinpurwa,711,21,429,hab,398,31,687,24,282,33,3855,38,28.148510823743003,81.2679713935948,0
Uttar Pradesh,Bahraich,Nawabganj,280,20,207,hab,202,5,267,13,73,33,4241,38,27.95550066923026,81.60342876946451,0
Uttar Pradesh,Bahraich,Payagpur,713,29,310,hab,308,2,705,8,403,33,4648,38,27.446363448807364,81.78890272433118,0
Uttar Pradesh,Bahraich,Risia,389,78,210,hab,203,7,326,63,179,33,5171,38,27.77083569040642,81.58189814742262,0
Uttar Pradesh,Bahraich,Shivpur,941,39,287,hab,279,8,920,21,654,33,5582,38,27.787498115215637,81.40262405900415,0
Uttar Pradesh,Bahraich,Tejwapur,907,137,372,hab,368,4,858,49,535,33,5941,38,27.53214715447453,81.49794432323613,0
Uttar Pradesh,Bahraich,Visheshwarganj,944,17,430,hab,427,3,944,0,514,33,6381,38,27.38866831450681,81.86598623321773,0
Uttar Pradesh,Ballia,Bairia,80,7,2,hab,2,0,8,72,78,33,420,41,25.792738436154174,84.45723019836804,0
Uttar Pradesh,Ballia,Bansdih,110,1,1,hab,1,0,4,106,109,33,536,41,25.890128936371596,84.25856996217257,0
Uttar Pradesh,Ballia,Belhari,70,13,0,hab,0,0,0,70,70,33,706,41,25.73481402705115,84.30163215715939,0
Uttar Pradesh,Ballia,Beruarbari,74,29,2,hab,1,1,2,72,72,33,731,41,25.85879443215471,84.13496001238919,0
Uttar Pradesh,Ballia,Chilkahar,205,38,0,hab,0,0,0,205,205,33,1287,41,25.844565183470753,83.9454109261431,0
Uttar Pradesh,Ballia,Dubhar,230,39,0,hab,0,0,0,230,230,33,1679,41,25.757054297800483,84.20702488435201,0
Uttar Pradesh,Ballia,Gadwar,182,59,3,hab,3,0,9,173,179,33,1800,41,25.830828267114732,84.02794141993382,0
Uttar Pradesh,Ballia,Hanumanganj,125,14,0,hab,0,0,0,125,125,33,2130,41,25.768791843731613,84.1022336161291,0
Uttar Pradesh,Ballia,Maniar,122,2,12,hab,6,6,15,107,110,33,3674,41,25.969091769342302,84.16048443820877,0
Uttar Pradesh,Ballia,Murlichhapra,92,10,0,hab,0,0,0,92,92,33,4011,41,25.751676139090396,84.53912382721948,0
Uttar Pradesh,Ballia,Nagra,266,33,3,hab,1,2,7,259,263,33,4077,41,25.998456514376322,83.83125585590221,0
Uttar Pradesh,Ballia,Nawanagar,156,11,2,hab,2,0,5,151,154,33,4253,41,26.06058756155777,84.01207437121936,0
Uttar Pradesh,Ballia,Pandah,128,31,1,hab,1,0,3,125,127,33,4503,41,25.959891193252684,84.00908665267652,0
Uttar Pradesh,Ballia,Rasda,134,4,0,hab,0,0,0,134,134,33,5109,41,25.85566839879295,83.83576327763596,0
Uttar Pradesh,Ballia,Reoti,151,23,0,hab,0,0,0,151,151,33,5161,41,25.854074319732025,84.37524577825283,0
Uttar Pradesh,Ballia,Sear,297,48,2,hab,2,0,7,290,295,33,5460,41,26.10119122137289,83.83651695615232,0
Uttar Pradesh,Ballia,Shohaon,108,5,2,hab,2,0,11,97,106,33,5585,41,25.6656147735182,83.99565461364945,0
Uttar Pradesh,Balrampur,Balrampur,492,0,334,hab,311,23,467,25,158,33,476,42,27.42571644619474,82.21019487312716,0
Uttar Pradesh,Balrampur,Gainsari,381,44,249,hab,230,19,337,44,132,33,1807,42,27.541988012847284,82.50368351157374,0
Uttar Pradesh,Balrampur,Gendas Buzurg,326,33,247,hab,244,3,318,8,79,33,1906,42,27.223504915655084,82.46061770301715,0
Uttar Pradesh,Balrampur,Harraiya Satgharwa,410,0,361,hab,321,40,399,11,49,33,2164,42,27.667812039267805,82.20922609837781,0
Uttar Pradesh,Balrampur,Pachpedwa,190,0,205,osm,176,29,187,3,-15,33,4410,42,27.54870370473995,82.66476235357015,0
Uttar Pradesh,Balrampur,Rehra,485,12,434,hab,422,12,484,1,51,33,5148,42,27.148520545246264,82.33918574524519,0
Uttar Pradesh,Balrampur,Sriduttganj,419,48,236,hab,225,11,390,29,183,33,5759,42,27.328332386728352,82.3188968247709,0
Uttar Pradesh,Balrampur,Tulsipur,357,0,266,hab,240,26,347,10,91,33,6148,42,27.546110731204124,82.32487733363138,0
Uttar Pradesh,Balrampur,Utraula,291,52,206,hab,195,11,270,21,85,33,6246,42,27.29484037448909,82.40669639419505,0
Uttar Pradesh,Banda,Baberu,203,0,144,hab,122,22,158,45,59,33,340,44,25.572370305403922,80.69394061764947,0
Uttar Pradesh,Banda,Badokhar Khurd,144,0,108,hab,104,4,118,26,36,33,365,44,25.48452150857455,80.32642633122715,0
Uttar Pradesh,Banda,Bisanda,161,0,129,hab,115,14,140,21,32,33,976,44,25.387934761805273,80.69120356488637,0
Uttar Pradesh,Banda,Jaspura,109,0,87,hab,83,4,98,11,22,33,2453,44,25.820997819762095,80.40301186385453,0
Uttar Pradesh,Banda,Kamasin,188,0,127,hab,121,6,175,13,61,33,2677,44,25.532875518251625,80.89486488898883,0
Uttar Pradesh,Banda,Mahua,249,0,171,hab,155,16,233,16,78,33,3542,44,25.309554717557667,80.45318200047905,0
Uttar Pradesh,Banda,Naraini,323,0,294,hab,249,45,290,33,29,33,4161,44,25.148238628919135,80.53312391661235,0
Uttar Pradesh,Banda,Tindwari,157,0,127,hab,116,11,138,19,30,33,6090,44,25.658037500888682,80.48643122565642,0
Uttar Pradesh,Barabanki,Banikoder,459,59,9,hab,9,0,21,438,450,33,515,50,26.771854994125114,81.49186479565994,0
Uttar Pradesh,Barabanki,Banki,260,25,1,hab,1,0,1,259,259,33,527,50,26.919241975134202,81.17997657640225,0
Uttar Pradesh,Barabanki,Dariyabad,327,22,16,hab,15,1,25,302,311,33,1449,50,26.896244716139403,81.54715631259867,0
Uttar Pradesh,Barabanki,Dewa,467,22,1,hab,1,0,6,461,466,33,1537,50,27.022518493549512,81.14098664513774,0
Uttar Pradesh,Barabanki,Fatehpur,305,11,1,hab,1,0,7,298,304,33,1771,50,27.171580589693832,81.1985728528913,0
Uttar Pradesh,Barabanki,Haidergarh,427,44,5,hab,3,2,6,421,422,33,2102,50,26.616401167880735,81.45995343581394,0
Uttar Pradesh,Barabanki,Harakh,313,11,3,hab,3,0,11,302,310,33,2137,50,26.82364743319973,81.25476343402052,0
Uttar Pradesh,Barabanki,Masauli,247,15,1,hab,1,0,16,231,246,33,3749,50,26.937883639860182,81.32753657091304,0
Uttar Pradesh,Barabanki,Nidura,580,9,3,hab,3,0,28,552,577,33,4295,50,27.13738327814473,81.04267570784917,0
Uttar Pradesh,Barabanki,Puredalai,202,14,49,hab,18,31,19,183,153,33,4867,50,26.907094557454354,81.6803669966372,0
Uttar Pradesh,Barabanki,Ram Nagar,289,14,24,hab,23,1,46,243,265,33,5012,50,27.072062498822447,81.37366106715815,0
Uttar Pradesh,Barabanki,Siddhaur,408,32,1,hab,1,0,5,403,407,33,5602,50,26.745578742979045,81.37405538017555,0
Uttar Pradesh,Barabanki,Sirauli Gauspur,242,11,1,hab,1,0,2,240,241,33,5668,50,26.98493809839879,81.45551533090804,0
Uttar Pradesh,Barabanki,Suratganj,342,9,2,hab,1,1,5,337,340,33,5816,50,27.22170822705683,81.34601873956301,0
Uttar Pradesh,Barabanki,Trivediganj,301,5,0,hab,0,0,0,301,301,33,6138,50,26.64287641125473,81.26817674205887,0
Uttar Pradesh,Bareilly,Alampur Jafrabad,177,13,1,hab,1,0,3,174,176,33,72,53,28.225626030333732,79.30013804505644,0
Uttar Pradesh,Bareilly,Baheri,204,4,0,hab,0,0,0,204,204,33,406,53,28.799319256434078,79.50493113981894,0
Uttar Pradesh,Bareilly,Bhadhpura,144,29,0,hab,0,0,0,144,144,33,754,53,28.44326188301954,79.6975626164393,0
Uttar Pradesh,Bareilly,Bhojipura,106,13,0,hab,0,0,0,106,106,33,873,53,28.5125314347358,79.44091874176253,0
Uttar Pradesh,Bareilly,Bhuta,210,57,9,hab,9,0,17,193,201,33,896,53,28.27204785217854,79.64209415441269,0
Uttar Pradesh,Bareilly,Bithri Chainpur,116,22,1,hab,1,0,1,115,115,33,994,53,28.387950549344353,79.53998894660073,0
Uttar Pradesh,Bareilly,Damkhoda,118,9,0,hab,0,0,0,118,118,33,1417,53,28.69346935278538,79.56615032238636,0
Uttar Pradesh,Bareilly,Faridpur,163,24,24,hab,23,1,32,131,139,33,1763,53,28.16047449634573,79.54677431410879,0
Uttar Pradesh,Bareilly,Fatehganj(West),105,10,0,hab,0,0,0,105,105,33,1769,53,28.508265561767768,79.3402498467958,0
Uttar Pradesh,Bareilly,Kiyara,103,31,2,hab,1,1,2,101,101,33,3056,53,28.345729734789185,79.41074917836309,0
Uttar Pradesh,Bareilly,Majhgawan,108,11,0,hab,0,0,0,108,108,33,3562,53,28.354883685459587,79.23814102247343,0
Uttar Pradesh,Bareilly,Meerganj,114,8,0,hab,0,0,0,114,114,33,3809,53,28.515002994441385,79.22915679361768,0
Uttar Pradesh,Bareilly,Nawabganj,171,22,3,hab,3,0,4,167,168,33,4244,53,28.540239282761934,79.59404754622307,0
Uttar Pradesh,Bareilly,Ramnager,92,1,2,hab,1,1,1,91,90,33,5056,53,28.374091408872072,79.09789987060215,0
Uttar Pradesh,Bareilly,Shergrah,142,4,0,hab,0,0,0,142,142,33,5560,53,28.661521236930593,79.35481878638848,0
Uttar Pradesh,Basti,Bahadurpur,450,82,388,osm,290,98,407,43,62,33,398,59,26.665375257180973,82.71692373803873,0
Uttar Pradesh,Basti,Bankati,336,72,221,hab,216,5,298,38,115,33,522,59,26.714833468592648,82.90014265945014,0
Uttar Pradesh,Basti,Basti Sadar,517,96,366,hab,338,28,467,50,151,33,657,59,26.783457104205816,82.74386539772209,0
Uttar Pradesh,Basti,Gaur,340,14,561,osm,484,77,336,4,-221,33,1892,59,26.897138669090722,82.59379942474949,0
Uttar Pradesh,Basti,Harraiya,502,56,478,osm,457,21,480,22,24,33,2163,59,26.797900077382014,82.48487809069259,0
Uttar Pradesh,Basti,Kaptan Ganj,540,85,457,osm,445,12,503,37,83,33,2746,59,26.704019605198805,82.58832663438615,0
Uttar Pradesh,Basti,Kudraha,309,113,190,hab,185,5,214,95,119,33,3224,59,26.623467639609707,82.82297847674133,0
Uttar Pradesh,Basti,Parasurampur,394,22,439,osm,429,10,389,5,-45,33,4553,59,26.900892010412267,82.3480449494691,0
Uttar Pradesh,Basti,Ram Nagar,213,18,310,osm,298,12,201,12,-97,33,5011,59,27.05732327120137,82.66535214568461,0
Uttar Pradesh,Basti,Rudhauli,231,71,154,hab,154,0,187,44,77,33,5203,59,27.004963183097555,82.80823829221501,0
Uttar Pradesh,Basti,Saltauwa Gopalpur,492,58,387,hab,368,19,481,11,105,33,5307,59,26.935705650656647,82.7192765218497,0
Uttar Pradesh,Basti,Saun Ghat,347,71,245,hab,212,33,310,37,102,33,5448,59,26.872427108787413,82.83568005957703,0
Uttar Pradesh,Basti,Vikramjot,557,77,491,osm,473,18,503,54,66,33,6367,59,26.764879786681306,82.3754229069523,0
Uttar Pradesh,Bijnor,Afzalgarh,177,33,3,hab,2,1,3,174,174,33,25,80,29.395355211961533,78.7459761827935,0
Uttar Pradesh,Bijnor,Dhampur,156,31,1,hab,1,0,3,153,155,33,1549,80,29.30086394656648,78.56392204273492,0
Uttar Pradesh,Bijnor,Haldaur,196,42,2,hab,2,0,4,192,194,33,2110,80,29.27497381416423,78.2167774256294,0
Uttar Pradesh,Bijnor,Jalilpur,205,16,20,hab,19,1,29,176,185,33,2398,80,29.118415990689233,78.21910693969974,0
Uttar Pradesh,Bijnor,Kiratpur,154,13,2,hab,1,1,4,150,152,33,3042,80,29.493682774045663,78.2591323164347,0
Uttar Pradesh,Bijnor,Kotwali,343,48,3,hab,2,1,8,335,340,33,3186,80,29.485914270138217,78.49962278768432,0
Uttar Pradesh,Bijnor,Mohd. Pur Deomal,242,29,4,hab,2,2,4,238,238,33,3894,80,29.451162384974158,78.12412008055554,0
Uttar Pradesh,Bijnor,Najibabad,257,6,3,hab,2,1,9,248,254,33,4096,80,29.649867059378273,78.32237527221609,0
Uttar Pradesh,Bijnor,Nehtaur,198,22,1,hab,1,0,3,195,197,33,4268,80,29.2937832502438,78.39258942355501,0
Uttar Pradesh,Bijnor,Noorpur,186,13,11,hab,6,5,10,176,175,33,4340,80,29.13031922106058,78.41886211747082,0
Uttar Pradesh,Bijnor,Seohara,162,20,20,hab,20,0,36,126,142,33,5483,80,29.16585236966734,78.59022247019844,0
Uttar Pradesh,Bulandshahr,Agauta,67,7,3,hab,3,0,4,63,64,33,31,91,28.514673361212278,77.88204882133027,0
Uttar Pradesh,Bulandshahr,Anoopshahr,96,16,3,hab,1,2,1,95,93,33,207,91,28.381551184348183,78.21369471942126,0
Uttar Pradesh,Bulandshahr,Araniya,94,6,93,osm,79,14,83,11,1,33,222,91,28.17522728853681,77.94818113038382,0
Uttar Pradesh,Bulandshahr,B.B.Nagar,52,6,8,hab,8,0,9,43,44,33,333,91,28.635356297474132,77.91504291117538,0
Uttar Pradesh,Bulandshahr,Bulandshahr,91,14,15,hab,14,1,20,71,76,33,1065,91,28.398969002341328,77.85232992354614,0
Uttar Pradesh,Bulandshahr,Danpur,114,2,43,hab,41,2,54,60,71,33,1431,91,28.208822350531147,78.2297600620437,0
Uttar Pradesh,Bulandshahr,Debai,106,20,51,hab,48,3,56,50,55,33,1474,91,28.185170116875163,78.36143393079209,0
Uttar Pradesh,Bulandshahr,Gulawathi,62,11,1,hab,1,0,1,61,61,33,2059,91,28.5490722057179,77.79879391376004,0
Uttar Pradesh,Bulandshahr,Jhangirabad,83,7,0,hab,0,0,0,83,83,33,2493,91,28.464247411947255,78.05972974571652,0
Uttar Pradesh,Bulandshahr,Khurja,111,12,82,hab,70,12,77,34,29,33,3027,91,28.237881635344692,77.8051878552975,0
Uttar Pradesh,Bulandshahr,Lakhawati,68,14,4,hab,3,1,3,65,64,33,3340,91,28.456551777478605,77.95903914794837,0
Uttar Pradesh,Bulandshahr,Pahasu,124,10,61,hab,41,20,41,83,63,33,4427,91,28.176393762637822,78.10307726502155,0
Uttar Pradesh,Bulandshahr,Shikarpur,105,11,52,hab,47,5,52,53,53,33,5566,91,28.3218215135285,78.02210121381498,0
Uttar Pradesh,Bulandshahr,Sikandrabad,157,11,1,hab,1,0,2,155,156,33,5621,91,28.42996775627999,77.72592659140246,0
Uttar Pradesh,Bulandshahr,Syana,47,3,2,hab,1,1,1,46,45,33,5836,91,28.622316734877643,78.05002199421153,0
Uttar Pradesh,Bulandshahr,Unchagaon,75,9,0,hab,0,0,0,75,75,33,6215,91,28.530090202539025,78.14590163452931,0
Uttar Pradesh,Chandauli,Barahani,194,13,125,hab,122,3,174,20,69,33,559,103,25.306886169616597,83.4342455731971,0
Uttar Pradesh,Chandauli,Chahania,317,7,2,hab,2,0,18,299,315,33,1103,103,25.435322477141494,83.21385275490454,0
Uttar Pradesh,Chandauli,Chakiya,345,7,52,hab,51,1,102,243,293,33,1118,103,25.06791346977486,83.17394730374271,0
Uttar Pradesh,Chandauli,Chandauli,304,16,12,hab,10,2,23,281,292,33,1150,103,25.211358628329876,83.2691360955572,0
Uttar Pradesh,Chandauli,Dhanapur,328,9,148,hab,145,3,247,81,180,33,1551,103,25.4252010369965,83.38093705102128,0
Uttar Pradesh,Chandauli,Naugarh,212,4,25,hab,18,7,22,190,187,33,4229,103,24.866716231705063,83.22570575848515,0
Uttar Pradesh,Chandauli,Niyamatabad,229,4,67,hab,67,0,130,99,162,33,4326,103,25.2609368134858,83.10894199097314,0
Uttar Pradesh,Chandauli,Sakaldiha,373,24,20,hab,16,4,60,313,353,33,5283,103,25.316761630362926,83.26537777790399,0
Uttar Pradesh,Chandauli,Shahabganj,303,5,1,hab,1,0,1,302,302,33,5501,103,25.073181747327155,83.29655512406418,0
Uttar Pradesh,Chitrakoot,Chitrakoot,709,39,67,hab,54,13,128,581,642,33,1325,114,25.258657823074458,80.87435639813421,0
Uttar Pradesh,Chitrakoot,Manikpur,483,25,0,hab,0,0,0,483,483,33,3681,114,25.074873561133174,81.04910042011059,0
Uttar Pradesh,Chitrakoot,Mau,320,5,6,hab,6,0,14,306,314,33,3773,114,25.21132921156357,81.35849092235802,0
Uttar Pradesh,Chitrakoot,Pahari,477,207,35,hab,34,1,132,345,442,33,4425,114,25.43687065763098,81.04035913177734,0
Uttar Pradesh,Chitrakoot,Ramnagar,288,111,0,hab,0,0,0,288,288,33,5050,114,25.311622853181536,81.20392580068587,0
Uttar Pradesh,Deoria,Baitalpur,366,47,1,hab,1,0,16,350,365,33,423,142,26.543461645526055,83.6985483013818,0
Uttar Pradesh,Deoria,Bankata,286,7,0,hab,0,0,0,286,286,33,521,142,26.30172228598843,84.12684852469464,0
Uttar Pradesh,Deoria,Berhaj,144,10,2,hab,2,0,6,138,142,33,723,142,26.303857343761504,83.69211275187853,0
Uttar Pradesh,Deoria,Bhagalpur,167,28,0,hab,0,0,0,167,167,33,761,142,26.233910082712665,83.84897700313041,0
Uttar Pradesh,Deoria,Bhaluani,333,28,1,hab,1,0,9,324,332,33,786,142,26.37768034323368,83.753051556514,0
Uttar Pradesh,Deoria,Bhatni,268,33,0,hab,0,0,0,268,268,33,821,142,26.400608622639783,83.94945763221328,0
Uttar Pradesh,Deoria,Bhatpar Rani,198,8,2,hab,2,0,17,181,196,33,822,142,26.32331507435646,84.044444540794,0
Uttar Pradesh,Deoria,Deoria Sadar,370,0,0,hab,0,0,0,370,370,33,1509,142,26.463668254338796,83.78648196679664,0
Uttar Pradesh,Deoria,Deshi Deoria,165,21,1,hab,1,0,7,158,164,33,1518,142,26.66976450936019,83.80442197054171,0
Uttar Pradesh,Deoria,Gouri Bazar,360,10,1,hab,1,0,9,351,359,33,2024,142,26.583832433142426,83.65633237069783,0
Uttar Pradesh,Deoria,Lar,331,18,0,hab,0,0,0,331,331,33,3382,142,26.18180514462359,83.97620253073268,0
Uttar Pradesh,Deoria,Patherdeva,176,25,0,hab,0,0,0,176,176,33,4616,142,26.568601389360353,83.93060250289362,0
Uttar Pradesh,Deoria,Rampur Karkhana,274,0,1,hab,1,0,6,268,273,33,5063,142,26.547876602512005,83.81941891471,0
Uttar Pradesh,Deoria,Rudrapur,225,32,0,hab,0,0,0,225,225,33,5205,142,26.432593225032758,83.56484701941504,0
Uttar Pradesh,Deoria,Selempur,271,28,0,hab,0,0,0,271,271,33,5472,142,26.31431925858705,83.9077725508436,0
Uttar Pradesh,Deoria,TARKULWA,217,73,1,hab,1,0,13,204,216,33,5927,142,26.66070359105296,83.90703354406914,0
Uttar Pradesh,Etah,Aliganj,303,1,1,hab,0,1,0,303,302,33,85,174,27.468826840011836,79.17893963323776,0
Uttar Pradesh,Etah,Awagarh,198,27,1,hab,1,0,7,191,197,33,325,174,27.475368708654933,78.4243922069102,0
Uttar Pradesh,Etah,Jaithra,307,14,2,hab,2,0,10,297,305,33,2368,174,27.510070690841967,79.00537102626785,0
Uttar Pradesh,Etah,Jalesar,231,1,58,hab,49,9,58,173,173,33,2394,174,27.430247434312093,78.29388238569581,0
Uttar Pradesh,Etah,Marhara,191,51,1,hab,1,0,2,189,190,33,3728,174,27.721358957500836,78.6371316787033,0
Uttar Pradesh,Etah,Nidhauli Kalan,283,9,1,hab,1,0,2,281,282,33,4294,174,27.588175077470794,78.55397026429152,0
Uttar Pradesh,Etah,Sakit,245,23,2,hab,1,1,1,244,243,33,5286,174,27.450685115900942,78.7815069388141,0
Uttar Pradesh,Etah,Sheetalpur,269,34,2,hab,2,0,6,263,267,33,5547,174,27.578134724458973,78.75694429880949,0
Uttar Pradesh,Etawah,Barhpura,243,29,15,hab,14,1,34,209,228,33,599,175,26.744772590615472,78.94900560140277,0
Uttar Pradesh,Etawah,Basrehar,291,14,2,hab,2,0,6,285,289,33,651,175,26.870125957310123,79.10705309360897,0
Uttar Pradesh,Etawah,Bharthana,231,9,11,hab,11,0,15,216,220,33,813,175,26.770089284587375,79.22458438534343,0
Uttar Pradesh,Etawah,Chakarnagar,150,61,9,hab,9,0,13,137,141,33,1114,175,26.56059934854857,79.09383864706018,0
Uttar Pradesh,Etawah,Jaswantnagar,254,10,32,hab,30,2,55,199,222,33,2456,175,26.88805302782063,78.8726799314522,0
Uttar Pradesh,Etawah,Mahewah,287,13,4,hab,4,0,13,274,283,33,3530,175,26.65221972034588,79.1805122973913,0
Uttar Pradesh,Etawah,Saifai,229,33,1,hab,1,0,4,225,228,33,5270,175,26.924770619909438,79.0108983585878,0
Uttar Pradesh,Etawah,Takha,292,10,13,hab,13,0,32,260,279,33,5857,175,26.90149786970436,79.26893321606677,0
Uttar Pradesh,Faizabad,Amaniganj,321,14,320,osm,298,22,320,1,1,33,109,176,26.6215232550489,81.80439478634801,0
Uttar Pradesh,Faizabad,Bikapur,437,41,15,hab,14,1,51,386,422,33,935,176,26.550425094842016,82.1400420031992,0
Uttar Pradesh,Faizabad,Haringtonganj,428,24,225,hab,221,4,363,65,203,33,2151,176,26.561594256787885,82.01538926518803,0
Uttar Pradesh,Faizabad,Masodha,375,19,265,hab,251,14,354,21,110,33,3753,176,26.739280757126757,82.12035713432775,0
Uttar Pradesh,Faizabad,Mawai,230,6,232,osm,214,18,221,9,-2,33,3783,176,26.71154328118814,81.6314467931475,0
Uttar Pradesh,Faizabad,Maya Bazar,383,21,304,hab,295,9,374,9,79,33,3793,176,26.62010563200503,82.37273197311767,0
Uttar Pradesh,Faizabad,Milkipur,476,44,352,hab,337,15,463,13,124,33,3858,176,26.628078361589154,81.93984601733962,0
Uttar Pradesh,Faizabad,Pura Bazar,466,52,215,hab,205,10,434,32,251,33,4861,176,26.70928629139811,82.25361924786941,0
Uttar Pradesh,Faizabad,Rudauli,312,73,259,osm,248,11,257,55,53,33,5201,176,26.75089392607659,81.74724167776013,0
Uttar Pradesh,Faizabad,Sohawal,296,29,210,hab,201,9,279,17,86,33,5709,176,26.7620332095211,81.92496974082148,0
Uttar Pradesh,Faizabad,Tarun,970,96,22,hab,20,2,74,896,948,33,5932,176,26.518973923770567,82.23866799605241,0
Uttar Pradesh,Farrukhabad,Badhpur,185,9,0,hab,0,0,0,185,185,33,359,179,27.390836931813578,79.56829613236317,0
Uttar Pradesh,Farrukhabad,Kaimganj,302,5,5,hab,5,0,9,293,297,33,2584,179,27.612879299625554,79.26562848726734,0
Uttar Pradesh,Farrukhabad,Kamalganj,390,19,1,hab,1,0,11,379,389,33,2672,179,27.245643571752016,79.5871499849069,0
Uttar Pradesh,Farrukhabad,Mohammadabad,339,9,1,hab,1,0,2,337,338,33,3881,179,27.316505098086928,79.40466103036465,0
Uttar Pradesh,Farrukhabad,Nawabganj,206,9,7,hab,7,0,13,193,199,33,4240,179,27.445666541601582,79.33594347965669,0
Uttar Pradesh,Farrukhabad,Rajepur,274,6,1,hab,1,0,3,271,273,33,4975,179,27.46117689750223,79.64279920495773,0
Uttar Pradesh,Farrukhabad,Shamashabad,354,19,1,hab,1,0,12,342,353,33,5528,179,27.526569992214828,79.46863513700573,0
Uttar Pradesh,Fatehpur,Airayan,211,12,0,hab,0,0,0,211,211,33,45,182,25.78548003627642,81.20009026742115,0
Uttar Pradesh,Fatehpur,Amauli,214,42,1,hab,1,0,3,211,213,33,121,182,25.98842831042904,80.33535621704607,0
Uttar Pradesh,Fatehpur,Ashother,158,0,2,hab,2,0,2,156,156,33,260,182,25.737868039868502,80.86540021779368,0
Uttar Pradesh,Fatehpur,Bahuwa,101,0,5,hab,3,2,3,98,96,33,410,182,25.797289764589735,80.65912939242254,0
Uttar Pradesh,Fatehpur,Bhitaura,233,0,1,hab,1,0,4,229,232,33,864,182,25.980949594675565,80.94978311174957,0
Uttar Pradesh,Fatehpur,Devmai,136,0,2,hab,2,0,9,127,134,33,1535,182,26.1090826364814,80.4252097869286,0
Uttar Pradesh,Fatehpur,Dhata,138,0,38,hab,38,0,48,90,100,33,1601,182,25.581535585056365,81.18269333070681,0
Uttar Pradesh,Fatehpur,Haswa,217,1,0,hab,0,0,0,217,217,33,2184,182,25.83062178056919,80.9331230915396,0
Uttar Pradesh,Fatehpur,Hathgaon,280,0,1,hab,1,0,3,277,279,33,2187,182,25.90251229674243,81.11790260913443,0
Uttar Pradesh,Fatehpur,Khajuha,212,0,0,hab,0,0,0,212,212,33,2925,182,25.941844506142434,80.51230494266339,0
Uttar Pradesh,Fatehpur,Malwan,246,1,2,hab,2,0,7,239,244,33,3613,182,26.071780026086458,80.61391408998573,0
Uttar Pradesh,Fatehpur,Teliyani,134,0,1,hab,1,0,1,133,133,33,5950,182,25.938826054769002,80.76505597858,0
Uttar Pradesh,Fatehpur,Vijaipur,153,0,24,hab,22,2,28,125,129,33,6354,182,25.661225074405234,81.05550759007139,0
Uttar Pradesh,Firozabad,Aika,597,51,16,hab,16,0,70,527,581,33,43,184,27.39164407854064,78.5973270429418,0
Uttar Pradesh,Firozabad,Araon,349,93,0,hab,0,0,0,349,349,33,224,184,27.12229827346765,78.72094155173308,0
Uttar Pradesh,Firozabad,Firozabad,522,27,133,hab,132,1,341,181,389,33,1785,184,27.111581740535488,78.40902035133072,0
Uttar Pradesh,Firozabad,Jasrana,365,67,2,hab,2,0,7,358,363,33,2455,184,27.246645762114937,78.65581507201888,0
Uttar Pradesh,Firozabad,Khairgarh,368,72,3,hab,3,0,13,355,365,33,2918,184,27.245545169259145,78.51750456347204,0
Uttar Pradesh,Firozabad,Madanpur,590,29,14,hab,14,0,65,525,576,33,3466,184,26.99207301874977,78.68432876288135,0
Uttar Pradesh,Firozabad,Narkhi,387,37,6,hab,1,5,13,374,381,33,4192,184,27.277317395201514,78.39085566305131,0
Uttar Pradesh,Firozabad,Shikohabad,438,81,18,hab,15,3,37,401,420,33,5567,184,27.068449068001886,78.5579000624888,0
Uttar Pradesh,Firozabad,Tundla,510,172,73,hab,73,0,212,298,437,33,6153,184,27.19084685801146,78.26064396650214,0
Uttar Pradesh,G.B. Nagar,Bisrakh,117,16,42,hab,33,9,41,76,75,33,989,185,28.576731737889826,77.42165159666973,0
Uttar Pradesh,G.B. Nagar,Dadri,92,17,12,hab,12,0,14,78,80,33,1392,185,28.54177526343284,77.5970766134705,0
Uttar Pradesh,G.B. Nagar,Dankaur,142,13,44,hab,38,6,50,92,98,33,1429,185,28.378178663735792,77.5705204689855,0
Uttar Pradesh,G.B. Nagar,Jewar,117,0,83,hab,77,6,85,32,34,33,2481,185,28.182253174086075,77.61241818787826,0
Uttar Pradesh,Ghaziabad,Bhojpur,89,15,51,hab,47,4,64,25,38,33,874,193,28.80730549224975,77.62861753606776,0
Uttar Pradesh,Ghaziabad,Loni,65,0,31,hab,26,5,35,30,34,33,3438,193,28.76382041485393,77.31959039488433,0
Uttar Pradesh,Ghaziabad,Muradnagar,79,5,57,hab,52,5,70,9,22,33,4003,193,28.831002387167377,77.4844283651706,0
Uttar Pradesh,Ghaziabad,Rajapur,60,11,46,hab,35,11,41,19,14,33,4968,193,28.700053418108936,77.48140121675723,0
Uttar Pradesh,Ghazipur,Barachawar,106,12,0,hab,0,0,0,106,106,33,556,194,25.731275728778716,83.84086523995425,0
Uttar Pradesh,Ghazipur,Bhadaura,70,11,9,hab,8,1,11,59,61,33,750,194,25.44968409426664,83.76634647591851,0
Uttar Pradesh,Ghazipur,Bhawarkol,136,9,1,hab,0,1,0,136,135,33,835,194,25.598737139196615,83.86947136723892,0
Uttar Pradesh,Ghazipur,Birano,131,38,2,hab,2,0,6,125,129,33,963,194,25.753108619807147,83.54746161620477,0
Uttar Pradesh,Ghazipur,Deokali,181,23,6,hab,6,0,11,170,175,33,1501,194,25.55325089695054,83.36692766744501,0
Uttar Pradesh,Ghazipur,Ghazipur (Sadar),148,33,0,hab,0,0,0,148,148,33,1937,194,25.606694481567573,83.59050448657823,0
Uttar Pradesh,Ghazipur,Jakhania,199,10,1,hab,1,0,5,194,198,33,2373,194,25.775465853853518,83.40523187563079,0
Uttar Pradesh,Ghazipur,Jamania,134,5,12,hab,7,5,11,123,122,33,2412,194,25.432815691086244,83.5991395873855,0
Uttar Pradesh,Ghazipur,Karanda,110,14,9,hab,8,1,16,94,101,33,2758,194,25.488550904680956,83.49154266977425,0
Uttar Pradesh,Ghazipur,Kasimabad,194,21,1,hab,1,0,5,189,193,33,2813,194,25.78843387256335,83.70292559554969,0
Uttar Pradesh,Ghazipur,Manihari,199,24,0,hab,0,0,0,199,199,33,3677,194,25.671535087932522,83.4415894155696,0
Uttar Pradesh,Ghazipur,Maradah,113,24,4,hab,4,0,8,105,109,33,3720,194,25.781202946450477,83.60520731736034,0
Uttar Pradesh,Ghazipur,Muhammadabad,165,28,0,hab,0,0,0,165,165,33,3958,194,25.644033656502618,83.7464321110443,0
Uttar Pradesh,Ghazipur,Reotipur,90,10,2,hab,2,0,4,86,88,33,5162,194,25.531366697059532,83.70048033117845,0
Uttar Pradesh,Ghazipur,Sadat,191,5,1,hab,1,0,7,184,190,33,5234,194,25.672701441566293,83.25716096214941,0
Uttar Pradesh,Ghazipur,Saidpur,234,10,2,hab,2,0,4,230,232,33,5269,194,25.573339257749428,83.15628586877715,0
Uttar Pradesh,Gonda,Babhanjot,386,13,456,osm,443,13,382,4,-70,33,342,199,27.06936578353846,82.48867996520718,0
Uttar Pradesh,Gonda,Belsar,542,0,502,hab,468,34,537,5,40,33,712,199,26.940790704506036,81.88331365833665,0
Uttar Pradesh,Gonda,Chhapiya,353,6,507,osm,464,43,352,1,-154,33,1254,199,26.98030084069773,82.42310400659679,0
Uttar Pradesh,Gonda,Colonelganj,516,0,399,hab,392,7,512,4,117,33,1367,199,27.074122400225477,81.63679285578985,0
Uttar Pradesh,Gonda,Haldharmau,539,62,336,hab,336,0,524,15,203,33,2111,199,27.147149339169218,81.75519145867999,0
Uttar Pradesh,Gonda,Intiyathok,453,29,380,hab,374,6,438,15,73,33,2302,199,27.29170589316103,82.104065650648,0
Uttar Pradesh,Gonda,Jhanijhri,467,75,473,osm,436,37,433,34,-6,33,2494,199,27.11504562646389,81.97952815117138,0
Uttar Pradesh,Gonda,Katrabazar,571,23,565,osm,563,2,563,8,6,33,2846,199,27.231875136941888,81.78587543515445,0
Uttar Pradesh,Gonda,Mankapur,309,22,534,osm,500,34,307,2,-225,33,3693,199,27.07212099470686,82.2341973908158,0
Uttar Pradesh,Gonda,Mujehna,468,0,425,hab,398,27,468,0,43,33,3959,199,27.200800589425324,82.17145730614196,0
Uttar Pradesh,Gonda,Nawabganj,470,31,364,hab,345,19,453,17,106,33,4242,199,26.89821031381041,82.17602547837197,0
Uttar Pradesh,Gonda,Pandari Kripal,262,24,260,osm,255,5,261,1,2,33,4506,199,27.190237726787537,82.01238108459383,0
Uttar Pradesh,Gonda,Paraspur,758,89,518,hab,509,9,715,43,240,33,4551,199,27.015669358414172,81.78935371761807,0
Uttar Pradesh,Gonda,Rupaiyeedeeh,510,12,460,hab,456,4,508,2,50,33,5212,199,27.333956930214395,81.96760537969823,0
Uttar Pradesh,Gonda,Tarabganj,484,21,445,hab,408,37,470,14,39,33,5915,199,26.906362759088594,81.99350014269046,0
Uttar Pradesh,Gonda,Wazeer Ganj,405,14,507,osm,450,57,401,4,-102,33,6432,199,26.981161641316074,82.10401487951755,0
Uttar Pradesh,Gorakhpur,Bansgaon,302,74,1,hab,1,0,8,294,301,33,537,202,26.560150677264943,83.36035332657559,0
Uttar Pradesh,Gorakhpur,Barhalganj,557,71,0,hab,0,0,0,557,557,33,591,202,26.308606065765034,83.56196478287318,0
Uttar Pradesh,Gorakhpur,Belghat,369,49,0,hab,0,0,0,369,369,33,702,202,26.43903137074399,83.17376618659105,0
Uttar Pradesh,Gorakhpur,Bhathat,304,32,37,hab,35,2,63,241,267,33,817,202,26.894308022046136,83.45754299422343,0
Uttar Pradesh,Gorakhpur,Brahmpur,277,49,0,hab,0,0,0,277,277,33,1048,202,26.57011848134471,83.55818781868659,0
Uttar Pradesh,Gorakhpur,Campierganj,541,26,209,hab,205,4,293,248,332,33,1092,202,27.032444877582872,83.26549952991152,0
Uttar Pradesh,Gorakhpur,Chargawan,330,6,2,hab,0,2,0,330,328,33,1187,202,26.811277900438814,83.39462641781543,0
Uttar Pradesh,Gorakhpur,Gagha,319,81,0,hab,0,0,0,319,319,33,1802,202,26.398820451954435,83.45988214802206,0
Uttar Pradesh,Gorakhpur,Gola,523,44,1,hab,1,0,6,517,522,33,1979,202,26.377407254558975,83.3735233281701,0
Uttar Pradesh,Gorakhpur,Jungle Kaudia,267,27,4,hab,4,0,9,258,263,33,2543,202,26.866478797268492,83.2829226682768,0
Uttar Pradesh,Gorakhpur,Kauri Ram,228,68,0,hab,0,0,0,228,228,33,2860,202,26.541860502875622,83.44927333201638,0
Uttar Pradesh,Gorakhpur,Khajani,462,47,1,hab,1,0,12,450,461,33,2922,202,26.619505531689327,83.22688477376332,0
Uttar Pradesh,Gorakhpur,Khorabar,445,73,0,hab,0,0,0,445,445,33,3014,202,26.67954998390939,83.47462526735706,0
Uttar Pradesh,Gorakhpur,Pali,246,4,0,hab,0,0,0,246,246,33,4462,202,26.824069073681727,83.18098766992318,0
Uttar Pradesh,Gorakhpur,Pipraich,303,78,1,hab,1,0,10,293,302,33,4768,202,26.777689825296374,83.53146042079317,0
Uttar Pradesh,Gorakhpur,Piprauli,193,17,1,hab,1,0,6,187,192,33,4770,202,26.68848346598739,83.33047138013008,0
Uttar Pradesh,Gorakhpur,Sahjanwa,191,14,1,hab,1,0,5,186,190,33,5262,202,26.69893385108881,83.17233978704063,0
Uttar Pradesh,Gorakhpur,Sardarnagar,368,96,0,hab,0,0,0,368,368,33,5409,202,26.690902108524057,83.58631311816211,0
Uttar Pradesh,Gorakhpur,Urwa,381,61,2,hab,2,0,10,371,379,33,6232,202,26.493173540316885,83.26835859248037,0
Uttar Pradesh,Hamirpur,Gohand,84,6,10,hab,7,3,9,75,74,33,1975,212,25.705457089473622,79.55645517445893,0
Uttar Pradesh,Hamirpur,Kurara,94,0,2,hab,2,0,3,91,92,33,3277,212,25.980055757970025,80.00241106254919,0
Uttar Pradesh,Hamirpur,Maudaha,154,4,43,hab,37,6,54,100,111,33,3775,212,25.610398849538555,80.1281585182853,0
Uttar Pradesh,Hamirpur,Muskara,82,3,15,hab,12,3,14,68,67,33,4021,212,25.67887987382551,79.86009811273946,0
Uttar Pradesh,Hamirpur,Rath,64,1,18,hab,17,1,18,46,46,33,5117,212,25.578650911933746,79.5099137574886,0
Uttar Pradesh,Hamirpur,Sarila,98,8,5,hab,5,0,8,90,93,33,5414,212,25.810308300989856,79.70956437952603,0
Uttar Pradesh,Hamirpur,Sumerpur,104,1,8,hab,7,1,4,100,96,33,5804,212,25.832746589919626,80.14645966804358,0
Uttar Pradesh,Hapur,Dhaulana,76,5,5,hab,2,3,3,73,71,33,6945,611,28.644697323033267,77.65566191997986,0
Uttar Pradesh,Hapur,Garhmukteshwar,94,3,1,hab,1,0,2,92,93,33,6942,611,28.76308143907171,78.08745574482855,0
Uttar Pradesh,Hapur,Hapur,136,15,0,hab,0,0,0,136,136,33,6944,611,28.698059082231197,77.81277667095895,0
Uttar Pradesh,Hapur,Simbhawali,93,9,1,hab,0,1,0,93,92,33,6943,611,28.773697085966266,77.9473296816247,0
Uttar Pradesh,Hardoi,Ahrori,359,12,4,hab,4,0,14,345,355,33,41,215,27.317471144960223,80.30736591780045,0
Uttar Pradesh,Hardoi,Bawan,267,21,0,hab,0,0,0,267,267,33,670,215,27.421107405992586,79.99946771218406,0
Uttar Pradesh,Hardoi,Behndar,281,26,0,hab,0,0,0,281,281,33,690,215,27.02184492026702,80.41122503952766,0
Uttar Pradesh,Hardoi,Bharawan,342,73,3,hab,3,0,17,325,339,33,808,215,27.160731831397285,80.71034091935452,0
Uttar Pradesh,Hardoi,Bharkhani,375,10,1,hab,1,0,4,371,374,33,810,215,27.55659790529717,79.79132301925367,0
Uttar Pradesh,Hardoi,Bilgram,255,18,0,hab,0,0,0,255,255,33,947,215,27.185084024450813,80.00557537762491,0
Uttar Pradesh,Hardoi,Harpal Pur,233,26,1,hab,1,0,5,228,232,33,2161,215,27.3288990718818,79.7687013295949,0
Uttar Pradesh,Hardoi,Haryawan,174,9,1,hab,0,1,0,174,173,33,2170,215,27.54394357424763,80.19694627347842,0
Uttar Pradesh,Hardoi,Kachhauna,209,20,0,hab,0,0,0,209,209,33,2556,215,27.158736620747163,80.36419730123598,0
Uttar Pradesh,Hardoi,Kothawan,304,57,0,hab,0,0,0,304,304,33,3171,215,27.2464278457439,80.50098367810463,0
Uttar Pradesh,Hardoi,Madhoganj,271,18,1,hab,1,0,5,266,270,33,3483,215,27.075048160592992,80.12061510693452,0
Uttar Pradesh,Hardoi,Mallawan,160,36,1,hab,0,1,0,160,159,33,3604,215,27.037847551867845,80.19650038251375,0
Uttar Pradesh,Hardoi,Pihani,275,20,1,hab,1,0,3,272,274,33,4749,215,27.662464464286366,80.19173803048818,0
Uttar Pradesh,Hardoi,Sandi,210,23,0,hab,0,0,0,210,210,33,5341,215,27.2684965877594,79.89245553571084,0
Uttar Pradesh,Hardoi,Sandila,287,60,1,hab,0,1,0,287,286,33,5342,215,27.1028098145966,80.570026968904,0
Uttar Pradesh,Hardoi,Shahbad,287,26,0,hab,0,0,0,287,287,33,5507,215,27.58765459281226,79.93145063562007,0
Uttar Pradesh,Hardoi,Sursa,338,17,0,hab,0,0,0,338,338,33,5822,215,27.271358058777647,80.14099955221971,0
Uttar Pradesh,Hardoi,Tandiyawan,265,16,5,hab,5,0,6,259,260,33,5895,215,27.438574226912742,80.27318720590407,0
Uttar Pradesh,Hardoi,Todarpur,242,24,0,hab,0,0,0,242,242,33,6123,215,27.650960540944627,80.05395967682686,0
Uttar Pradesh,Hathras,Hasayan,205,9,14,hab,11,3,13,192,191,33,2177,218,27.63660524535864,78.33231650549199,0
Uttar Pradesh,Hathras,Hathras,164,3,0,hab,0,0,0,164,164,33,2190,218,27.571557391594986,78.1454856041503,0
Uttar Pradesh,Hathras,Mursan,203,9,46,hab,46,0,57,146,157,33,4013,218,27.55249209830488,77.9827088065257,0
Uttar Pradesh,Hathras,Sadabad,206,16,36,hab,35,1,39,167,170,33,5228,218,27.396613042347866,77.98643747856414,0
Uttar Pradesh,Hathras,Sahpau,128,2,17,hab,17,0,23,105,111,33,5264,218,27.451938300279256,78.11889065419074,0
Uttar Pradesh,Hathras,Sasani,172,9,89,hab,84,5,88,84,83,33,5428,218,27.69806724803289,78.10517504597294,0
Uttar Pradesh,Hathras,Sikendra-Rao,178,19,45,hab,43,2,49,129,133,33,5622,218,27.744170824348398,78.4338650799314,0
Uttar Pradesh,J.B.F.Nagar,Amroha,183,30,151,hab,143,8,160,23,32,33,163,232,28.974596622105917,78.45366529367365,0
Uttar Pradesh,J.B.F.Nagar,Dhanaura,182,13,123,hab,115,8,151,31,59,33,1553,232,28.976960675351986,78.18969209113983,0
Uttar Pradesh,J.B.F.Nagar,Gajraula,135,3,132,hab,115,17,125,10,3,33,1812,232,28.841913043982885,78.23498437077394,0
Uttar Pradesh,J.B.F.Nagar,Gangeshwari,145,0,132,hab,119,13,134,11,13,33,1852,232,28.564187578549188,78.3021573952079,0
Uttar Pradesh,J.B.F.Nagar,Hasanpur,163,14,149,hab,140,9,145,18,14,33,2174,232,28.717236936322582,78.32895798528384,0
Uttar Pradesh,J.B.F.Nagar,Joya,237,20,186,hab,168,18,206,31,51,33,2532,232,28.855448610053138,78.49285737720095,0
Uttar Pradesh,Jalaun,Dakor,138,3,4,hab,4,0,4,134,134,33,1402,241,25.92745808851581,79.41188819407128,0
Uttar Pradesh,Jalaun,Jalaun,103,1,6,hab,6,0,7,96,97,33,2391,241,26.136703434165096,79.34800428704517,0
Uttar Pradesh,Jalaun,Kadaura,132,5,2,hab,2,0,2,130,130,33,2562,241,26.00694213628341,79.75910117437793,0
Uttar Pradesh,Jalaun,Konch,110,5,0,hab,0,0,0,110,110,33,3111,241,25.947811158199954,79.1493598289146,0
Uttar Pradesh,Jalaun,Kuthond,237,1,2,hab,2,0,12,225,235,33,3310,241,26.338210660506466,79.41454140954991,0
Uttar Pradesh,Jalaun,Madhogarh,230,45,4,hab,4,0,18,212,226,33,3484,241,26.265015886245273,79.19600751928833,0
Uttar Pradesh,Jalaun,Mahewa,109,0,4,hab,4,0,4,105,105,33,3529,241,26.174305736262756,79.58191072104034,0
Uttar Pradesh,Jalaun,Nadigaon,159,8,6,hab,2,4,2,157,153,33,4050,241,26.107843455922236,79.09897266982344,0
Uttar Pradesh,Jalaun,Rampura,109,2,21,hab,20,1,33,76,88,33,5068,241,26.374546347217294,79.21835790235949,0
Uttar Pradesh,Jaunpur,Badalapur,227,6,2,hab,2,0,9,218,225,33,351,252,25.932893313874967,82.4678063665661,0
Uttar Pradesh,Jaunpur,Barsathi,226,11,0,hab,0,0,0,226,226,33,620,252,25.560542212463012,82.47642464318297,0
Uttar Pradesh,Jaunpur,Buxa,209,10,1,hab,1,0,3,206,208,33,1085,252,25.825894834256346,82.52168057929165,0
Uttar Pradesh,Jaunpur,Dharmapur,128,8,2,hab,0,2,0,128,126,33,1588,252,25.722375892882468,82.75064638552077,0
Uttar Pradesh,Jaunpur,Dobhi,270,1,1,hab,1,0,11,259,269,33,1649,252,25.62763663037176,83.02491484836698,0
Uttar Pradesh,Jaunpur,Jalalpur,251,1,1,hab,1,0,4,247,250,33,2385,252,25.598248145949007,82.78917306726038,0
Uttar Pradesh,Jaunpur,Karanja Kala,224,8,0,hab,0,0,0,224,224,33,2762,252,25.81281409951465,82.67700804155461,0
Uttar Pradesh,Jaunpur,Kerakat,432,11,1,hab,1,0,4,428,431,33,2886,252,25.62340893229168,82.92739211279158,0
Uttar Pradesh,Jaunpur,Khutahan,306,8,3,hab,3,0,19,287,303,33,3029,252,25.987952141966854,82.58293235657648,0
Uttar Pradesh,Jaunpur,Machhali Shahar,176,3,2,hab,2,0,3,173,174,33,3457,252,25.642595502240294,82.37261715396471,0
Uttar Pradesh,Jaunpur,Maharajganj,291,20,0,hab,0,0,0,291,291,33,3521,252,25.851922459793922,82.35297670678511,0
Uttar Pradesh,Jaunpur,Mariyahun,419,11,0,hab,0,0,0,419,419,33,3731,252,25.658487487254497,82.56077318628446,0
Uttar Pradesh,Jaunpur,Muftiganj,139,4,0,hab,0,0,0,139,139,33,3956,252,25.71096810009205,82.86156304827945,0
Uttar Pradesh,Jaunpur,Mungra Badshapur,154,2,1,hab,0,1,0,154,153,33,3997,252,25.639150445136362,82.23539297833071,0
Uttar Pradesh,Jaunpur,Ram Nagar,277,9,0,hab,0,0,0,277,277,33,5013,252,25.561188327762764,82.63848018585708,0
Uttar Pradesh,Jaunpur,Rampur,238,9,1,hab,1,0,8,230,237,33,5059,252,25.46941206613205,82.6288870267951,0
Uttar Pradesh,Jaunpur,Shahganj,280,15,2,hab,2,0,7,273,278,33,5509,252,25.98162586818395,82.68290864389418,0
Uttar Pradesh,Jaunpur,Sikrara,198,1,1,hab,0,1,0,198,197,33,5626,252,25.73813678684899,82.568520199088,0
Uttar Pradesh,Jaunpur,Sirkoni,261,71,3,hab,3,0,17,244,258,33,5673,252,25.66850187841435,82.73470246567564,0
Uttar Pradesh,Jaunpur,Suitha Kala,156,22,1,hab,1,0,3,153,155,33,5782,252,26.106257097196593,82.546459782969,0
Uttar Pradesh,Jaunpur,Sujanganj,250,12,0,hab,0,0,0,250,250,33,5783,252,25.76508000574377,82.2973668599613,0
Uttar Pradesh,Jhansi,Babina,256,5,142,hab,131,11,217,39,114,33,343,256,25.337692189616504,78.46006002901922,0
Uttar Pradesh,Jhansi,Badagaon,202,0,114,hab,84,30,170,32,88,33,350,256,25.494874080205367,78.67472479935186,0
Uttar Pradesh,Jhansi,Bamaur,224,2,34,hab,30,4,64,160,190,33,482,256,25.685280364600473,79.20795871566634,0
Uttar Pradesh,Jhansi,Bangra,227,22,13,hab,13,0,37,190,214,33,511,256,25.32244084094108,78.96870196318359,0
Uttar Pradesh,Jhansi,Chirgaon,215,61,6,hab,6,0,14,201,209,33,1321,256,25.626349580313,78.8921731530331,0
Uttar Pradesh,Jhansi,Gursarai,242,15,34,hab,32,2,61,181,208,33,2085,256,25.496137748594553,79.18906954843774,0
Uttar Pradesh,Jhansi,Mauranipur,196,9,28,hab,27,1,46,150,168,33,3778,256,25.267424658908652,79.17388009898765,0
Uttar Pradesh,Jhansi,Moth,301,24,2,hab,2,0,3,298,299,33,3934,256,25.812341225332734,78.95549437173104,0
Uttar Pradesh,Kannauj,Chibramau,366,3,0,hab,0,0,0,366,366,33,1272,270,27.13453161442431,79.50877940609979,0
Uttar Pradesh,Kannauj,Haseran,230,15,0,hab,0,0,0,230,230,33,2178,270,26.940531874591812,79.56707239930388,0
Uttar Pradesh,Kannauj,Jalalabad,236,4,0,hab,0,0,0,236,236,33,2382,270,27.102770343026553,79.80921456437113,0
Uttar Pradesh,Kannauj,Kannauj,269,8,0,hab,0,0,0,269,269,33,2732,270,27.022185887376196,79.89266417233424,0
Uttar Pradesh,Kannauj,Saurikh,269,35,1,hab,1,0,3,266,268,33,5450,270,27.002607217124467,79.45852210832487,0
Uttar Pradesh,Kannauj,Talgram,275,29,1,hab,1,0,4,271,274,33,5871,270,27.09369228066529,79.67487772857821,0
Uttar Pradesh,Kannauj,Umarda,548,2,1,hab,1,0,9,539,547,33,6200,270,26.89503668702257,79.79617372487373,0
Uttar Pradesh,Kanpur Dehat,Akabarpur,210,4,2,hab,0,2,0,210,208,33,52,273,26.42961771674283,79.95015422159912,0
Uttar Pradesh,Kanpur Dehat,Amraudha,192,12,1,hab,1,0,5,187,191,33,159,273,26.185224052655833,79.83282449668248,0
Uttar Pradesh,Kanpur Dehat,Derapur,149,17,1,hab,1,0,4,145,148,33,1516,273,26.444482827662153,79.81203034478203,0
Uttar Pradesh,Kanpur Dehat,Jhinjhak,249,24,2,hab,2,0,3,246,247,33,2502,273,26.56342660583659,79.75330401611075,0
Uttar Pradesh,Kanpur Dehat,Maitha,306,29,1,hab,1,0,2,304,305,33,3558,273,26.552178798718334,80.03433082187787,0
Uttar Pradesh,Kanpur Dehat,Malasa,214,21,1,hab,0,1,0,214,213,33,3583,273,26.27987384971467,79.88768815540476,0
Uttar Pradesh,Kanpur Dehat,Rajpur,160,3,2,hab,2,0,3,157,158,33,4998,273,26.323773563730043,79.6393324182329,0
Uttar Pradesh,Kanpur Dehat,Rasoolabad,593,18,1,hab,1,0,18,575,592,33,5113,273,26.692912958570492,79.84593820202915,0
Uttar Pradesh,Kanpur Dehat,Sandalpur,156,7,0,hab,0,0,0,156,156,33,5337,273,26.442923146033877,79.67796490557853,0
Uttar Pradesh,Kanpur Dehat,Sarwan Khera,212,18,10,hab,10,0,13,199,202,33,5427,273,26.355880989335333,80.07716537136236,0
Uttar Pradesh,Kanpur Nagar,Bhitargaon,368,15,1,hab,1,0,3,365,367,33,862,274,26.18194069233403,80.33254921832184,0
Uttar Pradesh,Kanpur Nagar,Bidhunu,422,27,12,hab,12,0,55,367,410,33,911,274,26.334317817301226,80.26847547437296,0
Uttar Pradesh,Kanpur Nagar,Bilhaur,351,28,2,hab,2,0,14,337,349,33,949,274,26.842608295402556,80.05109625968487,0
Uttar Pradesh,Kanpur Nagar,Chaubeypur,329,20,0,hab,0,0,0,329,329,33,1199,274,26.61538131654732,80.20532509712257,0
Uttar Pradesh,Kanpur Nagar,Ghatampur,374,27,0,hab,0,0,0,374,374,33,1927,274,26.086972871812108,80.12622342964178,0
Uttar Pradesh,Kanpur Nagar,Kakvan,216,21,0,hab,0,0,0,216,216,33,2601,274,26.800329638860912,79.97661645753271,0
Uttar Pradesh,Kanpur Nagar,Kalyanpur,372,26,2,hab,2,0,4,368,370,33,2667,274,26.455818997087086,80.28795654757582,0
Uttar Pradesh,Kanpur Nagar,Patara,321,32,5,hab,4,1,19,302,316,33,4597,274,26.225835645055078,80.14608629065418,0
Uttar Pradesh,Kanpur Nagar,Sarsaul,350,49,1,hab,1,0,3,347,349,33,5421,274,26.280622924492498,80.47668369899172,0
Uttar Pradesh,Kanpur Nagar,Shivrajpur,374,24,1,hab,1,0,6,368,373,33,5584,274,26.67645671845616,80.08282250922242,0
Uttar Pradesh,Kasganj,Amanpur,210,62,8,hab,8,0,13,197,202,33,7047,631,27.741713321347174,78.77138078170097,0
Uttar Pradesh,Kasganj,Ganjdundwara,198,43,8,hab,8,0,10,188,190,33,7045,631,27.78098699373771,79.04323710977783,0
Uttar Pradesh,Kasganj,Kasganj,221,43,34,hab,34,0,41,180,187,33,7050,631,27.822588089040625,78.58499889401243,0
Uttar Pradesh,Kasganj,Patiyali,259,54,0,hab,0,0,0,259,259,33,7044,631,27.650399887400436,79.06560848145291,0
Uttar Pradesh,Kasganj,Sahawar,157,51,2,hab,2,0,5,152,155,33,7049,631,27.81894573861368,78.85667419455255,0
Uttar Pradesh,Kasganj,Sidhpura,183,48,1,hab,1,0,2,181,182,33,7046,631,27.66054460963718,78.90285126658044,0
Uttar Pradesh,Kasganj,Soron,286,29,23,hab,22,1,40,246,263,33,7048,631,27.917756225816436,78.69476703245907,0
Uttar Pradesh,Kaushambi,Chail,118,0,0,hab,0,0,0,118,118,33,1106,287,25.45296853304265,81.61545376672922,0
Uttar Pradesh,Kaushambi,Kara,213,0,1,hab,1,0,4,209,212,33,2750,287,25.70308177888586,81.32829639196723,0
Uttar Pradesh,Kaushambi,Kaushambi,239,0,74,hab,74,0,87,152,165,33,2861,287,25.352910098169225,81.45432393707328,0
Uttar Pradesh,Kaushambi,Manjhanpur,303,0,106,hab,105,1,110,193,197,33,3686,287,25.47761727591485,81.41436875276099,0
Uttar Pradesh,Kaushambi,Mooratganj,219,0,2,hab,2,0,11,208,217,33,3915,287,25.527634313608917,81.57446892691155,0
Uttar Pradesh,Kaushambi,Newada,267,0,26,hab,21,5,29,238,241,33,4284,287,25.361280966422466,81.5713964774294,0
Uttar Pradesh,Kaushambi,Sarsawan,383,0,53,hab,48,5,117,266,330,33,5423,287,25.413959233595254,81.2803848039361,0
Uttar Pradesh,Kaushambi,Sirathu,701,0,4,hab,2,2,13,688,697,33,5667,287,25.586826332828423,81.36170007148449,0
Uttar Pradesh,Kushinagar,Dudhai,520,64,1,hab,1,0,14,506,519,33,1682,322,26.805461581744513,84.15129849924122,0
Uttar Pradesh,Kushinagar,Fazil Nagar,354,46,4,hab,4,0,20,334,350,33,1780,322,26.655956915772368,84.01943055494323,0
Uttar Pradesh,Kushinagar,Hata,309,99,2,hab,2,0,16,293,307,33,2185,322,26.756828675964165,83.75831009126823,0
Uttar Pradesh,Kushinagar,Kaptanganj,257,95,53,hab,53,0,101,156,204,33,2747,322,26.905429477116176,83.63411310547123,0
Uttar Pradesh,Kushinagar,Kasiya,617,146,3,hab,3,0,62,555,614,33,2817,322,26.75814886663015,83.91937712669589,0
Uttar Pradesh,Kushinagar,Khadda,411,19,21,hab,9,12,16,395,390,33,2906,322,27.16307589419202,83.89506838603484,0
Uttar Pradesh,Kushinagar,Moti Chak,261,93,0,hab,0,0,0,261,261,33,3937,322,26.835604745091963,83.69686588067087,0
Uttar Pradesh,Kushinagar,Nebuwa Naurangiya,377,72,19,hab,17,2,33,344,358,33,4262,322,27.021311703761913,83.82163051609078,0
Uttar Pradesh,Kushinagar,Padrauna,623,124,8,hab,8,0,34,589,615,33,4421,322,26.85970513471593,83.97384985412364,0
Uttar Pradesh,Kushinagar,Ramkola,437,149,26,hab,24,2,31,406,411,33,5046,322,26.890146068660325,83.78721414884077,0
Uttar Pradesh,Kushinagar,Seorahi,736,209,0,hab,0,0,0,736,736,33,5488,322,26.665931682770324,84.31523310517473,0
Uttar Pradesh,Kushinagar,Sukrauli,254,78,0,hab,0,0,0,254,254,33,5788,322,26.77277317386864,83.62541505305079,0
Uttar Pradesh,Kushinagar,Tamkuhi,329,59,4,hab,3,1,20,309,325,33,5886,322,26.68558715951379,84.1501029146822,0
Uttar Pradesh,Kushinagar,Visunpura,519,52,0,hab,0,0,0,519,519,33,6386,322,26.978589344905235,83.95568916966354,0
Uttar Pradesh,Lakhimpur-Kherii,Bankeyganj,294,19,2,hab,2,0,9,285,292,33,525,326,28.20213962773761,80.43277830384834,0
Uttar Pradesh,Lakhimpur-Kherii,Behjam,273,16,1,hab,1,0,6,267,272,33,689,326,27.894440287080105,80.6081134417043,0
Uttar Pradesh,Lakhimpur-Kherii,Bijuwa,301,10,11,hab,11,0,23,278,290,33,933,326,28.251435900826564,80.59407371440079,0
Uttar Pradesh,Lakhimpur-Kherii,Dhaurahara,278,5,3,hab,3,0,8,270,275,33,1605,326,27.967133233261308,81.09140529341124,0
Uttar Pradesh,Lakhimpur-Kherii,Isanager,437,46,17,hab,7,10,13,424,420,33,2309,326,27.83931064545677,81.19659633519467,0
Uttar Pradesh,Lakhimpur-Kherii,Kumbhi / Gola,266,8,1,hab,1,0,1,265,265,33,3249,326,27.992083726055977,80.39637750867784,0
Uttar Pradesh,Lakhimpur-Kherii,Lakhimpur,334,31,8,hab,8,0,14,320,326,33,3341,326,27.94421247687983,80.69405760363168,0
Uttar Pradesh,Lakhimpur-Kherii,Mitauli,353,12,1,hab,1,0,4,349,352,33,3869,326,27.84479228379435,80.46787158345822,0
Uttar Pradesh,Lakhimpur-Kherii,Mohammdi,269,38,1,hab,1,0,4,265,268,33,3884,326,28.002507691219957,80.23888894273989,0
Uttar Pradesh,Lakhimpur-Kherii,Nakaha,301,129,24,hab,23,1,57,244,277,33,4097,326,27.933299805747318,80.92882949941134,0
Uttar Pradesh,Lakhimpur-Kherii,Nighasan,396,25,6,hab,4,2,11,385,390,33,4296,326,28.28342832953284,80.8700105657903,0
Uttar Pradesh,Lakhimpur-Kherii,Paliya,294,4,10,hab,4,6,22,272,284,33,4470,326,28.486600225778535,80.62256351157006,0
Uttar Pradesh,Lakhimpur-Kherii,Pasgawan,308,2,1,hab,1,0,1,307,307,33,4587,326,27.818834494390266,80.21619190806238,0
Uttar Pradesh,Lakhimpur-Kherii,Phoolbehar,299,5,156,hab,138,18,192,107,143,33,4737,326,28.03300598814641,80.796778143113,0
Uttar Pradesh,Lakhimpur-Kherii,Ramia Behar,327,11,24,hab,10,14,47,280,303,33,5044,326,28.155011733104207,81.04250003404698,0
Uttar Pradesh,Lalitpur,Bar,201,5,2,hab,2,0,5,196,199,33,552,328,24.804745587181305,78.63523184060575,0
Uttar Pradesh,Lalitpur,Birdha,173,4,6,hab,6,0,8,165,167,33,965,328,24.52414029373806,78.44005058679971,0
Uttar Pradesh,Lalitpur,Jakhora,242,12,2,hab,2,0,3,239,240,33,2376,328,24.7760907671249,78.35655883689216,0
Uttar Pradesh,Lalitpur,Madawara,144,4,9,hab,8,1,11,133,135,33,3471,328,24.35259336726641,78.74260210969099,0
Uttar Pradesh,Lalitpur,Mahroni,126,0,6,hab,5,1,7,119,120,33,3541,328,24.526158820597555,78.77456920046522,0
Uttar Pradesh,Lalitpur,Talbehat,281,3,18,hab,14,4,24,257,263,33,5867,328,25.029476305848487,78.49566697701427,0
Uttar Pradesh,Lucknow,Bakshi Ka Talab,438,44,2,hab,2,0,10,428,436,33,433,338,27.04515484909702,80.94923227172045,0
Uttar Pradesh,Lucknow,Chinhat,160,17,5,hab,3,2,9,151,155,33,1296,338,26.90334877319763,80.97760463328648,0
Uttar Pradesh,Lucknow,Gosaiganj,331,3,1,hab,1,0,3,328,330,33,2019,338,26.745542433443468,81.11258100440855,0
Uttar Pradesh,Lucknow,Kakori,179,18,1,hab,1,0,3,176,178,33,2598,338,26.876950810187058,80.78357526229436,0
Uttar Pradesh,Lucknow,Malihabad,219,16,0,hab,0,0,0,219,219,33,3593,338,26.95004949622655,80.68842167830984,0
Uttar Pradesh,Lucknow,Mall,284,69,1,hab,1,0,5,279,283,33,3600,338,27.04256296762883,80.76112414510699,0
Uttar Pradesh,Lucknow,Mohanlalganj,371,2,3,hab,3,0,10,361,368,33,3887,338,26.624627730693714,81.02383713706774,0
Uttar Pradesh,Lucknow,Sarojininagar,302,13,5,hab,1,4,1,301,297,33,5417,338,26.76042046284007,80.86768849914549,0
Uttar Pradesh,Maharajganj,Brijmanganj,515,4,395,hab,387,8,514,1,120,33,1051,345,27.231204754285923,83.26796720224814,0
Uttar Pradesh,Maharajganj,Dhani,185,7,116,hab,116,0,185,0,69,33,1557,345,27.13602115999128,83.1847764817462,0
Uttar Pradesh,Maharajganj,Gughali,249,9,275,osm,237,38,247,2,-26,33,2054,345,27.022633195607547,83.66640883071858,0
Uttar Pradesh,Maharajganj,Laxmipur,425,12,333,hab,320,13,419,6,92,33,3401,345,27.2898263596049,83.45130855788966,0
Uttar Pradesh,Maharajganj,Maharajganj,423,13,261,hab,240,21,403,20,162,33,3522,345,27.146848102102553,83.51130486371042,0
Uttar Pradesh,Maharajganj,Mithaura,265,18,198,hab,192,6,260,5,67,33,3870,345,27.255923608625622,83.61418494255723,0
Uttar Pradesh,Maharajganj,Nautanwa,448,6,309,hab,305,4,429,19,139,33,4236,345,27.416277940556405,83.52125768196353,0
Uttar Pradesh,Maharajganj,Nichlaul,456,22,270,hab,262,8,431,25,186,33,4290,345,27.3099524181428,83.77313877541984,0
Uttar Pradesh,Maharajganj,Paniyara,566,5,390,hab,382,8,566,0,176,33,4522,345,27.027032733626157,83.44803572445929,0
Uttar Pradesh,Maharajganj,Partawal,274,49,219,hab,216,3,234,40,55,33,4578,345,26.97332745246555,83.53486265579642,0
Uttar Pradesh,Maharajganj,Pharenda,505,9,330,hab,320,10,504,1,175,33,4730,345,27.13532304419834,83.33547275999818,0
Uttar Pradesh,Maharajganj,Siswa,306,19,189,hab,180,9,300,6,117,33,5688,345,27.14605659261639,83.72127915064036,0
Uttar Pradesh,Mahoba,Charkhari,102,12,66,hab,57,9,69,33,36,33,1188,347,25.43393613977092,79.75527318877342,0
Uttar Pradesh,Mahoba,Jaitpur,114,16,86,hab,79,7,89,25,28,33,2369,347,25.232924532802947,79.56498525624421,0
Uttar Pradesh,Mahoba,Kabarai,192,39,122,hab,109,13,145,47,70,33,2553,347,25.329166532609044,79.89497176713492,0
Uttar Pradesh,Mahoba,Panwari,130,7,102,hab,97,5,108,22,28,33,4531,347,25.385977451633487,79.45010028771424,0
Uttar Pradesh,Mainpuri,Barnahal,231,26,0,hab,0,0,0,231,231,33,612,348,27.063056851730046,78.85201960074589,0
Uttar Pradesh,Mainpuri,Bewar,356,5,1,hab,1,0,1,355,355,33,739,348,27.19988162121207,79.29811602481323,0
Uttar Pradesh,Mainpuri,Ghiror,270,8,13,hab,13,0,18,252,257,33,1939,348,27.24075916058783,78.81375974763921,0
Uttar Pradesh,Mainpuri,Jagir,235,12,0,hab,0,0,0,235,235,33,2345,348,27.15503002668122,79.13689620752953,0
Uttar Pradesh,Mainpuri,Karhal,380,27,1,hab,1,0,2,378,379,33,2776,348,27.026803786257513,78.99933403747428,0
Uttar Pradesh,Mainpuri,Kishni,399,4,1,hab,1,0,1,398,398,33,3052,348,27.051828082072745,79.27257700581742,0
Uttar Pradesh,Mainpuri,Kurawali,214,3,1,hab,1,0,3,211,213,33,3279,348,27.374324847466898,78.93694022390012,0
Uttar Pradesh,Mainpuri,Mainpuri,345,10,0,hab,0,0,0,345,345,33,3555,348,27.21574639361711,78.98031719063667,0
Uttar Pradesh,Mainpuri,Sultanganj,292,4,1,hab,1,0,3,289,291,33,5796,348,27.3128188226557,79.12694293049795,0
Uttar Pradesh,Mathura,Baldev,235,5,112,hab,109,3,151,84,123,33,446,358,27.381954830009928,77.83808064134357,0
Uttar Pradesh,Mathura,Chata,120,6,30,hab,29,1,49,71,90,33,1193,358,27.77391375343988,77.52517540903105,0
Uttar Pradesh,Mathura,Chaumuha,100,12,23,hab,22,1,35,65,77,33,1203,358,27.654251402327862,77.56584999709959,0
Uttar Pradesh,Mathura,Farah,116,1,61,hab,60,1,73,43,55,33,1759,358,27.310016138430573,77.70975690014383,0
Uttar Pradesh,Mathura,Goverdhan,180,3,39,hab,38,1,75,105,141,33,2026,358,27.466858995472744,77.48061428291882,0
Uttar Pradesh,Mathura,Manth,167,13,71,hab,65,6,106,61,96,33,3709,358,27.657770878595564,77.74499152145809,0
Uttar Pradesh,Mathura,Mathura,194,19,47,hab,46,1,80,114,147,33,3765,358,27.50317797458266,77.62306265643186,0
Uttar Pradesh,Mathura,Nahjheel,150,10,84,hab,80,4,99,51,66,33,4088,358,27.848601765325775,77.68261121295407,0
Uttar Pradesh,Mathura,Nandgaon,72,3,36,hab,35,1,43,29,36,33,4138,358,27.748614842988488,77.38685840348207,0
Uttar Pradesh,Mathura,Raya,232,13,85,hab,84,1,158,74,147,33,5132,358,27.53773550786365,77.81277335663344,0
Uttar Pradesh,Mau,Badraon,262,14,1,hab,1,0,9,253,261,33,366,359,26.15609985992042,83.49094929921975,0
Uttar Pradesh,Mau,Dohrighat,375,46,2,hab,2,0,11,364,373,33,1654,359,26.212728350998752,83.59559160442959,0
Uttar Pradesh,Mau,Fatehpur Mandaon,160,17,5,hab,5,0,9,151,155,33,1776,359,26.15932680125336,83.72689728472085,0
Uttar Pradesh,Mau,Ghosi,402,90,4,hab,4,0,30,372,398,33,1947,359,26.094985372617927,83.60118803817608,0
Uttar Pradesh,Mau,Kopaganj,316,53,2,hab,2,0,24,292,314,33,3125,359,26.012573820001997,83.5684511089823,0
Uttar Pradesh,Mau,Mohammdabad,718,62,0,hab,0,0,0,718,718,33,3883,359,26.016401220576835,83.38834738412703,0
Uttar Pradesh,Mau,Pardaha,316,46,1,hab,1,0,1,315,315,33,4562,359,25.914012700132616,83.54583451760732,0
Uttar Pradesh,Mau,Ranipur,645,60,2,hab,1,1,9,636,643,33,5098,359,25.911632930610775,83.41942012197336,0
Uttar Pradesh,Mau,Rattanpura,509,63,1,hab,1,0,4,505,508,33,5122,359,25.940218267478986,83.71929428836152,0
Uttar Pradesh,Meerut,Daurala,57,1,21,hab,21,0,25,32,36,33,1469,362,29.10857148963854,77.72881451691484,0
Uttar Pradesh,Meerut,Hastinapur,96,1,8,hab,7,1,8,88,88,33,2183,362,29.155893946470744,78.02121192125522,0
Uttar Pradesh,Meerut,Jani Khurd,57,0,41,hab,41,0,47,10,16,33,2441,362,28.94976616720225,77.54443544470647,0
Uttar Pradesh,Meerut,Kharkhoda,41,0,23,hab,19,4,20,21,18,33,2976,362,28.826879396327364,77.76998639467648,0
Uttar Pradesh,Meerut,Machhra,51,1,1,hab,0,1,0,51,50,33,3459,362,28.917168342140098,77.90737109052193,0
Uttar Pradesh,Meerut,Mawana,58,1,12,hab,11,1,11,47,46,33,3785,362,29.140906071981487,77.87449278396859,0
Uttar Pradesh,Meerut,Meerut,25,0,26,osm,18,8,18,7,-1,33,3810,362,28.953400781094622,77.69071851312279,0
Uttar Pradesh,Meerut,Parikshatgarh,80,2,0,hab,0,0,0,80,80,33,4567,362,28.9795174885407,77.98735317729563,0
Uttar Pradesh,Meerut,Rajpura,55,0,1,hab,1,0,1,54,54,33,5003,362,28.994202117359062,77.7992338104004,0
Uttar Pradesh,Meerut,Rasoolpur Rhota,47,0,25,hab,24,1,32,15,22,33,5114,362,29.040322674267763,77.54461435549476,0
Uttar Pradesh,Meerut,Sardhana,54,1,35,hab,34,1,34,20,19,33,5412,362,29.19009301624499,77.6512332325978,0
Uttar Pradesh,Meerut,Saroorpur,35,0,29,hab,26,3,28,7,6,33,5419,362,29.13274945012004,77.54181825075425,0
Uttar Pradesh,Mirzapur,Chhanbey,553,2,404,hab,372,32,549,4,149,33,1252,364,25.166811310153232,82.37130288593508,0
Uttar Pradesh,Mirzapur,Hallia,408,16,725,osm,653,72,385,23,-317,33,2116,364,24.78302480309828,82.3341061449748,0
Uttar Pradesh,Mirzapur,Jamalpur,357,12,303,hab,281,22,344,13,54,33,2411,364,25.09349959572615,83.06965045471682,0
Uttar Pradesh,Mirzapur,Kon,113,1,58,hab,53,5,107,6,55,33,3107,364,25.20097379623536,82.53655928548113,0
Uttar Pradesh,Mirzapur,Lalganj,257,2,520,osm,481,39,256,1,-263,33,3360,364,24.976867568965094,82.40526466378564,0
Uttar Pradesh,Mirzapur,Madihan,289,6,341,osm,310,31,272,17,-52,33,3491,364,24.905377690178273,82.58405753923975,0
Uttar Pradesh,Mirzapur,Majhawa,262,13,153,hab,150,3,231,31,109,33,3561,364,25.22306952992545,82.72775198800102,0
Uttar Pradesh,Mirzapur,Nagar (City),441,4,375,hab,338,37,425,16,66,33,4062,364,25.123791628459983,82.57375522995488,0
Uttar Pradesh,Mirzapur,Narainpur,606,9,248,hab,238,10,571,35,358,33,4162,364,25.1297964023431,82.96442054760588,0
Uttar Pradesh,Mirzapur,Pahadi,255,0,292,osm,263,29,246,9,-37,33,4424,364,25.058734704122852,82.69762197241248,0
Uttar Pradesh,Mirzapur,Raj Garh,516,2,752,osm,615,137,488,28,-236,33,4957,364,24.94494789687723,82.87938785451088,0
Uttar Pradesh,Mirzapur,Sikhar,84,1,69,hab,63,6,81,3,15,33,5623,364,25.156721722449575,82.81028097341478,0
Uttar Pradesh,Moradabad,Bhagatpur Tanda,173,16,128,hab,126,2,165,8,45,33,762,369,28.976491164175297,78.8854357912652,0
Uttar Pradesh,Moradabad,Bilari,217,61,156,hab,153,3,159,58,61,33,940,369,28.564470136136684,78.85989430935038,0
Uttar Pradesh,Moradabad,Chhajlet,173,8,148,hab,148,0,160,13,25,33,1251,369,28.995745608097625,78.62546291695669,0
Uttar Pradesh,Moradabad,Dilari,160,6,137,hab,127,10,156,4,23,33,1634,369,29.041303166428534,78.77062867418448,0
Uttar Pradesh,Moradabad,Dingarpur,153,4,157,osm,149,8,147,6,-4,33,1642,369,28.716477361798468,78.74424410076217,0
Uttar Pradesh,Moradabad,Moradabad,85,13,71,hab,64,7,72,13,14,33,3918,369,28.862165055745383,78.74968355323409,0
Uttar Pradesh,Moradabad,Mundapandey,134,6,133,osm,125,8,129,5,1,33,3987,369,28.78717022269689,78.90307941112674,0
Uttar Pradesh,Moradabad,Thakurdwara,135,3,136,osm,121,15,131,4,-1,33,5971,369,29.174061370960587,78.79545067484021,0
Uttar Pradesh,Muzaffarnagar,Baghra,53,6,46,hab,43,3,47,6,7,33,385,375,29.45439713005558,77.54109400231525,0
Uttar Pradesh,Muzaffarnagar,Budhana,68,23,44,hab,42,2,43,25,24,33,1058,375,29.282824901821524,77.46795516564431,0
Uttar Pradesh,Muzaffarnagar,Charthawal,75,12,61,hab,55,6,58,17,14,33,1191,375,29.5585370672819,77.57401595306098,0
Uttar Pradesh,Muzaffarnagar,Jansath,98,6,83,hab,70,13,76,22,15,33,2443,375,29.321420253616566,77.9374880591791,0
Uttar Pradesh,Muzaffarnagar,Khatauli,117,8,98,hab,95,3,104,13,19,33,2982,375,29.28615006266089,77.74073645675172,0
Uttar Pradesh,Muzaffarnagar,Morna,68,7,67,osm,51,16,60,8,1,33,3926,375,29.500250095784747,77.93128564477155,0
Uttar Pradesh,Muzaffarnagar,Muzaffarnagar,60,12,43,hab,34,9,37,23,17,33,4032,375,29.46572431659204,77.71778043615232,0
Uttar Pradesh,Muzaffarnagar,Purkazi,78,4,96,osm,68,28,67,11,-18,33,4869,375,29.62563942167959,77.88607048347419,0
Uttar Pradesh,Muzaffarnagar,Sahapur,42,0,47,osm,41,6,42,0,-5,33,5248,375,29.352433031416926,77.55878054861223,0
Uttar Pradesh,Pilibhit,Amaria,192,5,1,hab,1,0,1,191,191,33,114,430,28.76217251152406,79.76855607825067,0
Uttar Pradesh,Pilibhit,Barkhera,142,9,13,hab,13,0,18,124,129,33,609,430,28.43872210750086,79.8747967638843,0
Uttar Pradesh,Pilibhit,Bilsanda,170,3,10,hab,10,0,14,156,160,33,952,430,28.26290222760604,79.93012609733795,0
Uttar Pradesh,Pilibhit,Bisalpur,138,3,13,hab,13,0,12,126,125,33,975,430,28.287041110920526,79.78250515144546,0
Uttar Pradesh,Pilibhit,Lalauri Khera,125,9,0,hab,0,0,0,125,125,33,3357,430,28.58771287423709,79.74308157891996,0
Uttar Pradesh,Pilibhit,Marauri,184,9,8,hab,8,0,19,165,176,33,3722,430,28.64287387538912,79.8965503797018,0
Uttar Pradesh,Pilibhit,Puranpur,432,90,6,hab,3,3,6,426,426,33,4864,430,28.579929747640257,80.15999455401695,0
Uttar Pradesh,Pratapgarh,Aspur Deosara,163,2,0,hab,0,0,0,163,163,33,272,436,25.960158762957093,82.30967119325207,0
Uttar Pradesh,Pratapgarh,Babaganj,150,4,0,hab,0,0,0,150,150,33,335,436,25.802020147420063,81.58427090261515,0
Uttar Pradesh,Pratapgarh,Bihar,167,7,15,hab,12,3,9,158,152,33,915,436,25.73523681450011,81.69404033256228,0
Uttar Pradesh,Pratapgarh,Gaura,368,23,0,hab,0,0,0,368,368,33,1893,436,25.741322616654543,82.07504052757741,0
Uttar Pradesh,Pratapgarh,Kalakankar,125,1,27,hab,22,5,26,99,98,33,2607,436,25.83002057768669,81.41643379977205,0
Uttar Pradesh,Pratapgarh,Kunda,172,7,8,hab,8,0,11,161,164,33,3253,436,25.68002661245363,81.50768926790892,0
Uttar Pradesh,Pratapgarh,Lalganj,160,16,1,hab,1,0,4,156,159,33,3359,436,25.950789456453663,81.65888859779177,0
Uttar Pradesh,Pratapgarh,Laxmanpur,374,29,0,hab,0,0,0,374,374,33,3398,436,25.907873420333072,81.80349335997764,0
Uttar Pradesh,Pratapgarh,Mandhata,187,6,0,hab,0,0,0,187,187,33,3645,436,25.79477481568215,81.87030246956706,0
Uttar Pradesh,Pratapgarh,Mangraura,312,23,1,hab,1,0,5,307,311,33,3670,436,26.005495962831986,82.0796932819455,0
Uttar Pradesh,Pratapgarh,Patti,155,6,1,hab,1,0,7,148,154,33,4636,436,25.92616621664633,82.21247201312512,0
Uttar Pradesh,Pratapgarh,Rampur Sangramgarh,180,5,1,hab,1,0,1,179,179,33,5066,436,25.89799278874184,81.56739019736854,0
Uttar Pradesh,Pratapgarh,Sadar,205,27,1,hab,1,0,3,202,204,33,5230,436,25.91567165606523,81.96397034821868,0
Uttar Pradesh,Pratapgarh,Sandwa Chandika,356,46,1,hab,1,0,6,350,355,33,5344,436,26.01084626469228,81.85980751654802,0
Uttar Pradesh,Pratapgarh,Sangipur,248,12,1,hab,1,0,1,247,247,33,5354,436,26.067873729521246,81.63792066807086,0
Uttar Pradesh,Pratapgarh,Shivgarh,585,46,1,hab,1,0,6,579,584,33,5581,436,25.849430940920726,82.08950724527291,0
Uttar Pradesh,Rae Bareli,Amawan,290,17,1,hab,0,1,0,290,289,33,123,444,26.31346155598363,81.30430515397723,0
Uttar Pradesh,Rae Bareli,Bachharawan,183,8,0,hab,0,0,0,183,183,33,348,444,26.47858900875761,81.10931216190545,0
Uttar Pradesh,Rae Bareli,Chhatoh,295,18,1,hab,1,0,5,290,294,33,1258,444,26.17313554128888,81.54840828754278,0
Uttar Pradesh,Rae Bareli,Dalmau,419,15,0,hab,0,0,0,419,419,33,1405,444,26.13021364892543,81.07452411824185,0
Uttar Pradesh,Rae Bareli,Deenshah Gaura,250,6,0,hab,0,0,0,250,250,33,1479,444,26.034089830758056,81.15652537565332,0
Uttar Pradesh,Rae Bareli,Dih,409,25,2,hab,2,0,16,393,407,33,1633,444,26.14895649641409,81.44396738725446,0
Uttar Pradesh,Rae Bareli,Harchandpur,268,27,1,hab,1,0,5,263,267,33,2142,444,26.349763208088465,81.14095014005117,0
Uttar Pradesh,Rae Bareli,Jagatpur,243,23,1,hab,1,0,9,234,242,33,2336,444,26.03420297520616,81.25734213434501,0
Uttar Pradesh,Rae Bareli,Kheron,280,16,0,hab,0,0,0,280,280,33,3000,444,26.279775281460072,80.91914225004197,0
Uttar Pradesh,Rae Bareli,Lalganj,318,18,1,hab,1,0,7,311,317,33,3363,444,26.14664283294369,80.94198202194708,0
Uttar Pradesh,Rae Bareli,Mahrajganj,350,49,0,hab,0,0,0,350,350,33,3540,444,26.419706133051047,81.30395655298761,0
Uttar Pradesh,Rae Bareli,Rahi,683,16,5,hab,5,0,27,656,678,33,4926,444,26.171594731324745,81.2784785907531,0
Uttar Pradesh,Rae Bareli,Rohania,146,9,0,hab,0,0,0,146,146,33,5181,444,25.956240255475574,81.36451494304906,0
Uttar Pradesh,Rae Bareli,Salon,453,20,0,hab,0,0,0,453,453,33,5305,444,26.021371681871198,81.44025719032129,0
Uttar Pradesh,Rae Bareli,Saraini,401,13,1,hab,1,0,6,395,400,33,5397,444,26.12039701839095,80.79689488919563,0
Uttar Pradesh,Rae Bareli,Satawan,310,17,1,hab,1,0,6,304,309,33,5434,444,26.26304741304397,81.10287180911908,0
Uttar Pradesh,Rae Bareli,Sheogarh,185,5,0,hab,0,0,0,185,185,33,5556,444,26.53042069965871,81.25816215380608,0
Uttar Pradesh,Rae Bareli,Unchahar,415,18,2,hab,2,0,17,398,413,33,6216,444,25.90960109637513,81.28786388970971,0
Uttar Pradesh,Rampur,Bilaspur,271,13,1,hab,1,0,1,270,270,33,943,457,28.86830498484,79.29042114838104,0
Uttar Pradesh,Rampur,Chamrawa,163,9,4,hab,3,1,7,156,159,33,1139,457,28.755633869585843,79.06138288886991,0
Uttar Pradesh,Rampur,Milak,249,7,1,hab,1,0,3,246,248,33,3857,457,28.6764121163926,79.17296694869025,0
Uttar Pradesh,Rampur,Saidnagar,163,10,11,hab,11,0,15,148,152,33,5268,457,28.871965149037422,79.04007928479484,0
Uttar Pradesh,Rampur,Shahbad,219,5,44,hab,44,0,58,161,175,33,5504,457,28.576193807558166,78.99981857306845,0
Uttar Pradesh,Rampur,Suar,390,6,20,hab,19,1,32,358,370,33,5777,457,29.018806734663134,79.06749092148948,0
Uttar Pradesh,S.K. Nagar,Baghauli,287,33,0,hab,0,0,0,287,287,33,380,470,26.858879515075223,83.06915859403655,0
Uttar Pradesh,S.K. Nagar,Belhar Kala,155,51,4,hab,4,0,10,145,151,33,705,470,26.960684582230225,82.9694788248094,0
Uttar Pradesh,S.K. Nagar,Haisar Bazar,265,47,1,hab,1,0,6,259,264,33,2104,470,26.510960603742156,83.07564392021592,0
Uttar Pradesh,S.K. Nagar,Khalilabad,344,25,6,hab,6,0,22,322,338,33,2931,470,26.729711263049477,83.05325239805559,0
Uttar Pradesh,S.K. Nagar,Mehdawal,188,20,0,hab,0,0,0,188,188,33,3817,470,26.95590283599174,83.13730460175907,0
Uttar Pradesh,S.K. Nagar,Nath Nagar,255,17,17,hab,12,5,33,222,238,33,4219,470,26.61381261047158,83.00259584354384,0
Uttar Pradesh,S.K. Nagar,Pauli,200,88,0,hab,0,0,0,200,200,33,4641,470,26.548834010382674,82.95361842496584,0
Uttar Pradesh,S.K. Nagar,Samariyawan,334,23,46,hab,43,3,85,249,288,33,5317,470,26.84686124200332,82.93194612781502,0
Uttar Pradesh,S.K. Nagar,Santha,141,6,24,hab,24,0,40,101,117,33,5381,470,27.036190463596878,83.05652631765597,0
Uttar Pradesh,S.R. Nagar(Bhadohi),Aurai,167,32,22,hab,22,0,22,145,145,33,313,471,25.271073150677946,82.56341170131205,0
Uttar Pradesh,S.R. Nagar(Bhadohi),Bhadoi,207,14,0,hab,0,0,0,207,207,33,755,471,25.363245634723157,82.59514900761714,0
Uttar Pradesh,S.R. Nagar(Bhadohi),Deagh,158,10,2,hab,2,0,2,156,156,33,1473,471,25.268709847527436,82.32214948032939,0
Uttar Pradesh,S.R. Nagar(Bhadohi),Gyanpur,207,39,0,hab,0,0,0,207,207,33,2094,471,25.34981689860227,82.41482851481285,0
Uttar Pradesh,S.R. Nagar(Bhadohi),Suriyawan,222,7,0,hab,0,0,0,222,222,33,5821,471,25.45060353685929,82.42135541311426,0
Uttar Pradesh,Saharanpur,Baliakheri,135,16,31,hab,29,2,40,95,104,33,453,474,29.929350102582003,77.58268553644075,0
Uttar Pradesh,Saharanpur,Deoband,98,6,51,hab,46,5,61,37,47,33,1494,474,29.678912741267485,77.69394899392546,0
Uttar Pradesh,Saharanpur,Gangoh,179,0,28,hab,28,0,31,148,151,33,1855,474,29.76507597749769,77.26891083014037,0
Uttar Pradesh,Saharanpur,Muzaffarabad,218,13,63,hab,58,5,87,131,155,33,4031,474,30.161535757867036,77.75907220591945,0
Uttar Pradesh,Saharanpur,Nagal,99,9,74,hab,68,6,79,20,25,33,4055,474,29.81146561360461,77.66479507439023,0
Uttar Pradesh,Saharanpur,Nakur,144,8,10,hab,10,0,10,134,134,33,4105,474,29.91695343774652,77.33159071408096,0
Uttar Pradesh,Saharanpur,Nanauta,93,9,35,hab,32,3,34,59,58,33,4131,474,29.69667704181545,77.48405146000121,0
Uttar Pradesh,Saharanpur,Puwarka,174,35,12,hab,11,1,15,159,162,33,4891,474,30.020316742971854,77.62464631359386,0
Uttar Pradesh,Saharanpur,Rampur Maniharan,96,6,44,hab,42,2,55,41,52,33,5064,474,29.806823471317557,77.49811759563896,0
Uttar Pradesh,Saharanpur,Sadholi Quadim,146,7,4,hab,4,0,7,139,142,33,5236,474,30.260929071917875,77.62136139741615,0
Uttar Pradesh,Saharanpur,Sarsawa,166,25,23,hab,22,1,39,127,143,33,5422,474,30.054508489964594,77.42757418751847,0
Uttar Pradesh,Sambhal,Asmoli,164,25,126,hab,115,11,135,29,38,33,7034,629,28.741615864258147,78.53592065013336,0
Uttar Pradesh,Sambhal,Bahjoi,127,11,100,hab,91,9,112,15,27,33,7032,629,28.401602155858598,78.59200521111747,0
Uttar Pradesh,Sambhal,Baniyakhera,182,86,71,hab,63,8,83,99,111,33,7035,629,28.45808564503488,78.75473522159315,0
Uttar Pradesh,Sambhal,Gunnaur,127,34,91,hab,77,14,92,35,36,33,7036,629,28.28687135235536,78.46921277251577,0
Uttar Pradesh,Sambhal,Junawai,135,46,92,osm,72,20,91,44,43,33,7037,629,28.20105427337469,78.52373620920463,0
Uttar Pradesh,Sambhal,Pawansa,173,37,121,hab,104,17,130,43,52,33,7033,629,28.518173260208222,78.5574596391276,0
Uttar Pradesh,Sambhal,Rajpura,124,16,93,hab,90,3,110,14,31,33,7038,629,28.380835019280187,78.38152184020412,0
Uttar Pradesh,Sambhal,Sambhal,195,32,196,osm,123,73,146,49,-1,33,7031,629,28.6174747992941,78.59487084506547,0
Uttar Pradesh,Shahjahanpur,Banda,284,3,0,hab,0,0,0,284,284,33,493,493,28.275490757747804,80.0844225565403,0
Uttar Pradesh,Shahjahanpur,Bhawal Khera,150,0,0,hab,0,0,0,150,150,33,830,493,27.838561991453954,79.97291543066623,0
Uttar Pradesh,Shahjahanpur,Dadraul,136,0,4,hab,4,0,5,131,132,33,1391,493,27.851951945503234,79.85701708098573,0
Uttar Pradesh,Shahjahanpur,Jalalabad,250,28,2,hab,2,0,3,247,248,33,2380,493,27.710146264495865,79.64130453762107,0
Uttar Pradesh,Shahjahanpur,Jatipur,153,1,2,hab,2,0,4,149,151,33,2461,493,27.95934349784583,79.55952672957706,0
Uttar Pradesh,Shahjahanpur,Kalan,109,0,1,hab,1,0,1,108,108,33,2613,493,27.734352903671333,79.42688222436577,0
Uttar Pradesh,Shahjahanpur,Kanth,108,28,0,hab,0,0,0,108,108,33,2738,493,27.773066787567167,79.77788579255265,0
Uttar Pradesh,Shahjahanpur,Katra Khudaganj,102,0,7,hab,5,2,8,94,95,33,2845,493,28.113018826413597,79.7052635272767,0
Uttar Pradesh,Shahjahanpur,Khuttar,87,0,1,hab,0,1,0,87,86,33,3031,493,28.29692841137572,80.26232712460283,0
Uttar Pradesh,Shahjahanpur,Madnapur,79,43,0,hab,0,0,0,79,79,33,3494,493,27.850855465414877,79.68636006251818,0
Uttar Pradesh,Shahjahanpur,Mirzapur,65,0,1,hab,1,0,1,64,64,33,3867,493,27.692668237200444,79.54728171199196,0
Uttar Pradesh,Shahjahanpur,Nigohi,138,1,11,hab,10,1,14,124,127,33,4297,493,28.097870922822725,79.8536145374478,0
Uttar Pradesh,Shahjahanpur,Powayan,148,0,1,hab,1,0,1,147,147,33,4819,493,28.09879114954257,80.11658313844362,0
Uttar Pradesh,Shahjahanpur,Sindhauli,154,1,1,hab,1,0,1,153,153,33,5649,493,28.011637306777494,80.00657294390746,0
Uttar Pradesh,Shahjahanpur,Tilhar,120,0,1,hab,1,0,2,118,119,33,6087,493,27.977329243898343,79.72175781907106,0
Uttar Pradesh,Shamli,Kairana,59,2,55,hab,51,4,54,5,4,33,7040,630,29.425895533151635,77.2005730297696,0
Uttar Pradesh,Shamli,Kandhala,66,5,67,osm,54,13,60,6,-1,33,7041,630,29.321900581262867,77.30750647627903,0
Uttar Pradesh,Shamli,Shamli,48,8,38,hab,35,3,36,12,10,33,7039,630,29.439208178291093,77.35319930948715,0
Uttar Pradesh,Shamli,Thanabhawan,81,8,78,osm,69,9,70,11,3,33,7042,630,29.577941770311085,77.39864049572515,0
Uttar Pradesh,Shamli,Un,146,1,177,osm,161,16,145,1,-31,33,7043,630,29.58620963596747,77.21525847872707,0
Uttar Pradesh,Shrawasti,Gilaula,570,31,323,hab,313,10,555,15,247,33,1955,500,27.621038672567913,81.77811871042215,0
Uttar Pradesh,Shrawasti,Harriharpur Rani,546,0,310,hab,297,13,522,24,236,33,2165,500,27.737870585379508,81.90347564326062,0
Uttar Pradesh,Shrawasti,Ikauna,825,0,443,hab,435,8,821,4,382,33,2283,500,27.53077710597156,81.975016599849,0
Uttar Pradesh,Shrawasti,Jamunha,620,20,379,hab,371,8,611,9,241,33,2432,500,27.81120140714535,81.71867776576524,0
Uttar Pradesh,Shrawasti,Sirsia,541,1,264,hab,261,3,532,9,277,33,5682,500,27.79772437469474,82.05107649457113,0
Uttar Pradesh,Siddharathnagar,Baansi,289,28,169,hab,143,26,262,27,120,33,334,502,27.203838202700016,82.9115766471201,0
Uttar Pradesh,Siddharathnagar,Barhni,192,1,161,hab,152,9,189,3,31,33,598,502,27.444645781949678,82.84943343040779,0
Uttar Pradesh,Siddharathnagar,Bhanwapur,291,17,190,hab,190,0,275,16,101,33,802,502,27.288082196597582,82.57402761765081,0
Uttar Pradesh,Siddharathnagar,Birdpur,413,43,314,hab,293,21,388,25,99,33,966,502,27.38263721761781,83.15838537256303,0
Uttar Pradesh,Siddharathnagar,Dumariaganj,439,80,274,hab,267,7,344,95,165,33,1696,502,27.152240062240093,82.64246063514297,0
Uttar Pradesh,Siddharathnagar,Itwa,275,10,194,hab,187,7,257,18,81,33,2325,502,27.358414736800917,82.7171081399627,0
Uttar Pradesh,Siddharathnagar,Jogiya,205,113,71,hab,60,11,109,96,134,33,2520,502,27.220305507421568,83.02216542719866,0
Uttar Pradesh,Siddharathnagar,Khesraha,278,67,153,hab,149,4,231,47,125,33,3002,502,27.090343972348165,83.01100186248875,0
Uttar Pradesh,Siddharathnagar,Kuhniyaon,386,26,265,hab,202,63,361,25,121,33,3227,502,27.276281672151942,82.80607600441061,0
Uttar Pradesh,Siddharathnagar,Mithwal,320,46,218,hab,195,23,274,46,102,33,3871,502,27.10201745102253,82.87728645193863,0
Uttar Pradesh,Siddharathnagar,Naugarh,372,111,227,hab,194,33,289,83,145,33,4230,502,27.30697947101525,83.09434368835767,0
Uttar Pradesh,Siddharathnagar,Shohratgarh,249,28,163,hab,145,18,216,33,86,33,5586,502,27.39133150240516,82.99369610846438,0
Uttar Pradesh,Siddharathnagar,Uska,425,98,193,hab,191,2,375,50,232,33,6235,502,27.232513339929582,83.15146870715756,0
Uttar Pradesh,Sitapur,Aliya,270,18,0,hab,0,0,0,270,270,33,92,513,27.69050427449991,80.62773445516753,0
Uttar Pradesh,Sitapur,Behta,427,74,1,hab,1,0,5,422,426,33,692,513,27.770009201493863,81.07820973560634,0
Uttar Pradesh,Sitapur,Biswan,515,43,0,hab,0,0,0,515,515,33,991,513,27.484504391880492,80.95183757528879,0
Uttar Pradesh,Sitapur,Gondlamau,391,49,0,hab,0,0,0,391,391,33,1996,513,27.287722025681873,80.67837206342391,0
Uttar Pradesh,Sitapur,Hargaon,302,60,1,hab,0,1,0,302,301,33,2144,513,27.763893361432455,80.78679148436616,0
Uttar Pradesh,Sitapur,Kasmanda,431,76,0,hab,0,0,0,431,431,33,2818,513,27.36045965961262,80.86362243680259,0
Uttar Pradesh,Sitapur,Khairabad,327,31,0,hab,0,0,0,327,327,33,2916,513,27.523974745159297,80.71056834156974,0
Uttar Pradesh,Sitapur,Laharpur,245,50,1,hab,0,1,0,245,244,33,3326,513,27.720119048448066,80.93624921307291,0
Uttar Pradesh,Sitapur,Machrehta,370,24,0,hab,0,0,0,370,370,33,3463,513,27.416082276509083,80.66613206871885,0
Uttar Pradesh,Sitapur,Mahmoodabad,384,65,0,hab,0,0,0,384,384,33,3535,513,27.380648198976182,81.13356392018622,0
Uttar Pradesh,Sitapur,Maholi,233,22,1,hab,1,0,2,231,232,33,3537,513,27.683467551948322,80.51060424879006,0
Uttar Pradesh,Sitapur,Mishrikh,325,47,1,hab,1,0,1,324,324,33,3868,513,27.43154340559486,80.49039992849026,0
Uttar Pradesh,Sitapur,Pahla,461,107,0,hab,0,0,0,461,461,33,4428,513,27.357410437498007,81.05012807351525,0
Uttar Pradesh,Sitapur,Parsendi,349,31,0,hab,0,0,0,349,349,33,4575,513,27.632145571313792,80.80324656475005,0
Uttar Pradesh,Sitapur,Pisawan,293,19,0,hab,0,0,0,293,293,33,4776,513,27.600874171489224,80.40775706836979,0
Uttar Pradesh,Sitapur,Rampurmathura,635,31,3,hab,2,1,13,622,632,33,5071,513,27.359400059297748,81.28650466016255,0
Uttar Pradesh,Sitapur,Reosa,573,19,15,hab,15,0,26,547,558,33,5160,513,27.56636072105627,81.22626663139634,0
Uttar Pradesh,Sitapur,Sakran,415,10,0,hab,0,0,0,415,415,33,5291,513,27.6166140852839,81.05217427110007,0
Uttar Pradesh,Sitapur,Sidhauli,379,71,3,hab,3,0,10,369,376,33,5604,513,27.23750670052515,80.90146107670532,0
Uttar Pradesh,Sonebhadra,Babhani,131,20,0,hab,0,0,0,131,131,33,341,518,23.939845556392324,83.07337721884221,0
Uttar Pradesh,Sonebhadra,Chatra,220,22,0,hab,0,0,0,220,220,33,1195,518,24.63928758827906,83.23960725372281,0
Uttar Pradesh,Sonebhadra,Chopan,355,21,42,hab,33,9,38,317,313,33,1347,518,24.429006399157895,83.03009768452212,0
Uttar Pradesh,Sonebhadra,Duddhi,142,11,4,hab,1,3,1,141,138,33,1681,518,24.20858303489447,83.22687665725057,0
Uttar Pradesh,Sonebhadra,Ghorawal,401,25,502,osm,427,75,361,40,-101,33,1945,518,24.737072719404857,82.77671571945716,0
Uttar Pradesh,Sonebhadra,Myorepur,264,20,9,hab,5,4,7,257,255,33,4038,518,24.12073177938935,82.94558890810191,0
Uttar Pradesh,Sonebhadra,Nagwa,203,13,43,hab,40,3,47,156,160,33,4085,518,24.59121075318196,83.339210350694,0
Uttar Pradesh,Sonebhadra,Robertsganj,366,23,201,hab,102,99,99,267,165,33,5176,518,24.688418186260503,83.05455518989685,0
Uttar Pradesh,Sultanpur,Akhandnagar,713,47,0,hab,0,0,0,713,713,33,56,530,26.20386600424991,82.56251642540285,0
Uttar Pradesh,Sultanpur,Baldirai,526,33,42,hab,39,3,115,411,484,33,448,530,26.469685128231145,81.86066386173313,0
Uttar Pradesh,Sultanpur,Bhadaiya,238,17,1,hab,1,0,6,232,237,33,748,530,26.15951348140014,82.12203777789234,0
Uttar Pradesh,Sultanpur,Danpatganj,526,109,3,hab,3,0,23,503,523,33,1430,530,26.423122959696325,82.0365888910684,0
Uttar Pradesh,Sultanpur,Dostpur,262,53,1,hab,1,0,5,257,261,33,1671,530,26.27447534622008,82.41448118049532,0
Uttar Pradesh,Sultanpur,Duvepur,298,30,12,hab,12,0,20,278,286,33,1719,530,26.241629924149024,82.02987542005597,0
Uttar Pradesh,Sultanpur,Jaisinghpur,472,96,1,hab,1,0,7,465,471,33,2365,530,26.28116059933481,82.25470199892568,0
Uttar Pradesh,Sultanpur,Kadipur,639,86,1,hab,1,0,4,635,638,33,2570,530,26.09821174318637,82.41682564379921,0
Uttar Pradesh,Sultanpur,Kurebhar,459,98,2,hab,2,0,31,428,457,33,3281,530,26.356241094114317,82.18429578013583,0
Uttar Pradesh,Sultanpur,Kurwar,453,62,157,hab,153,4,219,234,296,33,3299,530,26.32929486546573,81.94846527640983,0
Uttar Pradesh,Sultanpur,Lambhua,455,39,0,hab,0,0,0,455,455,33,3369,530,26.113164444829767,82.22312686878182,0
Uttar Pradesh,Sultanpur,Motigarpur,147,41,0,hab,0,0,0,147,147,33,3938,530,26.22657847389526,82.31556814062385,0
Uttar Pradesh,Sultanpur,Partapur Kamaicha,190,8,0,hab,0,0,0,190,190,33,4577,530,26.076745937484453,82.32258422377093,0
Uttar Pradesh,Unnao,Asoha,282,25,0,hab,0,0,0,282,282,33,269,568,26.5549000992447,80.81732525387294,0
Uttar Pradesh,Unnao,Auras,216,18,1,hab,1,0,3,213,215,33,317,568,26.919774984834,80.53798750135802,0
Uttar Pradesh,Unnao,Bangarmau,260,115,0,hab,0,0,0,260,260,33,506,568,26.876436390429003,80.21654775127355,0
Uttar Pradesh,Unnao,Bichchiya,315,21,17,hab,16,1,48,267,298,33,902,568,26.523075977418475,80.5783762890377,0
Uttar Pradesh,Unnao,Bighapur,255,50,2,hab,1,1,1,254,253,33,913,568,26.28564675906456,80.66909390822468,0
Uttar Pradesh,Unnao,Fatehpur - 84,326,18,1,hab,1,0,3,323,325,33,1775,568,26.7929450319371,80.26157525371659,0
Uttar Pradesh,Unnao,Ganj Muradabad,217,16,2,hab,1,1,1,216,215,33,1861,568,26.935504177787376,80.25101138979855,0
Uttar Pradesh,Unnao,Hasanganj,243,29,1,hab,1,0,5,238,242,33,2172,568,26.76624877737891,80.63822751149934,0
Uttar Pradesh,Unnao,Hilauli,361,8,1,hab,1,0,5,356,360,33,2210,568,26.433601506447,80.94082017230592,0
Uttar Pradesh,Unnao,Miyaganj,275,34,2,hab,2,0,2,273,273,33,3872,568,26.76403315846363,80.49386607141737,0
Uttar Pradesh,Unnao,Nawabganj,366,16,1,hab,1,0,8,358,365,33,4243,568,26.629136336012124,80.66868458337926,0
Uttar Pradesh,Unnao,Purwa,225,9,10,hab,9,1,21,204,215,33,4880,568,26.419879983962478,80.76985398225298,0
Uttar Pradesh,Unnao,Safipur,272,36,0,hab,0,0,0,272,272,33,5240,568,26.7188399623491,80.35427025057649,0
Uttar Pradesh,Unnao,Sikandarpsur Karan,322,28,4,hab,4,0,10,312,318,33,5619,568,26.40174444401199,80.53977883266612,0
Uttar Pradesh,Unnao,Sikrandarpur Sirosi,271,32,1,hab,1,0,7,264,270,33,5625,568,26.579590636650376,80.38627269222273,0
Uttar Pradesh,Unnao,Sumerpur,338,34,0,hab,0,0,0,338,338,33,5805,568,26.241305102235234,80.76059153891691,0
Uttar Pradesh,Varanasi,Arazeeline,491,7,78,hab,76,2,154,337,413,33,229,577,25.26892781189055,82.83875583817229,0
Uttar Pradesh,Varanasi,Baragaon,452,3,1,hab,1,0,4,448,451,33,557,577,25.44966572883518,82.76815225244286,0
Uttar Pradesh,Varanasi,Chiraigaon,514,9,1,hab,1,0,10,504,513,33,1316,577,25.38080605703849,83.08595329104817,0
Uttar Pradesh,Varanasi,Cholapur,493,1,1,hab,1,0,5,488,492,33,1345,577,25.49458072567687,83.05346538755498,0
Uttar Pradesh,Varanasi,Harahua,470,41,1,hab,1,0,5,465,469,33,2136,577,25.4207874787299,82.94048218219804,0
Uttar Pradesh,Varanasi,Kashividyapith,302,8,4,hab,3,1,9,293,298,33,2812,577,25.290834920880915,82.9627416433228,0
Uttar Pradesh,Varanasi,Pindra,579,5,2,hab,2,0,20,559,577,33,4756,577,25.496092992232466,82.87274043905221,0
Uttar Pradesh,Varanasi,Sewapuri,558,12,5,hab,5,0,1,557,553,33,5497,577,25.33520366010401,82.75992045840796,0
Uttarakhand,Almora,Bhaisiachhana,96,9,133,osm,122,11,90,6,-37,34,782,12,29.662161589217686,79.81723515409897,0
Uttarakhand,Almora,Bhikiyasain,188,13,221,osm,206,15,185,3,-33,34,849,12,29.70670163858914,79.29671985226071,0
Uttarakhand,Almora,Chaukhutia,163,3,278,osm,205,73,161,2,-115,34,1202,12,29.873517614262607,79.39250779909918,0
Uttarakhand,Almora,Dhauladevi,227,11,277,osm,231,46,215,12,-50,34,1602,12,29.57007529670061,79.9090447591217,0
Uttarakhand,Almora,Dwarahat,204,9,257,osm,235,22,200,4,-53,34,1721,12,29.737323365670232,79.45947004597598,0
Uttarakhand,Almora,Hawalbag,218,5,234,osm,216,18,191,27,-16,34,2199,12,29.63561747110971,79.6136470448079,0
Uttarakhand,Almora,Lamgara,412,34,199,hab,182,17,334,78,213,34,3372,12,29.51163864668995,79.76495424956688,0
Uttarakhand,Almora,Sult,508,12,449,hab,404,45,504,4,59,34,5793,12,29.64163120531415,79.17313951478202,0
Uttarakhand,Almora,Syaldey,190,5,302,osm,256,46,188,2,-112,34,5835,12,29.851820565025328,79.19198766427772,0
Uttarakhand,Almora,Takula,147,5,221,osm,167,54,143,4,-74,34,5859,12,29.77521912053439,79.63034874735274,0
Uttarakhand,Almora,Tarikhet,263,4,337,osm,324,13,260,3,-74,34,5925,12,29.619126437358545,79.43187279486943,0
Uttarakhand,Bageshwar,Bageshwar,469,103,305,hab,291,14,367,102,164,34,377,36,29.837027592773968,79.8440779469923,0
Uttarakhand,Bageshwar,Garur,185,0,392,osm,286,106,184,1,-207,34,1889,36,29.936651971971134,79.60980180101558,0
Uttarakhand,Bageshwar,Kapkote,200,2,437,osm,270,167,193,7,-237,34,2745,36,30.077623187433648,79.94094237875709,0
Uttarakhand,Chamoli,Dasoli,112,2,168,osm,136,32,106,6,-56,34,1459,100,30.42340413342603,79.42768432304007,0
Uttarakhand,Chamoli,Dewal,71,3,158,osm,81,77,69,2,-87,34,1538,100,30.1279934634595,79.69022062365852,0
Uttarakhand,Chamoli,Gairsain,219,0,254,osm,183,71,180,39,-35,34,1808,100,30.06036939091957,79.29230795374205,0
Uttarakhand,Chamoli,Ghat,89,1,155,osm,116,39,88,1,-66,34,1924,100,30.272263712948952,79.54246636149895,0
Uttarakhand,Chamoli,Joshimath,90,1,151,osm,107,44,87,3,-61,34,2529,100,30.684595364408615,79.67727802445297,0
Uttarakhand,Chamoli,Karanprayag,206,83,127,osm,122,5,108,98,79,34,2765,100,30.254734638254163,79.2335691927655,0
Uttarakhand,Chamoli,Narayan Bagar,145,2,146,osm,101,45,135,10,-1,34,4167,100,30.167110228986544,79.34632167910914,0
Uttarakhand,Chamoli,Pokhri,132,2,115,hab,103,12,103,29,17,34,4789,100,30.359045359197708,79.20943903414135,0
Uttarakhand,Chamoli,Tharali,92,5,97,osm,70,27,88,4,-5,34,5996,100,30.107835649294998,79.5002666997523,0
Uttarakhand,Champawat,Barakot,100,0,9,hab,9,0,29,71,91,34,562,101,29.465889771229673,80.08509642497667,0
Uttarakhand,Champawat,Champawat,244,9,65,hab,32,33,51,193,179,34,1137,101,29.200642437643893,80.10805693996814,0
Uttarakhand,Champawat,Lohaghat,144,6,20,hab,17,3,33,111,124,34,3425,101,29.38040292594574,80.17564789222781,0
Uttarakhand,Champawat,Pati,156,4,102,hab,70,32,68,88,54,34,4618,101,29.333670781386733,79.92521325570026,0
Uttarakhand,Dehradun,Chakarata,154,1,504,osm,305,199,149,5,-350,34,1113,138,30.803203785799052,77.89511124315982,0
Uttarakhand,Dehradun,Doiwala,74,14,33,hab,11,22,23,51,41,34,1656,138,30.127919453621214,78.14960735214092,0
Uttarakhand,Dehradun,Kalsi,203,2,286,osm,266,20,203,0,-83,34,2656,138,30.598229217861938,77.88854024339422,0
Uttarakhand,Dehradun,Raipur,109,6,195,osm,113,82,79,30,-86,34,4947,138,30.31119716701485,78.10728054382704,0
Uttarakhand,Dehradun,Sahaspur,104,4,142,osm,68,74,55,49,-38,34,5253,138,30.37634411102229,77.91434958924069,0
Uttarakhand,Dehradun,Vikasnagar,67,11,36,hab,26,10,20,47,31,34,6365,138,30.44862442831012,77.79474387763102,0
Uttarakhand,Haridwar,Bahadrabad,114,8,23,hab,14,9,22,92,91,34,395,216,29.903101154998417,78.11896578658384,0
Uttarakhand,Haridwar,Bhagwanpur,80,1,78,hab,58,20,57,23,2,34,769,216,30.04144866180394,77.87227395802894,0
Uttarakhand,Haridwar,Khanpur,49,2,27,hab,23,4,29,20,22,34,2959,216,29.64368648902314,78.01525421405023,0
Uttarakhand,Haridwar,Laksar,85,1,37,hab,30,7,34,51,48,34,3353,216,29.744395847005432,78.08451382237867,0
Uttarakhand,Haridwar,Narsan,96,3,52,hab,50,2,70,26,44,34,4203,216,29.76334166221376,77.8690413970261,0
Uttarakhand,Haridwar,Roorkee,89,8,30,hab,29,1,34,55,59,34,5198,216,29.884272111912107,77.88955040100642,0
Uttarakhand,Nainital,Betalghat,128,4,204,osm,160,44,127,1,-76,34,733,383,29.50888490578279,79.39958093518244,0
Uttarakhand,Nainital,Bhimtal,108,15,237,osm,158,79,102,6,-129,34,856,383,29.33165274804803,79.48714966805089,0
Uttarakhand,Nainital,Dhari,46,2,179,osm,112,67,46,0,-133,34,1581,383,29.37913035324017,79.65634975415911,0
Uttarakhand,Nainital,Haldwani,239,0,49,hab,25,24,58,181,190,34,2114,383,29.129396067898437,79.64044829891525,0
Uttarakhand,Nainital,Kotabagh,115,5,119,osm,92,27,95,20,-4,34,3152,383,29.34341548971838,79.3112130817525,0
Uttarakhand,Nainital,Okalkanda,106,1,174,osm,96,78,60,46,-68,34,4379,383,29.290673446879698,79.7882090221083,0
Uttarakhand,Nainital,Ramgarh,123,6,175,osm,158,17,120,3,-52,34,5040,383,29.48240435863775,79.597610664806,0
Uttarakhand,Nainital,Ramnagar,185,0,38,hab,18,20,29,156,147,34,5053,383,29.397027514369032,79.10457773437288,0
Uttarakhand,Pauri,Birokhal,248,11,314,osm,289,25,243,5,-66,34,971,425,29.86426693101467,79.03397898606057,0
Uttarakhand,Pauri,Dugada,267,20,258,osm,219,39,231,36,9,34,1687,425,29.706394394562626,78.60125847887952,0
Uttarakhand,Pauri,Dwarikhal,224,3,234,osm,202,32,187,37,-10,34,1723,425,29.95302436985497,78.59281611484704,0
Uttarakhand,Pauri,Ekeshwar,226,8,235,osm,215,20,224,2,-9,34,1731,425,29.949539501106205,78.82298420843189,0
Uttarakhand,Pauri,Kaljikhal,241,5,135,hab,132,3,181,60,106,34,2640,425,30.011897121178205,78.72755242029672,0
Uttarakhand,Pauri,Khirsu,123,1,93,hab,89,4,118,5,30,34,3008,425,30.200852295429144,78.8474686101911,0
Uttarakhand,Pauri,Kot,215,2,10,hab,10,0,23,192,205,34,3147,425,30.128933603798146,78.65870627660465,0
Uttarakhand,Pauri,Nainidanda,289,1,336,osm,322,14,288,1,-47,34,4093,425,29.673058027713683,79.01651526077269,0
Uttarakhand,Pauri,Pabo,147,8,118,hab,116,2,138,9,29,34,4405,425,30.08305208889423,78.90627259377595,0
Uttarakhand,Pauri,Pauri,177,14,80,hab,77,3,123,54,97,34,4643,425,30.133977959686398,78.76297114064853,0
Uttarakhand,Pauri,Pokhra,122,19,167,osm,139,28,112,10,-45,34,4788,425,29.91931994742373,78.91178920603093,0
Uttarakhand,Pauri,Rikhinkhal,183,8,269,osm,244,25,179,4,-86,34,5168,425,29.680865633153946,78.85904557972822,0
Uttarakhand,Pauri,Thalisain,201,1,406,osm,276,130,201,0,-205,34,5979,425,30.055699449482372,79.07713194533333,0
Uttarakhand,Pauri,Yamkeshwar,225,5,310,osm,282,28,217,8,-85,34,6448,425,30.00813409770364,78.37199426456642,0
Uttarakhand,Pauri,Zahrikhal,216,31,247,osm,227,20,195,21,-31,34,6477,425,29.78334893127963,78.74715548547478,0
Uttarakhand,Pithoragarh,Berinag,273,5,122,hab,111,11,108,165,151,34,726,431,29.8013204944319,80.07943471619919,0
Uttarakhand,Pithoragarh,Bin,160,4,13,hab,13,0,42,118,147,34,953,431,29.577934374664757,80.17924747243629,0
Uttarakhand,Pithoragarh,Dharchula,69,4,62,hab,27,35,24,45,7,34,1579,431,30.199893739459785,80.59071902255621,0
Uttarakhand,Pithoragarh,Didihat,162,8,333,osm,303,30,133,29,-171,34,1627,431,29.803723189378324,80.24099222655671,0
Uttarakhand,Pithoragarh,Gangolihat,309,5,154,hab,141,13,170,139,155,34,1856,431,29.66713221393594,80.00644896260083,0
Uttarakhand,Pithoragarh,Kanalichina,205,5,27,hab,27,0,57,148,178,34,2693,431,29.705340166252896,80.28193688093427,0
Uttarakhand,Pithoragarh,Munakote,164,9,30,hab,26,4,57,107,134,34,3983,431,29.558573104828547,80.28991718405022,0
Uttarakhand,Pithoragarh,Munsyari,218,4,331,osm,248,83,206,12,-113,34,4000,431,30.288069454525882,80.21736855983164,0
Uttarakhand,Rudraprayag,Augustmuni,351,6,315,hab,301,14,313,38,36,34,307,469,30.32285541463666,79.04360888132894,0
Uttarakhand,Rudraprayag,Jakholi,167,10,245,osm,189,56,135,32,-78,34,2375,469,30.43548133352234,78.93144070395509,0
Uttarakhand,Rudraprayag,Ukimath,134,0,237,osm,180,57,132,2,-103,34,6192,469,30.627851543568255,79.12150699159086,0
Uttarakhand,Tehri,Bhailgana,260,0,561,osm,363,198,257,3,-301,34,776,539,30.586779890290227,78.7679051006566,0
Uttarakhand,Tehri,Chamba,214,0,316,osm,288,28,214,0,-102,34,1132,539,30.335538454564244,78.39662889128053,0
Uttarakhand,Tehri,Devprayag,246,10,118,hab,116,2,147,99,128,34,1536,539,30.214149180241204,78.5946660835151,0
Uttarakhand,Tehri,Jakhnidhar,148,6,193,osm,178,15,144,4,-45,34,2374,539,30.36410526645156,78.54301738411299,0
Uttarakhand,Tehri,Jaunpur,253,1,559,osm,376,183,249,4,-306,34,2464,539,30.480735049650633,78.15840824592381,0
Uttarakhand,Tehri,Kirti Nagar,153,2,151,hab,141,10,113,40,2,34,3047,539,30.298531303511044,78.76431398924647,0
Uttarakhand,Tehri,Narendra Nagar,207,2,358,osm,270,88,189,18,-151,34,4182,539,30.19282489453817,78.40617672150266,0
Uttarakhand,Tehri,Pratap Nagar,120,1,185,osm,164,21,120,0,-65,34,4824,539,30.498607814135507,78.49229394852482,0
Uttarakhand,Tehri,Thauldhar,157,2,319,osm,241,78,157,0,-162,34,6001,539,30.486744575754948,78.33584763753936,0
Uttarakhand,Udham Singh Nagar,Bazpur,113,19,5,hab,2,3,4,109,108,34,678,561,29.172317124729044,79.17917274124362,0
Uttarakhand,Udham Singh Nagar,Gaderpur,69,1,5,hab,5,0,8,61,64,34,1795,561,29.060873281869984,79.27912177333262,0
Uttarakhand,Udham Singh Nagar,Jaspur,103,2,21,hab,20,1,23,80,82,34,2452,561,29.282799585344158,78.87171247567076,0
Uttarakhand,Udham Singh Nagar,Kahatima,88,0,5,hab,2,3,3,85,83,34,2579,561,28.898444000348672,79.96487036133371,0
Uttarakhand,Udham Singh Nagar,Kashipur,75,1,2,hab,2,0,1,74,73,34,2809,561,29.207218079563514,79.01636930642677,0
Uttarakhand,Udham Singh Nagar,Rudrapur,85,1,2,hab,1,1,1,84,83,34,5204,561,28.970792751627464,79.49462416211341,0
Uttarakhand,Udham Singh Nagar,Sitarganj,123,2,2,hab,2,0,3,120,121,34,5694,561,28.95246756488709,79.72132160418253,0
Uttarakhand,Uttarkashi,Bhatwari,97,0,228,osm,127,101,84,13,-131,34,826,573,31.00728919055043,78.91539798873444,0
Uttarakhand,Uttarkashi,Chinyalisaur,102,0,243,osm,161,82,101,1,-141,34,1313,573,30.61486918292287,78.30294424845933,0
Uttarakhand,Uttarkashi,Dunda,121,1,253,osm,162,91,111,10,-132,34,1707,573,30.686107065995593,78.40858217986039,0
Uttarakhand,Uttarkashi,Mori,92,0,192,osm,110,82,85,7,-100,34,3923,573,31.10529330734048,78.22156579473804,0
Uttarakhand,Uttarkashi,Naugaon,181,0,301,osm,190,111,139,42,-120,34,4228,573,30.854734993783524,78.27899076325511,0
Uttarakhand,Uttarkashi,Purola,78,1,19,hab,15,4,33,45,59,34,4874,573,30.91582859764182,78.11994389264547,0
West Bengal,Alipurduar,Alipurduar-I,252,0,1,hab,1,0,1,251,251,35,7065,633,26.549808022931217,89.38246898502491,0
West Bengal,Alipurduar,Alipurduar-II,158,0,1,hab,1,0,5,153,157,35,7066,633,26.51319896182465,89.64213537043013,0
West Bengal,Alipurduar,Falakata,239,0,0,hab,0,0,0,239,239,35,7070,633,26.597408965883673,89.16809914573915,0
West Bengal,Alipurduar,Kalchini,116,0,24,hab,20,4,31,85,92,35,7067,633,26.696981084733196,89.4773995590783,0
West Bengal,Alipurduar,Kumargram,275,0,1,hab,1,0,6,269,274,35,7068,633,26.59842108104692,89.77505682304083,0
West Bengal,Alipurduar,Madarihat,153,0,3,hab,2,1,9,144,150,35,7069,633,26.744134416933864,89.20024420994179,0
West Bengal,Bankura,Bankura-I,137,0,3,hab,3,0,11,126,134,35,530,48,23.225753413510695,86.98553138433138,0
West Bengal,Bankura,Bankura-II,146,0,2,hab,2,0,5,141,144,35,531,48,23.278078892352436,87.10315170599054,0
West Bengal,Bankura,Barjora,185,0,3,hab,3,0,7,178,182,35,606,48,23.378973102469075,87.27313752663383,0
West Bengal,Bankura,Chatna,278,0,3,hab,3,0,7,271,275,35,1194,48,23.338585423550455,86.8930193546606,0
West Bengal,Bankura,Gangajalghati,156,0,14,hab,13,1,11,145,142,35,1841,48,23.413673764369744,87.11653225973834,0
West Bengal,Bankura,Indpur,198,0,18,hab,18,0,29,169,180,35,2297,48,23.140979085736717,86.88840141530888,0
West Bengal,Bankura,Indus,131,0,1,hab,1,0,2,129,130,35,2300,48,23.111393758553387,87.64890987109519,0
West Bengal,Bankura,Jaypur,139,1,1,hab,1,0,1,138,138,35,2476,48,23.027536827213286,87.46702275984899,0
West Bengal,Bankura,Khatra-I,148,1,3,hab,3,0,9,139,145,35,2985,48,22.978691307909795,86.87377841267613,0
West Bengal,Bankura,Khatra-II,116,0,3,hab,3,0,6,110,113,35,2986,48,23.072653165607253,86.80380944241992,0
West Bengal,Bankura,Kotulpur,171,3,0,hab,0,0,0,171,171,35,3184,48,22.99182477558547,87.59373694082059,0
West Bengal,Bankura,Mejia,72,2,1,hab,1,0,2,70,71,35,3825,48,23.544163789815567,87.1263648806221,0
West Bengal,Bankura,Onda,291,1,15,hab,15,0,24,267,276,35,4387,48,23.125649987217543,87.1631328516931,0
West Bengal,Bankura,Patrasayar,160,1,1,hab,1,0,1,159,159,35,4630,48,23.200725102937465,87.51416407885998,0
West Bengal,Bankura,Raipur-I(Raipur),206,0,1,hab,1,0,3,203,205,35,4950,48,22.757912028201343,86.89862638113671,0
West Bengal,Bankura,Raipur-II(Sarenga),166,0,0,hab,0,0,0,166,166,35,4951,48,22.79540102269353,87.00503972590089,0
West Bengal,Bankura,Ranibandh,169,0,1,hab,1,0,1,168,168,35,5091,48,22.850593505458768,86.75707472680051,0
West Bengal,Bankura,Saltora,145,0,0,hab,0,0,0,145,145,35,5308,48,23.535551785538786,86.97051536300866,0
West Bengal,Bankura,Simlapal,204,0,1,hab,1,0,3,201,203,35,5642,48,22.918253209057237,87.07342226074779,0
West Bengal,Bankura,Sonamukhi,187,0,0,hab,0,0,0,187,187,35,5722,48,23.30051773312843,87.4025106561949,0
West Bengal,Bankura,Taldangra,146,0,7,hab,7,0,8,138,139,35,5869,48,22.99941925982311,87.13747904117515,0
West Bengal,Bankura,Vishnupur,161,0,0,hab,0,0,0,161,161,35,6383,48,23.081152966515745,87.34323357703177,0
West Bengal,Birbhum,Bolpur  Sriniketan,201,0,6,hab,6,0,11,190,195,35,1019,84,23.674393478860924,87.70243365158856,0
West Bengal,Birbhum,Dubrajpur,225,0,0,hab,0,0,0,225,225,35,1680,84,23.799577917294208,87.4116951112689,0
West Bengal,Birbhum,Illambazar,207,0,1,hab,1,0,9,198,206,35,2285,84,23.67387680051338,87.52690768962573,0
West Bengal,Birbhum,Khoyrasol,126,0,2,hab,2,0,4,122,124,35,3019,84,23.799465568247363,87.23994339455122,0
West Bengal,Birbhum,Labpur,224,0,1,hab,1,0,8,216,223,35,3318,84,23.814241996533024,87.81952960967106,0
West Bengal,Birbhum,Mayureswar-I,141,0,0,hab,0,0,0,141,141,35,3797,84,24.041988157619773,87.76366532543582,0
West Bengal,Birbhum,Mayureswar-II,161,1,1,hab,1,0,5,156,160,35,3798,84,23.950135176160536,87.79124619762077,0
West Bengal,Birbhum,Md.Bazar,235,0,1,hab,1,0,7,228,234,35,3800,84,24.032492965103685,87.57535766747762,0
West Bengal,Birbhum,Murarai-I,120,0,1,hab,1,0,6,114,119,35,4004,84,24.477653408102444,87.84261383551701,0
West Bengal,Birbhum,Murarai-II,91,0,0,hab,0,0,0,91,91,35,4005,84,24.427919300500122,87.91826436656397,0
West Bengal,Birbhum,Nalhati-I,187,1,1,hab,1,0,2,185,186,35,4110,84,24.294859151936688,87.83525466852564,0
West Bengal,Birbhum,Nalhati-II,65,0,1,hab,1,0,3,62,64,35,4111,84,24.274506952624883,87.97187089949398,0
West Bengal,Birbhum,Nanoor,167,1,2,hab,2,0,4,163,165,35,4158,84,23.668846949682614,87.86982477691801,0
West Bengal,Birbhum,Rajnagar,143,0,1,hab,1,0,2,141,142,35,4990,84,23.960768934479983,87.34369066138072,0
West Bengal,Birbhum,Rampurhat-I,210,0,1,hab,1,0,3,207,209,35,5069,84,24.17627583603517,87.73076395679706,0
West Bengal,Birbhum,Rampurhat-II,133,0,0,hab,0,0,0,133,133,35,5070,84,24.15655671726635,87.86769305758492,0
West Bengal,Birbhum,Sainthia,270,0,1,hab,1,0,5,265,269,35,5277,84,23.86424914412285,87.67162014093672,0
West Bengal,Birbhum,Suri-I,163,0,0,hab,0,0,0,163,163,35,5819,84,23.905898561012076,87.49945070152963,0
West Bengal,Birbhum,Suri-II,102,0,1,hab,1,0,1,101,101,35,5820,84,23.84609541783141,87.5700686935994,0
West Bengal,Cooch-Behar,Coochbehar-I,293,0,0,hab,0,0,0,293,293,35,1371,120,26.262293862694374,89.41461902404866,0
West Bengal,Cooch-Behar,Coochbehar-II,436,0,1,hab,1,0,7,429,435,35,1372,120,26.405829568290713,89.43362513006818,0
West Bengal,Cooch-Behar,Dinhata-I,288,0,1,hab,1,0,5,283,287,35,1643,120,26.123473329421564,89.44396927566169,0
West Bengal,Cooch-Behar,Dinhata-II,158,0,1,hab,1,0,3,155,157,35,1644,120,26.105489301743603,89.56517497564788,0
West Bengal,Cooch-Behar,Haldibari,89,0,1,hab,1,0,6,83,88,35,2113,120,26.317072565156366,88.82495738939852,0
West Bengal,Cooch-Behar,Mathabhanga-I,138,0,0,hab,0,0,0,138,138,35,3759,120,26.37997303790142,89.15109581508446,0
West Bengal,Cooch-Behar,Mathabhanga-II,187,0,1,hab,1,0,2,185,186,35,3760,120,26.417832633513235,89.23825576669384,0
West Bengal,Cooch-Behar,Mekhliganj,78,0,4,hab,2,2,4,74,74,35,3826,120,26.383806747216063,88.96397242775177,0
West Bengal,Cooch-Behar,Sitai,77,0,1,hab,1,0,2,75,76,35,5690,120,26.082548690272205,89.33983662543142,0
West Bengal,Cooch-Behar,Sitalkuchi,183,0,0,hab,0,0,0,183,183,35,5691,120,26.198602984921727,89.21555423362051,0
West Bengal,Cooch-Behar,Tufanganj-I,205,0,1,hab,0,1,0,205,204,35,6142,120,26.302541972272657,89.62268439510981,0
West Bengal,Cooch-Behar,Tufanganj-II,173,0,2,hab,2,0,4,169,171,35,6143,120,26.373824282369135,89.74788377165939,0
West Bengal,Dakshin Dinajpur,Balurghat,310,0,8,hab,8,0,24,286,302,35,479,126,25.262968378562327,88.79654517410965,0
West Bengal,Dakshin Dinajpur,Bansihari,158,0,3,hab,3,0,9,149,155,35,539,126,25.389794790723077,88.39066252443038,0
West Bengal,Dakshin Dinajpur,Gangarampur,194,0,0,hab,0,0,0,194,194,35,1847,126,25.424387847620793,88.56056570802984,0
West Bengal,Dakshin Dinajpur,Harirampur,153,0,3,hab,3,0,6,147,150,35,2154,126,25.380476556836797,88.25867213322753,0
West Bengal,Dakshin Dinajpur,Hili,78,0,1,hab,1,0,4,74,77,35,2211,126,25.26555652151675,88.93588872621861,0
West Bengal,Dakshin Dinajpur,Kumarganj,218,0,4,hab,4,0,12,206,214,35,3243,126,25.416216258148342,88.759831212428,0
West Bengal,Dakshin Dinajpur,Kushmandi,229,0,1,hab,1,0,3,226,228,35,3303,126,25.517195572281448,88.40207546331818,0
West Bengal,Dakshin Dinajpur,Tapan,273,0,1,hab,1,0,4,269,272,35,5911,126,25.279875941431687,88.56401521260796,0
West Bengal,Darjeeling,Dar-Pulbazar,232,0,11,hab,5,6,11,221,221,35,1442,133,27.091966366535964,88.14473188677609,0
West Bengal,Darjeeling,Garubathan,89,0,8,hab,8,0,23,66,81,35,1887,133,27.028643311886697,88.74575918315185,0
West Bengal,Darjeeling,Jorebunglow-Sukhiapokhri,200,0,5,hab,5,0,11,189,195,35,2524,133,26.971048888525573,88.21155887150624,0
West Bengal,Darjeeling,Kalimpong-I,114,0,1,hab,1,0,4,110,113,35,2638,133,26.98400042077939,88.51229717602988,0
West Bengal,Darjeeling,Kalimpong-II,100,0,5,hab,3,2,13,87,95,35,2639,133,27.111304020154854,88.60587582296039,0
West Bengal,Darjeeling,Kurseong,112,0,5,hab,5,0,15,97,107,35,3290,133,26.870092470823415,88.35324767987127,0
West Bengal,Darjeeling,Mirik,46,0,1,hab,0,1,0,46,45,35,3864,133,26.8427579057439,88.20502618315317,0
West Bengal,Darjeeling,Rangli Rangliot,89,0,3,hab,2,1,5,84,86,35,5085,133,27.022415330674715,88.35872659936477,0
West Bengal,Hooghly,Arambag,242,0,0,hab,0,0,0,242,242,35,220,223,22.862089115699526,87.84095826905026,0
West Bengal,Hooghly,Balagarh,197,1,1,hab,1,0,7,190,196,35,435,223,23.11721133143852,88.42336201861616,0
West Bengal,Hooghly,Chanditala-I,116,0,3,hab,3,0,9,107,113,35,1158,223,22.721335042846825,88.18707943843509,0
West Bengal,Hooghly,Chanditala-II,166,0,1,hab,1,0,14,152,165,35,1159,223,22.70740167095339,88.26406378497423,0
West Bengal,Hooghly,Chinsura-Mogra,68,0,0,hab,0,0,0,68,68,35,1304,223,22.967038976834388,88.37867399742937,0
West Bengal,Hooghly,Dhaniakhali,255,0,1,hab,0,1,0,255,254,35,1558,223,22.974020074390996,88.09191656884131,0
West Bengal,Hooghly,Goghat-I,142,0,1,hab,1,0,4,138,141,35,1969,223,22.868679481043806,87.72500238055565,0
West Bengal,Hooghly,Goghat-II,150,0,2,hab,2,0,7,143,148,35,1970,223,22.90163943503252,87.63354124319115,0
West Bengal,Hooghly,Haripal,224,1,1,hab,1,0,6,218,223,35,2153,223,22.835006773452047,88.12150081214968,0
West Bengal,Hooghly,Jangipara,176,0,2,hab,2,0,8,168,174,35,2440,223,22.739571455345544,88.06649599067397,0
West Bengal,Hooghly,Khanakul-I,185,0,1,hab,1,0,2,183,184,35,2944,223,22.732977231120156,87.84866674460271,0
West Bengal,Hooghly,Khanakul-II,122,0,0,hab,0,0,0,122,122,35,2945,223,22.653925997393326,87.85805961019501,0
West Bengal,Hooghly,Pandua,217,0,0,hab,0,0,0,217,217,35,4514,223,23.077714992107875,88.252327877256,0
West Bengal,Hooghly,Polba-Dadpur,243,2,1,hab,1,0,1,242,242,35,4794,223,22.94051007630778,88.26565775230222,0
West Bengal,Hooghly,Pursura,131,0,1,hab,1,0,4,127,130,35,4875,223,22.85326680068068,87.94435741175839,0
West Bengal,Hooghly,Serampore-Uttarpara,61,0,1,hab,1,0,6,55,60,35,5492,223,22.730592266145273,88.32607248413656,0
West Bengal,Hooghly,Singur,219,0,0,hab,0,0,0,219,219,35,5660,223,22.822344221425574,88.27217815131391,0
West Bengal,Hooghly,Tarakeswar,140,0,1,hab,1,0,9,131,139,35,5917,223,22.859520936177667,88.01279350238772,0
West Bengal,Howrah,Amta-I,419,0,1,hab,1,0,10,409,418,35,165,226,22.599645122426168,88.02517157795751,0
West Bengal,Howrah,Amta-II,336,0,1,hab,1,0,15,321,335,35,166,226,22.57349101063592,87.92334710177772,0
West Bengal,Howrah,Bagnan-I,271,0,0,hab,0,0,0,271,271,35,391,226,22.495499418154616,87.94785428946696,0
West Bengal,Howrah,Bagnan-II,233,0,1,hab,1,0,11,222,232,35,392,226,22.43312928100285,87.9539595268935,0
West Bengal,Howrah,Ballyjagacha,238,0,0,hab,0,0,0,238,238,35,469,226,22.636782472167194,88.31894325087075,0
West Bengal,Howrah,Domjur,512,0,0,hab,0,0,0,512,512,35,1659,226,22.629550242726328,88.22507366914769,0
West Bengal,Howrah,Jagatballavpur,344,0,1,hab,1,0,13,331,343,35,2335,226,22.632884785157884,88.10449945270707,0
West Bengal,Howrah,Panchla,368,0,1,hab,1,0,25,343,367,35,4499,226,22.56436827574644,88.13719312335081,0
West Bengal,Howrah,Sankrail,432,0,1,hab,1,0,28,404,431,35,5377,226,22.557076607521633,88.21301664196974,0
West Bengal,Howrah,Shyampur-I,308,0,1,hab,1,0,11,297,307,35,5599,226,22.29026355371115,88.04561057168708,0
West Bengal,Howrah,Shyampur-II,172,0,1,hab,1,0,4,168,171,35,5600,226,22.348168184107084,87.99636339291148,0
West Bengal,Howrah,Udaynarayanpur,288,0,1,hab,1,0,10,278,287,35,6177,226,22.692562083805512,87.97219490690193,0
West Bengal,Howrah,Uluberia-I,299,0,0,hab,0,0,0,299,299,35,6195,226,22.44653186892464,88.08548678108586,0
West Bengal,Howrah,Uluberia-II,269,0,1,hab,1,0,17,252,268,35,6196,226,22.508314186786304,88.07594942410181,0
West Bengal,Jalpaiguri,Dhupguri,250,0,4,hab,4,0,7,243,246,35,1621,245,26.691730653553158,89.00576064350474,0
West Bengal,Jalpaiguri,Jalpaiguri-Sadar,337,0,0,hab,0,0,0,337,337,35,2402,245,26.493198980776437,88.68926975661827,0
West Bengal,Jalpaiguri,Mal,290,0,96,hab,81,15,173,117,194,35,3579,245,26.787623274949677,88.67186829146675,0
West Bengal,Jalpaiguri,Matiali,142,0,2,hab,2,0,8,134,140,35,3769,245,26.867615508455728,88.79170548917723,0
West Bengal,Jalpaiguri,Maynaguri,295,0,1,hab,1,0,3,292,294,35,3795,245,26.566397845261175,88.84224694738911,0
West Bengal,Jalpaiguri,Nagrakata,121,0,1,hab,1,0,2,119,120,35,4079,245,26.855904414961742,88.9152111785779,0
West Bengal,Jalpaiguri,Rajganj,414,0,3,hab,3,0,9,405,411,35,4977,245,26.665978515876596,88.51356381203928,0
West Bengal,Jhargram,Binpur I,448,0,2,hab,2,0,11,437,446,35,7591,667,22.59006262192644,87.02452988749664,0
West Bengal,Jhargram,Binpur II,410,0,3,hab,3,0,13,397,407,35,7592,667,22.655777507370406,86.7525059509064,0
West Bengal,Jhargram,Gopiballavpur I,213,0,1,hab,1,0,2,211,212,35,7587,667,22.163872086254983,86.86095263139727,0
West Bengal,Jhargram,Gopiballavpur II,197,0,1,hab,1,0,3,194,196,35,7588,667,22.24355641154277,86.94224983098157,0
West Bengal,Jhargram,Jamboni,306,0,7,hab,7,0,16,290,299,35,7593,667,22.446716602325083,86.85910050877177,0
West Bengal,Jhargram,Jhargram,511,0,3,hab,3,0,11,500,508,35,7586,667,22.37926820996768,87.04111065655266,0
West Bengal,Jhargram,Nayagram,302,0,1,hab,1,0,2,300,301,35,7589,667,22.026477451555152,87.07869621469513,0
West Bengal,Jhargram,Sankrail,262,0,2,hab,2,0,9,253,260,35,7590,667,22.219485374382344,87.12443792597918,0
West Bengal,Maldah,Bamongola,157,0,1,hab,1,0,2,155,156,35,486,350,25.18144360258411,88.39932507915199,0
West Bengal,Maldah,Chanchal-I,185,0,1,hab,1,0,4,181,184,35,1142,350,25.420701020322326,88.03859415557584,0
West Bengal,Maldah,Chanchal-II,91,0,12,hab,10,2,14,77,79,35,1143,350,25.32124355958356,88.01055262113772,0
West Bengal,Maldah,English Bazar,112,0,1,hab,1,0,3,109,111,35,1742,350,24.994264943024028,88.08452927355238,0
West Bengal,Maldah,Gazole,379,0,4,hab,4,0,12,367,375,35,1901,350,25.21568384449561,88.23196101877309,0
West Bengal,Maldah,Habibpur,199,0,1,hab,1,0,1,198,198,35,2096,350,25.012566940057855,88.327067887424,0
West Bengal,Maldah,Harishchandrapur-I,191,1,11,hab,11,0,20,171,180,35,2155,350,25.457048668265102,87.9296851398775,0
West Bengal,Maldah,Harishchandrapur-II,302,0,45,hab,45,0,111,191,257,35,2156,350,25.374970339569852,87.85490278511246,0
West Bengal,Maldah,Kaliachak-I,131,0,0,hab,0,0,0,131,131,35,2628,350,24.875767405273233,88.05270067087021,0
West Bengal,Maldah,Kaliachak-II,280,1,1,hab,1,0,14,266,279,35,2629,350,24.933536685778787,87.99823653421484,0
West Bengal,Maldah,Kaliachak-IIi,238,0,1,hab,1,0,9,229,237,35,2630,350,24.779584065033536,88.01442493440646,0
West Bengal,Maldah,Manikchak,248,0,1,hab,1,0,12,236,247,35,3680,350,25.107929243036914,87.8829181524726,0
West Bengal,Maldah,Old Malda,288,0,0,hab,0,0,0,288,288,35,4382,350,25.060723456075458,88.177713996974,0
West Bengal,Maldah,Ratua-I,202,0,6,hab,6,0,15,187,196,35,5124,350,25.221896214424504,87.93857309770127,0
West Bengal,Maldah,Ratua-II,129,0,2,hab,2,0,7,122,127,35,5125,350,25.160127070807935,88.03657439338365,0
West Bengal,Murshidabad,Beldanga I,114,0,0,hab,0,0,0,114,114,35,698,374,23.952393604823566,88.262735346388,0
West Bengal,Murshidabad,Beldanga-II,105,0,1,hab,1,0,6,99,104,35,699,374,23.846365403791097,88.24636583551082,0
West Bengal,Murshidabad,Berhampore,280,1,0,hab,0,0,0,280,280,35,724,374,24.077582209286042,88.28520958195752,0
West Bengal,Murshidabad,Bhagawangola I,132,0,0,hab,0,0,0,132,132,35,763,374,24.31958945683612,88.31469619425351,0
West Bengal,Murshidabad,Bhagawangola-II,68,0,1,hab,1,0,3,65,67,35,764,374,24.29942641478122,88.40516376163256,0
West Bengal,Murshidabad,Bharatpur-I,109,0,1,hab,1,0,4,105,108,35,806,374,23.88401105786273,88.08307729617309,0
West Bengal,Murshidabad,Bharatpur-II,74,0,0,hab,0,0,0,74,74,35,807,374,23.78947489539523,88.10915784184327,0
West Bengal,Murshidabad,Burwan,200,0,1,hab,1,0,2,198,199,35,1081,374,23.931031360598865,87.92442881408788,0
West Bengal,Murshidabad,Domkal,104,0,0,hab,0,0,0,104,104,35,1660,374,24.088443234380833,88.5643093030557,0
West Bengal,Murshidabad,Farakka,96,0,1,hab,1,0,1,95,95,35,1760,374,24.758753894163647,87.90947878314174,0
West Bengal,Murshidabad,Hariharpara,138,0,0,hab,0,0,0,138,138,35,2148,374,24.030201630275062,88.40282656229634,0
West Bengal,Murshidabad,Jalangi,117,0,1,hab,1,0,5,112,116,35,2390,374,24.18506626888603,88.67304198529176,0
West Bengal,Murshidabad,Kandi,133,0,1,hab,1,0,2,131,132,35,2704,374,24.011675107317206,88.09983401184347,0
West Bengal,Murshidabad,Khargram,177,0,1,hab,1,0,5,172,176,35,2971,374,24.082463293750322,87.98551783313751,0
West Bengal,Murshidabad,Lalgola,126,0,0,hab,0,0,0,126,126,35,3364,374,24.392244831377933,88.23447721233562,0
West Bengal,Murshidabad,Msd-Jiaganj,144,0,1,hab,1,0,1,143,143,35,3944,374,24.193061715685275,88.30440997139752,0
West Bengal,Murshidabad,Nabagram,135,0,1,hab,1,0,2,133,134,35,4041,374,24.18031943961628,88.11145440629114,0
West Bengal,Murshidabad,Nowda,90,0,1,hab,1,0,5,85,89,35,4345,374,23.90209301503045,88.411683612121,0
West Bengal,Murshidabad,Raghunathganj-I,94,0,2,hab,2,0,6,88,92,35,4917,374,24.42737695302792,88.04624472748426,0
West Bengal,Murshidabad,Raghunathganj-II,125,0,0,hab,0,0,0,125,125,35,4918,374,24.46851759213817,88.1280102503928,0
West Bengal,Murshidabad,Raninagar-I,107,0,1,hab,1,0,4,103,106,35,5096,374,24.217439754564545,88.46594958328234,0
West Bengal,Murshidabad,Raninagar-II,55,0,1,hab,1,0,2,53,54,35,5097,374,24.278100866199495,88.58127646909399,0
West Bengal,Murshidabad,Sagardighi,191,0,3,hab,3,0,6,185,188,35,5245,374,24.311105900868334,88.11012473463546,0
West Bengal,Murshidabad,Samserganj,114,0,2,hab,2,0,9,105,112,35,5330,374,24.64852104982175,87.9525919869215,0
West Bengal,Murshidabad,Suti-I,76,0,1,hab,1,0,5,71,75,35,5830,374,24.52828433631474,88.00013379872446,0
West Bengal,Murshidabad,Suti-II,109,0,1,hab,1,0,13,96,108,35,5831,374,24.593457076700222,88.01533700408793,0
West Bengal,Nadia,Chakdaha,200,0,1,hab,1,0,6,194,199,35,1116,379,23.037124495224294,88.54459743163606,0
West Bengal,Nadia,Chapra,105,0,0,hab,0,0,0,105,105,35,1184,379,23.546148967463136,88.57869984035156,0
West Bengal,Nadia,Hanskhali,148,0,3,hab,3,0,9,139,145,35,2126,379,23.343437029702592,88.63078221247196,0
West Bengal,Nadia,Haringhata,124,1,23,hab,22,1,35,89,101,35,2150,379,22.957373565724904,88.59746083907538,0
West Bengal,Nadia,Kaliganj,167,0,2,hab,2,0,4,163,165,35,2634,379,23.707316467551745,88.25520517933788,0
West Bengal,Nadia,Karimpur-I,115,0,0,hab,0,0,0,115,115,35,2780,379,24.00143182539484,88.68620543423364,0
West Bengal,Nadia,Karimpur-II,120,0,1,hab,1,0,6,114,119,35,2781,379,23.928577726977093,88.57556788419394,0
West Bengal,Nadia,Krishnaganj,84,0,2,hab,2,0,6,78,82,35,3198,379,23.444634755305184,88.71858619264336,0
West Bengal,Nadia,Krishnagar-I,188,0,2,hab,2,0,9,179,186,35,3199,379,23.39047797039196,88.5028670150117,0
West Bengal,Nadia,Krishnagar-II,91,0,6,hab,6,0,18,73,85,35,3200,379,23.48524372690443,88.45340091932118,0
West Bengal,Nadia,Nabadwip,35,0,3,hab,3,0,3,32,32,35,4040,379,23.39989792295655,88.37554510556538,0
West Bengal,Nadia,Nakashipara,145,0,2,hab,2,0,6,139,143,35,4099,379,23.613683351360148,88.39821296185296,0
West Bengal,Nadia,Ranaghat-I,91,0,2,hab,2,0,5,86,89,35,5074,379,23.201591841820196,88.53240681623308,0
West Bengal,Nadia,Ranaghat-II,173,0,0,hab,0,0,0,173,173,35,5075,379,23.19552582232424,88.64354902028373,0
West Bengal,Nadia,Santipur,112,0,1,hab,1,0,4,108,111,35,5387,379,23.26244285447652,88.43712001806016,0
West Bengal,Nadia,Tehatta-I,110,0,0,hab,0,0,0,110,110,35,5939,379,23.771949680234005,88.52492147725359,0
West Bengal,Nadia,Tehatta-II,81,0,2,hab,2,0,7,74,79,35,5940,379,23.7642654366494,88.41579502658695,0
West Bengal,North 24 Parganas,Amdanga,131,0,4,hab,4,0,8,123,127,35,143,404,22.837591096163568,88.4906538968477,0
West Bengal,North 24 Parganas,Baduria,112,0,3,hab,2,1,5,107,109,35,367,404,22.757791941733682,88.80442321323949,0
West Bengal,North 24 Parganas,Bagdah,232,0,1,hab,1,0,7,225,231,35,374,404,23.189472166938483,88.83232707911866,0
West Bengal,North 24 Parganas,Barasat II,158,0,0,hab,0,0,0,158,158,35,571,404,22.66139725725567,88.55102047639251,0
West Bengal,North 24 Parganas,Barasat-I,187,0,2,hab,2,0,12,175,185,35,572,404,22.73120428793904,88.50924181261692,0
West Bengal,North 24 Parganas,Barrackpore II,59,0,10,hab,4,6,11,48,49,35,618,404,22.707140640470435,88.3928891185271,0
West Bengal,North 24 Parganas,Barrackpore-I,88,0,7,hab,3,4,10,78,81,35,619,404,22.87587847461006,88.43218440337706,0
West Bengal,North 24 Parganas,Basirhat II,131,0,1,hab,1,0,5,126,130,35,642,404,22.657903007122613,88.77939188049804,0
West Bengal,North 24 Parganas,Basirhat-I,99,0,0,hab,0,0,0,99,99,35,643,404,22.65068038379738,88.89282473003638,0
West Bengal,North 24 Parganas,Bongaon,213,0,3,hab,3,0,11,202,210,35,1026,404,23.06800160300907,88.77326889433178,0
West Bengal,North 24 Parganas,Deganga,195,0,1,hab,1,0,6,189,194,35,1482,404,22.711591088114126,88.66550896717841,0
West Bengal,North 24 Parganas,Gaighata,172,0,4,hab,4,0,13,159,168,35,1806,404,22.939799634924576,88.78133320294656,0
West Bengal,North 24 Parganas,Habra-I,178,0,3,hab,2,1,11,167,175,35,2097,404,22.831453613764214,88.67686593946034,0
West Bengal,North 24 Parganas,Habra-II,124,0,2,hab,2,0,11,113,122,35,2098,404,22.848114000958034,88.5740023539351,0
West Bengal,North 24 Parganas,Haroa,164,0,1,hab,1,0,8,156,163,35,2159,404,22.585988004641788,88.68554782887821,0
West Bengal,North 24 Parganas,Hasnabad,121,0,1,hab,1,0,3,118,120,35,2179,404,22.543991048222615,88.8878009028366,0
West Bengal,North 24 Parganas,Hingalganj,98,0,1,hab,1,0,3,95,97,35,2220,404,22.327137556705146,88.97958188848062,0
West Bengal,North 24 Parganas,Minakhan,117,0,1,hab,1,0,3,114,116,35,3859,404,22.51417842767071,88.7449670655958,0
West Bengal,North 24 Parganas,Rajarhat,73,0,0,hab,0,0,0,73,73,35,4970,404,22.59473852964433,88.47047912333079,0
West Bengal,North 24 Parganas,Sandeshkhali-I,98,0,1,hab,1,0,2,96,97,35,5339,404,22.440706591609484,88.81817848871945,0
West Bengal,North 24 Parganas,Sandeshkhali-II,96,0,1,hab,1,0,2,94,95,35,5340,404,22.334256854124508,88.8754009945622,0
West Bengal,North 24 Parganas,Swarupnagar,159,0,4,hab,4,0,12,147,155,35,5834,404,22.83163288381306,88.87715263346004,0
West Bengal,Paschim Burdwan,Andal,63,0,0,hab,0,0,0,63,63,35,7124,642,23.607927730754152,87.20311829579909,0
West Bengal,Paschim Burdwan,Baraboni,135,0,1,hab,1,0,4,131,134,35,7125,642,23.785779745103493,86.99601462063076,0
West Bengal,Paschim Burdwan,Durgapur-Faridpur,123,0,1,hab,1,0,3,120,122,35,7126,642,23.59419055801135,87.31533911866543,0
West Bengal,Paschim Burdwan,Jamuria,57,0,0,hab,0,0,0,57,57,35,7127,642,23.71613660113118,87.11279368534639,0
West Bengal,Paschim Burdwan,Kanksa,100,0,1,hab,1,0,2,98,99,35,7128,642,23.53897060241424,87.42597209607537,0
West Bengal,Paschim Burdwan,Pandabeswar,68,0,1,hab,1,0,4,64,67,35,7129,642,23.69276742211545,87.24304361543803,0
West Bengal,Paschim Burdwan,Raniganj,27,0,1,hab,0,1,0,27,26,35,7585,642,23.621523783424106,87.09684680982464,0
West Bengal,Paschim Burdwan,Salanpur,76,0,2,hab,2,0,6,70,74,35,7131,642,23.80445866623754,86.89335649548296,0
West Bengal,Paschim Medinipur,Chandrakona I,126,1,1,hab,0,1,0,126,125,35,1162,420,22.750342146675962,87.60744908346213,0
West Bengal,Paschim Medinipur,Chandrakona II,123,0,0,hab,0,0,0,123,123,35,1163,420,22.73878321188088,87.53053871617048,0
West Bengal,Paschim Medinipur,Dantan I,178,0,1,hab,1,0,6,172,177,35,1435,420,21.931453953243746,87.28624113418076,0
West Bengal,Paschim Medinipur,Dantan II,141,0,1,hab,1,0,2,139,140,35,1436,420,21.949123194929594,87.41614533875476,0
West Bengal,Paschim Medinipur,Daspur I,168,0,1,hab,1,0,6,162,167,35,1461,420,22.566392857498705,87.6859425950475,0
West Bengal,Paschim Medinipur,Daspur II,157,0,1,hab,1,0,3,154,156,35,1462,420,22.553397102973356,87.79985076124066,0
West Bengal,Paschim Medinipur,Debra,456,0,2,hab,2,0,8,448,454,35,1476,420,22.428939071752705,87.59042753454827,0
West Bengal,Paschim Medinipur,Garbeta I,284,0,7,hab,5,2,16,268,277,35,1869,420,22.86768615529189,87.37807523082844,0
West Bengal,Paschim Medinipur,Garbeta II,255,0,2,hab,2,0,8,247,253,35,1870,420,22.78532903408869,87.17336362690456,0
West Bengal,Paschim Medinipur,Garbeta III,189,0,3,hab,2,1,3,186,186,35,1871,420,22.740879337365264,87.37720417670128,0
West Bengal,Paschim Medinipur,Ghatal,140,0,1,hab,0,1,0,140,139,35,1926,420,22.674324231812093,87.69205552574238,0
West Bengal,Paschim Medinipur,Keshiary,188,0,1,hab,1,0,4,184,187,35,2893,420,22.12996045303842,87.23421102927401,0
West Bengal,Paschim Medinipur,Keshpur,492,1,7,hab,7,0,16,476,485,35,2897,420,22.575965898328846,87.45639957738777,0
West Bengal,Paschim Medinipur,Kharagpur I,215,0,1,hab,1,0,2,213,214,35,2966,420,22.31663257084897,87.28038409024808,0
West Bengal,Paschim Medinipur,Kharagpur II,300,1,2,hab,2,0,7,293,298,35,2967,420,22.33047113095896,87.43692008106035,0
West Bengal,Paschim Medinipur,Midnapur Sadar,219,0,40,hab,38,2,63,156,179,35,3853,420,22.450122339172452,87.27831917172763,0
West Bengal,Paschim Medinipur,Mohanpur,99,0,1,hab,1,0,2,97,98,35,3892,420,21.832684703379538,87.39438616792278,0
West Bengal,Paschim Medinipur,Narayangarh,425,0,4,hab,4,0,18,407,421,35,4171,420,22.129016903830298,87.39739512935807,0
West Bengal,Paschim Medinipur,Pingla,184,0,1,hab,1,0,5,179,183,35,4758,420,22.279008528319476,87.60557455105794,0
West Bengal,Paschim Medinipur,Sabong,250,0,1,hab,1,0,6,244,249,35,5227,420,22.164108454986586,87.60377241107287,0
West Bengal,Paschim Medinipur,Salboni,367,0,42,hab,38,4,79,288,325,35,5296,420,22.581191659736245,87.23386135170819,0
West Bengal,Purba Burdwan,Ausgram-I,80,0,1,hab,1,0,1,79,79,35,7132,641,23.48719747838746,87.69421208007869,0
West Bengal,Purba Burdwan,Ausgram-II,206,0,1,hab,1,0,4,202,205,35,7133,641,23.509879486378768,87.57882419206724,0
West Bengal,Purba Burdwan,Bhatar,149,0,8,hab,8,0,17,132,141,35,7134,641,23.421336608714146,87.88896278843642,0
West Bengal,Purba Burdwan,Burdwan-I,138,0,0,hab,0,0,0,138,138,35,7135,641,23.2971183173753,87.88872194786052,0
West Bengal,Purba Burdwan,Burdwan-II,94,0,1,hab,1,0,3,91,93,35,7136,641,23.244268375093277,87.97186152263937,0
West Bengal,Purba Burdwan,Galsi-I,96,0,1,hab,1,0,2,94,95,35,7137,641,23.36498070605824,87.57281058760788,0
West Bengal,Purba Burdwan,Galsi-II,127,0,2,hab,2,0,5,122,125,35,7138,641,23.304765003242398,87.71049340263272,0
West Bengal,Purba Burdwan,Jamalpur,218,0,1,hab,1,0,9,209,217,35,7139,641,23.06904734533367,88.02453897809782,0
West Bengal,Purba Burdwan,Kalna-I,133,0,2,hab,2,0,8,125,131,35,7140,641,23.275758092806264,88.28033387255425,0
West Bengal,Purba Burdwan,Kalna-II,161,0,1,hab,1,0,6,155,160,35,7141,641,23.17960146690532,88.29428875170042,0
West Bengal,Purba Burdwan,Katwa-I,78,0,1,hab,1,0,2,76,77,35,7142,641,23.57577285003403,88.09548711094395,0
West Bengal,Purba Burdwan,Katwa-II,80,0,1,hab,1,0,1,79,79,35,7143,641,23.546761665947553,88.17767153200714,0
West Bengal,Purba Burdwan,Ketugram-I,87,0,1,hab,1,0,1,86,86,35,7144,641,23.73382313190821,87.97937683065534,0
West Bengal,Purba Burdwan,Ketugram-II,74,0,1,hab,1,0,2,72,73,35,7145,641,23.701960502887207,88.09579071778873,0
West Bengal,Purba Burdwan,Khandaghosh,141,0,1,hab,1,0,1,140,140,35,7146,641,23.16282900043543,87.74630048330587,0
West Bengal,Purba Burdwan,Memari-I,128,0,0,hab,0,0,0,128,128,35,7148,641,23.17498451517497,88.10258322215485,0
West Bengal,Purba Burdwan,Memari-II,135,0,2,hab,2,0,8,127,133,35,7149,641,23.270627219774994,88.1205298885459,0
West Bengal,Purba Burdwan,Mongolkote,162,0,1,hab,1,0,3,159,161,35,7155,641,23.541502068541085,87.93286743654215,0
West Bengal,Purba Burdwan,Monteswar,165,1,4,hab,4,0,4,161,161,35,7154,641,23.39545436541333,88.13516274581343,0
West Bengal,Purba Burdwan,Purbasthali-I,167,4,1,hab,1,0,5,162,166,35,7153,641,23.390665584394196,88.28313516997734,0
West Bengal,Purba Burdwan,Purbasthali-II,133,0,4,hab,4,0,15,118,129,35,7152,641,23.50626887864256,88.28875913881089,0
West Bengal,Purba Burdwan,Raina-I,130,0,0,hab,0,0,0,130,130,35,7151,641,23.11436149414971,87.87943847720693,0
West Bengal,Purba Burdwan,Raina-II,102,0,1,hab,1,0,3,99,101,35,7150,641,22.997387357070696,87.85328725766816,0
West Bengal,Purba Medinipur,Bhagwanpur I,160,3,1,hab,1,0,4,156,159,35,773,440,22.097859859635843,87.7565242102966,0
West Bengal,Purba Medinipur,Bhagwanpur II,195,1,2,hab,2,0,8,187,193,35,774,440,21.99252798297597,87.73114076669148,0
West Bengal,Purba Medinipur,Chandipur,116,1,1,hab,1,0,1,115,115,35,1157,440,22.097216350882906,87.86449088104263,0
West Bengal,Purba Medinipur,Contai I,235,0,0,hab,0,0,0,235,235,35,1368,440,21.756464215437326,87.70810295515896,0
West Bengal,Purba Medinipur,Contai II,187,0,3,hab,3,0,13,174,184,35,1369,440,21.81392703295011,87.82391271223956,0
West Bengal,Purba Medinipur,Contai III,174,0,1,hab,1,0,3,171,173,35,1370,440,21.857307640293303,87.72719269830993,0
West Bengal,Purba Medinipur,Egra I,143,0,1,hab,0,1,0,143,142,35,1728,440,21.835575830947505,87.50272538735462,0
West Bengal,Purba Medinipur,Egra II,127,0,2,hab,1,1,4,123,125,35,1729,440,21.8428165384809,87.59683817395127,0
West Bengal,Purba Medinipur,Haldia,34,0,2,hab,1,1,1,33,32,35,2112,440,22.071111677124648,88.06487455740292,0
West Bengal,Purba Medinipur,Khejuri I,42,0,1,hab,1,0,1,41,41,35,2993,440,21.94470687790017,87.834636842746,0
West Bengal,Purba Medinipur,Khejuri II,96,1,1,hab,1,0,1,95,95,35,2994,440,21.837131720392982,87.95708451387618,0
West Bengal,Purba Medinipur,Mahisadal,91,0,5,hab,4,1,11,80,86,35,3533,440,22.17836037017508,87.99727426550382,0
West Bengal,Purba Medinipur,Moyna,104,0,1,hab,1,0,4,100,103,35,3943,440,22.2324743647937,87.76210415366975,0
West Bengal,Purba Medinipur,Nandakumar,113,0,7,hab,6,1,9,104,106,35,4133,440,22.202885085887466,87.88971218187663,0
West Bengal,Purba Medinipur,Nandigram I,111,0,1,hab,1,0,1,110,110,35,4144,440,21.9796574468262,88.00560037446272,0
West Bengal,Purba Medinipur,Nandigram II,41,0,1,hab,1,0,1,40,40,35,4145,440,22.025500506336083,87.9124916529901,0
West Bengal,Purba Medinipur,Panskura I,250,0,0,hab,0,0,0,250,250,35,4527,440,22.391379225307936,87.72288654041212,0
West Bengal,Purba Medinipur,Panskura II,150,0,0,hab,0,0,0,150,150,35,4528,440,22.442163933294978,87.82377009306997,0
West Bengal,Purba Medinipur,Patashpur I,151,0,1,hab,1,0,7,144,150,35,4599,440,22.054939277548815,87.57368980685732,0
West Bengal,Purba Medinipur,Patashpur II,155,0,1,hab,1,0,5,150,154,35,4600,440,21.973162476946698,87.58602502369652,0
West Bengal,Purba Medinipur,Ramnagar I,151,0,1,hab,1,0,5,146,150,35,5054,440,21.671627557195784,87.5284162304993,0
West Bengal,Purba Medinipur,Ramnagar II,141,0,2,hab,2,0,7,134,139,35,5055,440,21.708678140489813,87.62381989314095,0
West Bengal,Purba Medinipur,Sahid Matangini,121,0,1,hab,1,0,4,117,120,35,5261,440,22.367970794307745,87.90162502273826,0
West Bengal,Purba Medinipur,Sutahata,84,0,4,hab,3,1,8,76,80,35,5829,440,22.122084766429275,88.14167012543021,0
West Bengal,Purba Medinipur,Tamluk,148,0,0,hab,0,0,0,148,148,35,5888,440,22.29619613808467,87.86111534625937,0
West Bengal,Purulia,Arsha,95,0,2,hab,2,0,3,92,93,35,249,443,23.287535006210828,86.20500807784065,0
West Bengal,Purulia,Bagmundi,138,0,1,hab,1,0,2,136,137,35,390,443,23.199546853860028,86.03545160460942,0
West Bengal,Purulia,Balarampur,90,0,0,hab,0,0,0,90,90,35,441,443,23.11236205992229,86.22194841946194,0
West Bengal,Purulia,Barabazar,198,0,2,hab,2,0,2,196,196,35,553,443,23.07248927849133,86.38295342074173,0
West Bengal,Purulia,Bundwan,131,0,1,hab,1,0,1,130,130,35,1069,443,22.826801022108732,86.52456173953802,0
West Bengal,Purulia,Hura,110,0,3,hab,3,0,3,107,107,35,2261,443,23.31114935095683,86.60364762514206,0
West Bengal,Purulia,Jaipur,106,0,1,hab,1,0,3,103,105,35,2360,443,23.47519181450152,86.13182422473575,0
West Bengal,Purulia,Jhalda-I,129,0,6,hab,6,0,9,120,123,35,2489,443,23.34459522518602,85.92310595457616,0
West Bengal,Purulia,Jhalda-II,118,0,2,hab,1,1,1,117,116,35,2490,443,23.413014315423748,86.04108132835424,0
West Bengal,Purulia,Kashipur,196,0,0,hab,0,0,0,196,196,35,2811,443,23.40893163560343,86.7200122191138,0
West Bengal,Purulia,Manbazar-I,212,0,1,hab,1,0,2,210,211,35,3628,443,23.083017221919487,86.61435357475098,0
West Bengal,Purulia,Manbazar-II,124,0,1,hab,1,0,2,122,123,35,3629,443,22.95017167007661,86.60538490850946,0
West Bengal,Purulia,Neturia,113,0,1,hab,1,0,2,111,112,35,4282,443,23.647349181036653,86.7448333003242,0
West Bengal,Purulia,Para,119,0,2,hab,2,0,5,114,117,35,4540,443,23.509022616203502,86.47447451611323,0
West Bengal,Purulia,Puncha,99,0,5,hab,5,0,8,91,94,35,4854,443,23.194851773207798,86.60851191325254,0
West Bengal,Purulia,Purulia-I,105,2,3,hab,3,0,5,100,102,35,4877,443,23.29578437111722,86.346772664976,0
West Bengal,Purulia,Purulia-II,101,0,0,hab,0,0,0,101,101,35,4878,443,23.373562165004447,86.4210108766018,0
West Bengal,Purulia,Raghunathpur-I,80,0,0,hab,0,0,0,80,80,35,4921,443,23.5380926261081,86.69453190579485,0
West Bengal,Purulia,Raghunathpur-II,89,0,1,hab,1,0,1,88,88,35,4922,443,23.59934702560726,86.57208514767254,0
West Bengal,Purulia,Santuri,92,0,1,hab,1,0,1,91,91,35,5389,443,23.55544068137517,86.84272055319099,0
West Bengal,Siliguri M.P.,Kharibari,179,0,3,hab,3,0,16,163,176,35,2973,505,26.590305116438216,88.18130181206789,0
West Bengal,Siliguri M.P.,Matigara,89,0,1,hab,1,0,3,86,88,35,3770,505,26.748986407366665,88.3822773360405,0
West Bengal,Siliguri M.P.,Naxalbari,107,0,3,hab,3,0,3,104,104,35,4257,505,26.71215660987696,88.25614351122805,0
West Bengal,Siliguri M.P.,Phansidewa,216,0,2,hab,2,0,5,211,214,35,4728,505,26.578550411474378,88.30015559683793,0
West Bengal,South 24-Parganas,Baruipur,195,0,0,hab,0,0,0,195,195,35,624,523,22.33906420213509,88.47966909955467,0
West Bengal,South 24-Parganas,Basanti,296,0,19,hab,18,1,66,230,277,35,632,523,22.17036270798727,88.70438822365797,0
West Bengal,South 24-Parganas,Bhangar-I,177,0,1,hab,1,0,5,172,176,35,796,523,22.46872069084339,88.57051547835118,0
West Bengal,South 24-Parganas,Bhangar-II,103,1,0,hab,0,0,0,103,103,35,797,523,22.550841015216207,88.55681619032606,0
West Bengal,South 24-Parganas,Bishnupur-I,131,0,2,hab,2,0,10,121,129,35,984,523,22.38175253213697,88.32495857999639,0
West Bengal,South 24-Parganas,Bishnupur-II,197,0,1,hab,1,0,7,190,196,35,985,523,22.382460919492644,88.24065248288687,0
West Bengal,South 24-Parganas,Budge Budge-I,61,1,0,hab,0,0,0,61,61,35,1055,523,22.464984569244546,88.17522455355213,0
West Bengal,South 24-Parganas,Budge Budge-II,146,0,1,hab,1,0,7,139,145,35,1056,523,22.392651369907625,88.16461507953964,0
West Bengal,South 24-Parganas,Canning-I,144,1,2,hab,2,0,8,136,142,35,1094,523,22.281230501917666,88.60642652752044,0
West Bengal,South 24-Parganas,Canning-II,159,0,1,hab,1,0,2,157,158,35,1095,523,22.39403195512936,88.66941179418531,0
West Bengal,South 24-Parganas,Diamond-Harbour-I,148,0,0,hab,0,0,0,148,148,35,1624,523,22.209068694115885,88.2128298123811,0
West Bengal,South 24-Parganas,Diamond-Harbour-II,165,0,2,hab,2,0,9,156,163,35,1625,523,22.243067318531125,88.1392582262523,0
West Bengal,South 24-Parganas,Falta,192,0,1,hab,1,0,3,189,191,35,1758,523,22.309053225290032,88.18030228690937,0
West Bengal,South 24-Parganas,Gosaba,197,0,10,hab,9,1,20,177,187,35,2018,523,21.863759641936333,88.87499621151473,0
West Bengal,South 24-Parganas,Jaynagar-I,167,0,0,hab,0,0,0,167,167,35,2474,523,22.225706458481014,88.4941805773769,0
West Bengal,South 24-Parganas,Jaynagar-II,214,0,0,hab,0,0,0,214,214,35,2475,523,22.106316046415344,88.50063471177825,0
West Bengal,South 24-Parganas,Kakdwip,94,0,2,hab,2,0,4,90,92,35,2593,523,21.913395397799082,88.22963679926127,0
West Bengal,South 24-Parganas,Kulpi,203,0,1,hab,1,0,5,198,202,35,3240,523,22.05848609770167,88.24418191601163,0
West Bengal,South 24-Parganas,Kultali,117,0,1,hab,1,0,2,115,116,35,3241,523,21.818821818079144,88.57877028642167,0
West Bengal,South 24-Parganas,Magrahat-I,144,1,4,hab,3,1,3,141,140,35,3507,523,22.247495728700823,88.3018866504593,0
West Bengal,South 24-Parganas,Magrahat-II,161,0,2,hab,2,0,16,145,159,35,3508,523,22.266028194154075,88.37979078628618,0
West Bengal,South 24-Parganas,Mandirbazar,180,0,1,hab,1,0,11,169,179,35,3649,523,22.14669562976986,88.33429489081362,0
West Bengal,South 24-Parganas,Mathurapur-I,178,0,1,hab,1,0,13,165,177,35,3766,523,22.075172520708378,88.3807972382665,0
West Bengal,South 24-Parganas,Mathurapur-II,154,0,1,hab,1,0,5,149,153,35,3767,523,21.990574992004195,88.44000517971851,0
West Bengal,South 24-Parganas,Namkhana,120,0,3,hab,2,1,8,112,117,35,4124,523,21.668488830877816,88.25329674420564,0
West Bengal,South 24-Parganas,Patharpratima,217,0,1,hab,1,0,4,213,216,35,4615,523,21.773152571814645,88.39688924314801,0
West Bengal,South 24-Parganas,Sagar,150,0,1,hab,1,0,1,149,149,35,5244,523,21.73638496028581,88.09455718067348,0
West Bengal,South 24-Parganas,Sonarpur,127,0,0,hab,0,0,0,127,127,35,5724,523,22.442023813281185,88.43757040720794,0
West Bengal,South 24-Parganas,Tha-Maheshtala,95,0,0,hab,0,0,0,95,95,35,5967,523,22.479544699758154,88.26299355404343,0
West Bengal,Uttardinajpur,Chopra,278,0,2,hab,2,0,12,266,276,35,1350,572,26.405564131902793,88.37195866600716,0
West Bengal,Uttardinajpur,Goalpokhar-I,298,0,2,hab,2,0,3,295,296,35,1960,572,26.056540160734183,88.07872226028778,0
West Bengal,Uttardinajpur,Goalpokhar-II,277,0,56,hab,54,2,113,164,221,35,1961,572,25.992909067892153,87.94035860897625,0
West Bengal,Uttardinajpur,Hemtabad,115,0,1,hab,1,0,7,108,114,35,2207,572,25.707494063371556,88.2553751229893,0
West Bengal,Uttardinajpur,Islampur,423,0,3,hab,3,0,17,406,420,35,2313,572,26.234996912157726,88.23175618798011,0
West Bengal,Uttardinajpur,Itahar,277,0,1,hab,1,0,4,273,276,35,2318,572,25.438983639541174,88.15649564447415,0
West Bengal,Uttardinajpur,Kaliaganj,186,0,1,hab,1,0,1,185,185,35,2631,572,25.61233987520295,88.32506112636023,0
West Bengal,Uttardinajpur,Karandighi,363,0,11,hab,11,0,29,334,352,35,2759,572,25.84090489788568,87.980673733674,0
West Bengal,Uttardinajpur,Raiganj,208,0,0,hab,0,0,0,208,208,35,4935,572,25.67672118210284,88.12354712437141,0
